,Train_filename,Gen_filename,Train_duration,Gen_duration,Difference
0,b-4_151-300_163.wav,VTTS_b-4_151-300_163.wav,4060,3587,473
1,b-3_5639-5744_5658.wav,VTTS_b-3_5639-5744_5658.wav,7140,5550,1590
2,b-3_6016-6115_6028.wav,VTTS_b-3_6016-6115_6028.wav,6620,5921,699
3,b-4_2000-5164_3435.wav,VTTS_b-4_2000-5164_3435.wav,4113,3947,166
4,b-3_4607-5008_4801.wav,VTTS_b-3_4607-5008_4801.wav,3770,4098,-328
5,b-2_611-712_669.wav,VTTS_b-2_611-712_669.wav,2140,2763,-623
6,b-4_2000-5164_3522.wav,VTTS_b-4_2000-5164_3522.wav,2640,2508,132
7,b-3_2524-2854_2658.wav,VTTS_b-3_2524-2854_2658.wav,11530,11320,210
8,b-1_2725-2825_2773.wav,VTTS_b-1_2725-2825_2773.wav,2950,2949,1
9,b-3_1321-1568_1498.wav,VTTS_b-3_1321-1568_1498.wav,2340,2252,88
10,b-1_3228-3328_3312.wav,VTTS_b-1_3228-3328_3312.wav,1080,1219,-139
11,b-3_6301-6400_6357.wav,VTTS_b-3_6301-6400_6357.wav,3720,3808,-88
12,b-1_1010-1110_1050.wav,VTTS_b-1_1010-1110_1050.wav,1800,1892,-92
13,b-2_815-916_867.wav,VTTS_b-2_815-916_867.wav,2590,2659,-69
14,b-4_2000-5164_3493.wav,VTTS_b-4_2000-5164_3493.wav,4954,5550,-596
15,b-2_713-814_714.wav,VTTS_b-2_713-814_714.wav,3200,2833,367
16,b-3_3628-3714_3679.wav,VTTS_b-3_3628-3714_3679.wav,6740,7105,-365
17,b-3_6274-6300_6283.wav,VTTS_b-3_6274-6300_6283.wav,2030,1962,68
18,b-4_2000-5164_4338.wav,VTTS_b-4_2000-5164_4338.wav,3463,3437,26
19,b-4_1221-1300_1296.wav,VTTS_b-4_1221-1300_1296.wav,5470,4888,582
20,b-3_5009-5427_5395.wav,VTTS_b-3_5009-5427_5395.wav,7580,8371,-791
21,b-2_1699-1800_1788.wav,VTTS_b-2_1699-1800_1788.wav,2560,2020,540
22,b-2_203-304_230.wav,VTTS_b-2_203-304_230.wav,1270,1207,63
23,b-3_2855-2942_2922.wav,VTTS_b-3_2855-2942_2922.wav,10740,10344,396
24,b-3_5009-5427_5120.wav,VTTS_b-3_5009-5427_5120.wav,6150,5526,624
25,b-3_2524-2854_2677.wav,VTTS_b-3_2524-2854_2677.wav,6250,6072,178
26,b-1_3632-3732_3721.wav,VTTS_b-1_3632-3732_3721.wav,1800,1974,-174
27,b-2_917-1018_960.wav,VTTS_b-2_917-1018_960.wav,4080,4981,-901
28,b-1_478-578_543.wav,VTTS_b-1_478-578_543.wav,4000,4005,-5
29,b-3_3198-3278_3254.wav,VTTS_b-3_3198-3278_3254.wav,7790,7314,476
30,b-1_1414-1514_1440.wav,VTTS_b-1_1414-1514_1440.wav,1740,2287,-547
31,b-1_2422-2522_2424.wav,VTTS_b-1_2422-2522_2424.wav,2740,2485,255
32,b-4_2000-5164_4705.wav,VTTS_b-4_2000-5164_4705.wav,14358,11610,2748
33,b-4_2000-5164_2980.wav,VTTS_b-4_2000-5164_2980.wav,4323,4412,-89
34,b-3_5853-5956_5863.wav,VTTS_b-3_5853-5956_5863.wav,2580,2159,421
35,b-2_1903-2038_1982.wav,VTTS_b-2_1903-2038_1982.wav,5700,3669,2031
36,b-3_4498-4605_4513.wav,VTTS_b-3_4498-4605_4513.wav,10800,10019,781
37,b-4_2000-5164_3048.wav,VTTS_b-4_2000-5164_3048.wav,1501,1416,85
38,b-3_4607-5008_4927.wav,VTTS_b-3_4607-5008_4927.wav,3690,4145,-455
39,b-4_151-300_202.wav,VTTS_b-4_151-300_202.wav,2650,2473,177
40,b-2_305-406_398.wav,VTTS_b-2_305-406_398.wav,4740,3413,1327
41,b-4_2000-5164_4969.wav,VTTS_b-4_2000-5164_4969.wav,5731,5050,681
42,b-3_4607-5008_4946.wav,VTTS_b-3_4607-5008_4946.wav,5180,5840,-660
43,b-3_5853-5956_5912.wav,VTTS_b-3_5853-5956_5912.wav,6040,6188,-148
44,b-3_2434-2523_2519.wav,VTTS_b-3_2434-2523_2519.wav,6580,6815,-235
45,b-4_2000-5164_2319.wav,VTTS_b-4_2000-5164_2319.wav,9640,9555,85
46,b-3_1321-1568_1418.wav,VTTS_b-3_1321-1568_1418.wav,2690,3042,-352
47,b-4_2000-5164_3118.wav,VTTS_b-4_2000-5164_3118.wav,4504,4586,-82
48,b-1_4358-4393_4375.wav,VTTS_b-1_4358-4393_4375.wav,2340,2485,-145
49,b-3_4001-4103_4080.wav,VTTS_b-3_4001-4103_4080.wav,7280,9694,-2414
50,b-3_5745-5852_5762.wav,VTTS_b-3_5745-5852_5762.wav,5030,4772,258
51,b-4_1014-1100_1081.wav,VTTS_b-4_1014-1100_1081.wav,4750,4714,36
52,b-1_2624-2724_2653.wav,VTTS_b-1_2624-2724_2653.wav,1120,1103,17
53,b-1_74-174_112.wav,VTTS_b-1_74-174_112.wav,3360,2833,527
54,b-3_6301-6400_6330.wav,VTTS_b-3_6301-6400_6330.wav,1010,894,116
55,b-3_1321-1568_1439.wav,VTTS_b-3_1321-1568_1439.wav,2850,2926,-76
56,b-2_815-916_892.wav,VTTS_b-2_815-916_892.wav,3210,2635,575
57,b-3_980-1077_1029.wav,VTTS_b-3_980-1077_1029.wav,4660,5422,-762
58,b-2_407-508_409.wav,VTTS_b-2_407-508_409.wav,1380,1300,80
59,b-3_4607-5008_4642.wav,VTTS_b-3_4607-5008_4642.wav,4230,4435,-205
60,b-1_2826-2926_2864.wav,VTTS_b-1_2826-2926_2864.wav,3690,3878,-188
61,b-2_1223-1324_1255.wav,VTTS_b-2_1223-1324_1255.wav,3660,3518,142
62,b-3_1568-1665_1643.wav,VTTS_b-3_1568-1665_1643.wav,5410,4888,522
63,b-3_980-1077_1058.wav,VTTS_b-3_980-1077_1058.wav,7100,6908,192
64,b-1_3329-3429_3330.wav,VTTS_b-1_3329-3429_3330.wav,1160,1265,-105
65,b-3_3538-3627_3544.wav,VTTS_b-3_3538-3627_3544.wav,2160,2078,82
66,b-3_4607-5008_4800.wav,VTTS_b-3_4607-5008_4800.wav,1930,1962,-32
67,b-4_2000-5164_3954.wav,VTTS_b-4_2000-5164_3954.wav,4374,5480,-1106
68,b-3_5009-5427_5214.wav,VTTS_b-3_5009-5427_5214.wav,3450,3599,-149
69,b-4_2000-5164_3148.wav,VTTS_b-4_2000-5164_3148.wav,2034,2009,25
70,b-1_3430-3530_3456.wav,VTTS_b-1_3430-3530_3456.wav,1590,1486,104
71,b-1_1414-1514_1442.wav,VTTS_b-1_1414-1514_1442.wav,1740,1730,10
72,b-2_815-916_893.wav,VTTS_b-2_815-916_893.wav,1300,1347,-47
73,b-2_509-610_572.wav,VTTS_b-2_509-610_572.wav,3520,3866,-346
74,b-1_2018-2118_2058.wav,VTTS_b-1_2018-2118_2058.wav,1900,3100,-1200
75,b-3_4001-4103_4085.wav,VTTS_b-3_4001-4103_4085.wav,6250,5689,561
76,b-3_6701-6800_6724.wav,VTTS_b-3_6701-6800_6724.wav,5000,5178,-178
77,b-1_1313-1413_1379.wav,VTTS_b-1_1313-1413_1379.wav,2850,3170,-320
78,b-1_2220-2320_2317.wav,VTTS_b-1_2220-2320_2317.wav,5340,5387,-47
79,b-2_611-712_631.wav,VTTS_b-2_611-712_631.wav,1620,1660,-40
80,b-1_3733-3833_3802.wav,VTTS_b-1_3733-3833_3802.wav,1480,1335,145
81,b-3_3112-3197_3175.wav,VTTS_b-3_3112-3197_3175.wav,2820,2392,428
82,b-3_2350-2433_2431.wav,VTTS_b-3_2350-2433_2431.wav,5560,6374,-814
83,b-3_2524-2854_2614.wav,VTTS_b-3_2524-2854_2614.wav,5790,4586,1204
84,b-3_6016-6115_6098.wav,VTTS_b-3_6016-6115_6098.wav,1420,1312,108
85,b-3_6116-6215_6135.wav,VTTS_b-3_6116-6215_6135.wav,4340,4841,-501
86,b-4_501-1014_777.wav,VTTS_b-4_501-1014_777.wav,3120,3088,32
87,b-4_1101-1220_1116.wav,VTTS_b-4_1101-1220_1116.wav,2730,2694,36
88,b-2_1223-1324_1275.wav,VTTS_b-2_1223-1324_1275.wav,1540,1486,54
89,b-3_4607-5008_4658.wav,VTTS_b-3_4607-5008_4658.wav,6620,6908,-288
90,b-2_509-610_562.wav,VTTS_b-2_509-610_562.wav,1360,1451,-91
91,b-4_2000-5164_2402.wav,VTTS_b-4_2000-5164_2402.wav,4100,3553,547
92,b-3_3279-3363_3362.wav,VTTS_b-3_3279-3363_3362.wav,7320,7221,99
93,b-3_1321-1568_1515.wav,VTTS_b-3_1321-1568_1515.wav,6750,7012,-262
94,b-1_1414-1514_1451.wav,VTTS_b-1_1414-1514_1451.wav,1730,1788,-58
95,b-3_6900-7016_6950.wav,VTTS_b-3_6900-7016_6950.wav,4380,4505,-125
96,b-1_3430-3530_3487.wav,VTTS_b-1_3430-3530_3487.wav,2090,1858,232
97,b-3_4607-5008_4712.wav,VTTS_b-3_4607-5008_4712.wav,5980,5921,59
98,b-1_2927-3025_2983.wav,VTTS_b-1_2927-3025_2983.wav,1410,1521,-111
99,b-4_2000-5164_4973.wav,VTTS_b-4_2000-5164_4973.wav,6988,6478,510
100,b-2_509-610_524.wav,VTTS_b-2_509-610_524.wav,2200,2705,-505
101,b-4_1014-1100_1071.wav,VTTS_b-4_1014-1100_1071.wav,2280,1985,295
102,b-4_2000-5164_4677.wav,VTTS_b-4_2000-5164_4677.wav,3779,3599,180
103,b-3_5009-5427_5428.wav,VTTS_b-3_5009-5427_5428.wav,9720,10182,-462
104,b-1_478-578_558.wav,VTTS_b-1_478-578_558.wav,1800,2078,-278
105,b-4_1-52_28.wav,VTTS_b-4_1-52_28.wav,9160,8870,290
106,b-2_203-304_206.wav,VTTS_b-2_203-304_206.wav,2080,2426,-346
107,b-3_2855-2942_2900.wav,VTTS_b-3_2855-2942_2900.wav,5780,6455,-675
108,b-4_2000-5164_2375.wav,VTTS_b-4_2000-5164_2375.wav,5560,5143,417
109,b-1_1515-1615_1524.wav,VTTS_b-1_1515-1615_1524.wav,2490,1962,528
110,b-3_1079-1320_1288.wav,VTTS_b-3_1079-1320_1288.wav,5330,5399,-69
111,b-1_3834-3934_3863.wav,VTTS_b-1_3834-3934_3863.wav,1130,1068,62
112,b-4_2000-5164_3387.wav,VTTS_b-4_2000-5164_3387.wav,1830,1974,-144
113,b-4_2000-5164_4957.wav,VTTS_b-4_2000-5164_4957.wav,3188,3077,111
114,b-1_3127-3227_3162.wav,VTTS_b-1_3127-3227_3162.wav,2970,4122,-1152
115,b-3_980-1077_1016.wav,VTTS_b-3_980-1077_1016.wav,3080,2868,212
116,b-4_1101-1220_1201.wav,VTTS_b-4_1101-1220_1201.wav,4860,5782,-922
117,b-2_2413-2500_2430.wav,VTTS_b-2_2413-2500_2430.wav,2950,3077,-127
118,b-4_2000-5164_2706.wav,VTTS_b-4_2000-5164_2706.wav,3510,3971,-461
119,b-3_3628-3714_3708.wav,VTTS_b-3_3628-3714_3708.wav,5920,4807,1113
120,b-3_5009-5427_5118.wav,VTTS_b-3_5009-5427_5118.wav,4920,5062,-142
121,b-3_5428-5533_5446.wav,VTTS_b-3_5428-5533_5446.wav,2910,2937,-27
122,b-1_2523-2623_2546.wav,VTTS_b-1_2523-2623_2546.wav,1810,1614,196
123,b-3_4498-4605_4538.wav,VTTS_b-3_4498-4605_4538.wav,2680,2763,-83
124,b-4_2000-5164_4774.wav,VTTS_b-4_2000-5164_4774.wav,3399,3704,-305
125,b-3_6116-6215_6152.wav,VTTS_b-3_6116-6215_6152.wav,4050,4052,-2
126,b-1_4358-4393_4368.wav,VTTS_b-1_4358-4393_4368.wav,4400,4876,-476
127,b-1_2523-2623_2581.wav,VTTS_b-1_2523-2623_2581.wav,2350,2705,-355
128,b-1_2018-2118_2108.wav,VTTS_b-1_2018-2118_2108.wav,2200,2090,110
129,b-3_5428-5533_5457.wav,VTTS_b-3_5428-5533_5457.wav,5970,6850,-880
130,b-3_6301-6400_6397.wav,VTTS_b-3_6301-6400_6397.wav,5660,5538,122
131,b-3_2434-2523_2485.wav,VTTS_b-3_2434-2523_2485.wav,6200,11308,-5108
132,b-4_2000-5164_3699.wav,VTTS_b-4_2000-5164_3699.wav,2684,2287,397
133,b-1_1313-1413_1332.wav,VTTS_b-1_1313-1413_1332.wav,3860,3634,226
134,b-3_5428-5533_5522.wav,VTTS_b-3_5428-5533_5522.wav,10890,10147,743
135,b-4_2000-5164_4495.wav,VTTS_b-4_2000-5164_4495.wav,4917,4911,6
136,b-1_2927-3025_3000.wav,VTTS_b-1_2927-3025_3000.wav,2290,2322,-32
137,b-1_794-1009_1005.wav,VTTS_b-1_794-1009_1005.wav,2670,2705,-35
138,b-3_4104-4206_4108.wav,VTTS_b-3_4104-4206_4108.wav,11390,10310,1080
139,b-4_1506-1600_1595.wav,VTTS_b-4_1506-1600_1595.wav,5640,4807,833
140,b-1_2018-2118_2018.wav,VTTS_b-1_2018-2118_2018.wav,5560,5283,277
141,b-1_276-376_375.wav,VTTS_b-1_276-376_375.wav,2580,2670,-90
142,b-2_203-304_203.wav,VTTS_b-2_203-304_203.wav,1710,2055,-345
143,b-4_2000-5164_4219.wav,VTTS_b-4_2000-5164_4219.wav,3918,4714,-796
144,b-1_579-649_624.wav,VTTS_b-1_579-649_624.wav,2420,2798,-378
145,b-3_2524-2854_2594.wav,VTTS_b-3_2524-2854_2594.wav,8700,8046,654
146,b-3_2524-2854_2786.wav,VTTS_b-3_2524-2854_2786.wav,8320,8475,-155
147,b-3_4607-5008_4699.wav,VTTS_b-3_4607-5008_4699.wav,4560,4969,-409
148,b-3_1960-2000_1988.wav,VTTS_b-3_1960-2000_1988.wav,5420,5155,265
149,b-4_2000-5164_3996.wav,VTTS_b-4_2000-5164_3996.wav,6814,6954,-140
150,b-2_2209-2310_2218.wav,VTTS_b-2_2209-2310_2218.wav,1580,1509,71
151,b-1_579-649_605.wav,VTTS_b-1_579-649_605.wav,4880,4772,108
152,b-1_478-578_494.wav,VTTS_b-1_478-578_494.wav,1430,1231,199
153,b-4_2000-5164_4531.wav,VTTS_b-4_2000-5164_4531.wav,8469,8231,238
154,b-1_4034-4069_4067.wav,VTTS_b-1_4034-4069_4067.wav,3930,5909,-1979
155,b-3_4607-5008_4909.wav,VTTS_b-3_4607-5008_4909.wav,3940,3796,144
156,b-2_815-916_831.wav,VTTS_b-2_815-916_831.wav,3200,4284,-1084
157,b-2_1427-1562_1508.wav,VTTS_b-2_1427-1562_1508.wav,7070,8185,-1115
158,b-4_1401-1505_1420.wav,VTTS_b-4_1401-1505_1420.wav,3380,3518,-138
159,b-4_2000-5164_2524.wav,VTTS_b-4_2000-5164_2524.wav,1610,1904,-294
160,b-3_6401-6500_6455.wav,VTTS_b-3_6401-6500_6455.wav,3310,3379,-69
161,b-4_2000-5164_2067.wav,VTTS_b-4_2000-5164_2067.wav,3670,3634,36
162,b-3_2000-2088_2060.wav,VTTS_b-3_2000-2088_2060.wav,6270,6444,-174
163,b-3_6217-6274_6266.wav,VTTS_b-3_6217-6274_6266.wav,2380,2310,70
164,b-1_4286-4321_4287.wav,VTTS_b-1_4286-4321_4287.wav,3850,4040,-190
165,b-1_3935-4033_3954.wav,VTTS_b-1_3935-4033_3954.wav,2080,2299,-219
166,b-4_2000-5164_4377.wav,VTTS_b-4_2000-5164_4377.wav,3601,3889,-288
167,b-1_1212-1312_1268.wav,VTTS_b-1_1212-1312_1268.wav,2710,2426,284
168,b-2_2209-2310_2288.wav,VTTS_b-2_2209-2310_2288.wav,3180,2786,394
169,b-1_1616-1716_1699.wav,VTTS_b-1_1616-1716_1699.wav,1480,1393,87
170,b-2_2413-2500_2445.wav,VTTS_b-2_2413-2500_2445.wav,2680,2763,-83
171,b-3_1321-1568_1480.wav,VTTS_b-3_1321-1568_1480.wav,2350,2357,-7
172,b-3_2350-2433_2388.wav,VTTS_b-3_2350-2433_2388.wav,4030,3413,617
173,b-4_2000-5164_4926.wav,VTTS_b-4_2000-5164_4926.wav,6639,6072,567
174,b-3_1321-1568_1522.wav,VTTS_b-3_1321-1568_1522.wav,4400,4052,348
175,b-1_1616-1716_1700.wav,VTTS_b-1_1616-1716_1700.wav,2240,2090,150
176,b-4_501-1014_961.wav,VTTS_b-4_501-1014_961.wav,2150,2101,49
177,b-2_2107-2193_2120.wav,VTTS_b-2_2107-2193_2120.wav,3070,3286,-216
178,b-1_1919-2017_1971.wav,VTTS_b-1_1919-2017_1971.wav,3390,3437,-47
179,b-3_1960-2000_1982.wav,VTTS_b-3_1960-2000_1982.wav,2730,2357,373
180,b-1_3026-3126_3030.wav,VTTS_b-1_3026-3126_3030.wav,1410,1347,63
181,b-4_401-500_424.wav,VTTS_b-4_401-500_424.wav,4220,3750,470
182,b-3_6501-6600_6578.wav,VTTS_b-3_6501-6600_6578.wav,3740,4760,-1020
183,b-3_6016-6115_6065.wav,VTTS_b-3_6016-6115_6065.wav,3170,2775,395
184,b-4_2000-5164_2632.wav,VTTS_b-4_2000-5164_2632.wav,3120,3123,-3
185,b-4_2000-5164_3715.wav,VTTS_b-4_2000-5164_3715.wav,785,662,123
186,b-3_1079-1320_1189.wav,VTTS_b-3_1079-1320_1189.wav,7190,6235,955
187,b-3_5009-5427_5031.wav,VTTS_b-3_5009-5427_5031.wav,4120,3448,672
188,b-3_3803-3888_3884.wav,VTTS_b-3_3803-3888_3884.wav,6080,5387,693
189,b-3_2000-2088_2073.wav,VTTS_b-3_2000-2088_2073.wav,6390,6339,51
190,b-3_980-1077_1077.wav,VTTS_b-3_980-1077_1077.wav,2820,2682,138
191,b-4_2000-5164_2639.wav,VTTS_b-4_2000-5164_2639.wav,2610,2368,242
192,b-3_4315-4424_4366.wav,VTTS_b-3_4315-4424_4366.wav,2400,2009,391
193,b-1_3733-3833_3807.wav,VTTS_b-1_3733-3833_3807.wav,2460,2612,-152
194,b-1_686-793_790.wav,VTTS_b-1_686-793_790.wav,2250,2322,-72
195,b-4_301-400_338.wav,VTTS_b-4_301-400_338.wav,3250,3204,46
196,b-4_2000-5164_4667.wav,VTTS_b-4_2000-5164_4667.wav,2553,2020,533
197,b-1_1212-1312_1253.wav,VTTS_b-1_1212-1312_1253.wav,3010,2844,166
198,b-3_1568-1665_1628.wav,VTTS_b-3_1568-1665_1628.wav,5660,5944,-284
199,b-2_101-202_171.wav,VTTS_b-2_101-202_171.wav,1840,1939,-99
200,b-3_2943-3024_3011.wav,VTTS_b-3_2943-3024_3011.wav,2380,2624,-244
201,b-1_686-793_739.wav,VTTS_b-1_686-793_739.wav,2300,2055,245
202,b-3_3279-3363_3351.wav,VTTS_b-3_3279-3363_3351.wav,11390,9903,1487
203,b-4_151-300_270.wav,VTTS_b-4_151-300_270.wav,3870,5596,-1726
204,b-3_4104-4206_4168.wav,VTTS_b-3_4104-4206_4168.wav,1290,1405,-115
205,b-3_2855-2942_2911.wav,VTTS_b-3_2855-2942_2911.wav,3890,4052,-162
206,b-1_3935-4033_4030.wav,VTTS_b-1_3935-4033_4030.wav,4140,8301,-4161
207,b-3_3025-3111_3077.wav,VTTS_b-3_3025-3111_3077.wav,4090,4191,-101
208,b-2_1903-2038_1975.wav,VTTS_b-2_1903-2038_1975.wav,2850,2937,-87
209,b-3_501-930_715.wav,VTTS_b-3_501-930_715.wav,9130,9868,-738
210,b-3_4207-4314_4275.wav,VTTS_b-3_4207-4314_4275.wav,2180,2148,32
211,b-4_2000-5164_2842.wav,VTTS_b-4_2000-5164_2842.wav,3450,3680,-230
212,b-4_2000-5164_2857.wav,VTTS_b-4_2000-5164_2857.wav,10060,11610,-1550
213,b-3_501-930_506.wav,VTTS_b-3_501-930_506.wav,7280,6618,662
214,b-2_407-508_427.wav,VTTS_b-2_407-508_427.wav,2840,3309,-469
215,b-1_4394-4429_4426.wav,VTTS_b-1_4394-4429_4426.wav,2650,2496,154
216,b-3_4207-4314_4311.wav,VTTS_b-3_4207-4314_4311.wav,4850,4679,171
217,b-4_501-1014_1011.wav,VTTS_b-4_501-1014_1011.wav,1170,1184,-14
218,b-1_650-685_652.wav,VTTS_b-1_650-685_652.wav,4750,4342,408
219,b-4_2000-5164_4587.wav,VTTS_b-4_2000-5164_4587.wav,5401,4656,745
220,b-1_74-174_103.wav,VTTS_b-1_74-174_103.wav,1490,1347,143
221,b-4_2000-5164_4275.wav,VTTS_b-4_2000-5164_4275.wav,2696,2937,-241
222,b-4_2000-5164_5125.wav,VTTS_b-4_2000-5164_5125.wav,2087,1869,218
223,b-3_6701-6800_6730.wav,VTTS_b-3_6701-6800_6730.wav,2200,2206,-6
224,b-1_2725-2825_2796.wav,VTTS_b-1_2725-2825_2796.wav,1400,1416,-16
225,b-3_6601-6700_6618.wav,VTTS_b-3_6601-6700_6618.wav,6440,7999,-1559
226,b-3_5009-5427_5323.wav,VTTS_b-3_5009-5427_5323.wav,4380,8429,-4049
227,b-2_1-100_52.wav,VTTS_b-2_1-100_52.wav,2350,2334,16
228,b-4_1401-1505_1417.wav,VTTS_b-4_1401-1505_1417.wav,3900,3808,92
229,b-3_2524-2854_2660.wav,VTTS_b-3_2524-2854_2660.wav,2490,2810,-320
230,b-3_3803-3888_3809.wav,VTTS_b-3_3803-3888_3809.wav,4960,4296,664
231,b-4_2000-5164_3592.wav,VTTS_b-4_2000-5164_3592.wav,2039,2090,-51
232,b-1_4214-4285_4254.wav,VTTS_b-1_4214-4285_4254.wav,1170,1149,21
233,b-4_2000-5164_2443.wav,VTTS_b-4_2000-5164_2443.wav,5980,6571,-591
234,b-3_6501-6600_6565.wav,VTTS_b-3_6501-6600_6565.wav,1510,1405,105
235,b-3_5533-5638_5617.wav,VTTS_b-3_5533-5638_5617.wav,8050,7755,295
236,b-2_509-610_607.wav,VTTS_b-2_509-610_607.wav,2070,2415,-345
237,b-4_501-1014_517.wav,VTTS_b-4_501-1014_517.wav,1220,1242,-22
238,b-1_3430-3530_3493.wav,VTTS_b-1_3430-3530_3493.wav,1410,1242,168
239,b-1_1010-1110_1079.wav,VTTS_b-1_1010-1110_1079.wav,2260,2252,8
240,b-3_1666-1763_1701.wav,VTTS_b-3_1666-1763_1701.wav,4700,4540,160
241,b-2_713-814_764.wav,VTTS_b-2_713-814_764.wav,2550,2067,483
242,b-4_2000-5164_5116.wav,VTTS_b-4_2000-5164_5116.wav,6037,6420,-383
243,b-3_2000-2088_2057.wav,VTTS_b-3_2000-2088_2057.wav,2560,2148,412
244,b-4_2000-5164_3149.wav,VTTS_b-4_2000-5164_3149.wav,3563,3564,-1
245,b-3_5009-5427_5137.wav,VTTS_b-3_5009-5427_5137.wav,4330,4342,-12
246,b-2_305-406_315.wav,VTTS_b-2_305-406_315.wav,2330,2485,-155
247,b-3_4607-5008_4789.wav,VTTS_b-3_4607-5008_4789.wav,3720,3959,-239
248,b-3_4315-4424_4344.wav,VTTS_b-3_4315-4424_4344.wav,3420,3715,-295
249,b-1_794-1009_999.wav,VTTS_b-1_794-1009_999.wav,3400,3599,-199
250,b-3_4315-4424_4393.wav,VTTS_b-3_4315-4424_4393.wav,7150,6258,892
251,b-3_1321-1568_1415.wav,VTTS_b-3_1321-1568_1415.wav,7740,7744,-4
252,b-3_4607-5008_4871.wav,VTTS_b-3_4607-5008_4871.wav,3970,3982,-12
253,b-3_501-930_577.wav,VTTS_b-3_501-930_577.wav,6490,5329,1161
254,b-3_3889-4000_3892.wav,VTTS_b-3_3889-4000_3892.wav,6700,6966,-266
255,b-1_794-1009_836.wav,VTTS_b-1_794-1009_836.wav,1830,2206,-376
256,b-2_1019-1120_1107.wav,VTTS_b-2_1019-1120_1107.wav,1600,1579,21
257,b-3_6016-6115_6020.wav,VTTS_b-3_6016-6115_6020.wav,7150,5793,1357
258,b-4_2000-5164_4036.wav,VTTS_b-4_2000-5164_4036.wav,4577,4319,258
259,b-4_1707-1813_1752.wav,VTTS_b-4_1707-1813_1752.wav,1850,1486,364
260,b-3_1079-1320_1155.wav,VTTS_b-3_1079-1320_1155.wav,4220,4934,-714
261,b-3_4001-4103_4065.wav,VTTS_b-3_4001-4103_4065.wav,8820,8127,693
262,b-3_2943-3024_2967.wav,VTTS_b-3_2943-3024_2967.wav,3970,4807,-837
263,b-3_5009-5427_5205.wav,VTTS_b-3_5009-5427_5205.wav,7460,10101,-2641
264,b-3_1862-1959_1921.wav,VTTS_b-3_1862-1959_1921.wav,4710,4841,-131
265,b-4_2000-5164_3227.wav,VTTS_b-4_2000-5164_3227.wav,5831,5317,514
266,b-2_1-100_6.wav,VTTS_b-2_1-100_6.wav,5030,6676,-1646
267,b-1_478-578_482.wav,VTTS_b-1_478-578_482.wav,2820,3460,-640
268,b-3_6301-6400_6378.wav,VTTS_b-3_6301-6400_6378.wav,4350,4284,66
269,b-4_2000-5164_2310.wav,VTTS_b-4_2000-5164_2310.wav,6000,7326,-1326
270,b-4_501-1014_1009.wav,VTTS_b-4_501-1014_1009.wav,2690,2786,-96
271,b-4_2000-5164_2743.wav,VTTS_b-4_2000-5164_2743.wav,5640,5712,-72
272,b-1_2220-2320_2234.wav,VTTS_b-1_2220-2320_2234.wav,1250,1335,-85
273,b-3_3538-3627_3587.wav,VTTS_b-3_3538-3627_3587.wav,9620,11610,-1990
274,b-4_2000-5164_2409.wav,VTTS_b-4_2000-5164_2409.wav,5275,5631,-356
275,b-3_6701-6800_6793.wav,VTTS_b-3_6701-6800_6793.wav,7030,5712,1318
276,b-3_5009-5427_5372.wav,VTTS_b-3_5009-5427_5372.wav,4240,4377,-137
277,b-2_611-712_659.wav,VTTS_b-2_611-712_659.wav,4780,5782,-1002
278,b-1_276-376_376.wav,VTTS_b-1_276-376_376.wav,1590,2101,-511
279,b-3_2524-2854_2689.wav,VTTS_b-3_2524-2854_2689.wav,1710,2159,-449
280,b-1_2523-2623_2559.wav,VTTS_b-1_2523-2623_2559.wav,1570,2612,-1042
281,b-1_4178-4213_4188.wav,VTTS_b-1_4178-4213_4188.wav,1900,2403,-503
282,b-3_501-930_866.wav,VTTS_b-3_501-930_866.wav,3410,4005,-595
283,b-3_4607-5008_4986.wav,VTTS_b-3_4607-5008_4986.wav,5170,6072,-902
284,b-3_2524-2854_2645.wav,VTTS_b-3_2524-2854_2645.wav,4190,4029,161
285,b-3_5428-5533_5516.wav,VTTS_b-3_5428-5533_5516.wav,7880,7953,-73
286,b-3_2177-2266_2193.wav,VTTS_b-3_2177-2266_2193.wav,2780,2670,110
287,b-3_1-97_32.wav,VTTS_b-3_1-97_32.wav,1620,1602,18
288,b-1_1111-1211_1196.wav,VTTS_b-1_1111-1211_1196.wav,2400,2403,-3
289,b-3_3628-3714_3630.wav,VTTS_b-3_3628-3714_3630.wav,4420,5793,-1373
290,b-4_2000-5164_2223.wav,VTTS_b-4_2000-5164_2223.wav,2410,2972,-562
291,b-4_1401-1505_1477.wav,VTTS_b-4_1401-1505_1477.wav,4590,4296,294
292,b-4_301-400_375.wav,VTTS_b-4_301-400_375.wav,1750,1567,183
293,b-3_5428-5533_5458.wav,VTTS_b-3_5428-5533_5458.wav,3870,4005,-135
294,b-3_5853-5956_5882.wav,VTTS_b-3_5853-5956_5882.wav,6460,5840,620
295,b-1_74-174_92.wav,VTTS_b-1_74-174_92.wav,3590,4040,-450
296,b-3_501-930_519.wav,VTTS_b-3_501-930_519.wav,6420,7721,-1301
297,b-4_1101-1220_1211.wav,VTTS_b-4_1101-1220_1211.wav,2090,2334,-244
298,b-3_5009-5427_5192.wav,VTTS_b-3_5009-5427_5192.wav,4840,6246,-1406
299,b-3_3025-3111_3027.wav,VTTS_b-3_3025-3111_3027.wav,6280,8313,-2033
300,b-3_501-930_518.wav,VTTS_b-3_501-930_518.wav,3670,5364,-1694
301,b-4_2000-5164_2129.wav,VTTS_b-4_2000-5164_2129.wav,2240,2159,81
302,b-1_1-73_22.wav,VTTS_b-1_1-73_22.wav,3450,3448,2
303,b-4_2000-5164_3914.wav,VTTS_b-4_2000-5164_3914.wav,9528,9543,-15
304,b-4_1014-1100_1015.wav,VTTS_b-4_1014-1100_1015.wav,7720,6548,1172
305,b-3_6116-6215_6199.wav,VTTS_b-3_6116-6215_6199.wav,4130,3553,577
306,b-1_1717-1817_1738.wav,VTTS_b-1_1717-1817_1738.wav,6640,5840,800
307,b-3_5009-5427_5316.wav,VTTS_b-3_5009-5427_5316.wav,10670,10286,384
308,b-4_1014-1100_1030.wav,VTTS_b-4_1014-1100_1030.wav,1640,1521,119
309,b-3_6801-6900_6845.wav,VTTS_b-3_6801-6900_6845.wav,2610,2148,462
310,b-2_2413-2500_2415.wav,VTTS_b-2_2413-2500_2415.wav,4220,3785,435
311,b-4_1506-1600_1558.wav,VTTS_b-4_1506-1600_1558.wav,6530,5573,957
312,b-4_2000-5164_2400.wav,VTTS_b-4_2000-5164_2400.wav,3660,3622,38
313,b-4_2000-5164_3115.wav,VTTS_b-4_2000-5164_3115.wav,7610,11610,-4000
314,b-1_2624-2724_2639.wav,VTTS_b-1_2624-2724_2639.wav,1390,1300,90
315,b-3_4607-5008_4773.wav,VTTS_b-3_4607-5008_4773.wav,4040,4191,-151
316,b-1_2624-2724_2721.wav,VTTS_b-1_2624-2724_2721.wav,3600,3564,36
317,b-3_4425-4497_4496.wav,VTTS_b-3_4425-4497_4496.wav,2750,2682,68
318,b-2_203-304_265.wav,VTTS_b-2_203-304_265.wav,1870,2647,-777
319,b-4_2000-5164_3250.wav,VTTS_b-4_2000-5164_3250.wav,3070,3077,-7
320,b-3_2524-2854_2615.wav,VTTS_b-3_2524-2854_2615.wav,4950,6095,-1145
321,b-3_5745-5852_5823.wav,VTTS_b-3_5745-5852_5823.wav,3980,4098,-118
322,b-1_3531-3631_3582.wav,VTTS_b-1_3531-3631_3582.wav,2620,2159,461
323,b-1_2523-2623_2593.wav,VTTS_b-1_2523-2623_2593.wav,1570,1521,49
324,b-4_2000-5164_4621.wav,VTTS_b-4_2000-5164_4621.wav,2801,2775,26
325,b-2_1903-2038_2034.wav,VTTS_b-2_1903-2038_2034.wav,1890,1788,102
326,b-3_98-195_151.wav,VTTS_b-3_98-195_151.wav,3430,3053,377
327,b-3_5428-5533_5440.wav,VTTS_b-3_5428-5533_5440.wav,2860,2926,-66
328,b-1_579-649_647.wav,VTTS_b-1_579-649_647.wav,2680,1869,811
329,b-3_4104-4206_4117.wav,VTTS_b-3_4104-4206_4117.wav,3220,2833,387
330,b-4_2000-5164_3619.wav,VTTS_b-4_2000-5164_3619.wav,3076,2961,115
331,b-1_3228-3328_3244.wav,VTTS_b-1_3228-3328_3244.wav,5670,11610,-5940
332,b-1_3834-3934_3871.wav,VTTS_b-1_3834-3934_3871.wav,3020,4702,-1682
333,b-2_2311-2412_2392.wav,VTTS_b-2_2311-2412_2392.wav,1380,1300,80
334,b-3_3803-3888_3886.wav,VTTS_b-3_3803-3888_3886.wav,3950,4261,-311
335,b-1_175-275_175.wav,VTTS_b-1_175-275_175.wav,3460,4481,-1021
336,b-2_509-610_561.wav,VTTS_b-2_509-610_561.wav,2720,2914,-194
337,b-3_6801-6900_6841.wav,VTTS_b-3_6801-6900_6841.wav,4910,4772,138
338,b-3_3364-3453_3394.wav,VTTS_b-3_3364-3453_3394.wav,6270,6235,35
339,b-3_3538-3627_3570.wav,VTTS_b-3_3538-3627_3570.wav,3120,2891,229
340,b-4_501-1014_987.wav,VTTS_b-4_501-1014_987.wav,4520,4005,515
341,b-3_3715-3802_3797.wav,VTTS_b-3_3715-3802_3797.wav,4120,4307,-187
342,b-1_686-793_716.wav,VTTS_b-1_686-793_716.wav,1380,1405,-25
343,b-4_2000-5164_2708.wav,VTTS_b-4_2000-5164_2708.wav,4910,6676,-1766
344,b-1_3733-3833_3780.wav,VTTS_b-1_3733-3833_3780.wav,3410,3611,-201
345,b-4_1901-2000_1940.wav,VTTS_b-4_1901-2000_1940.wav,3110,2821,289
346,b-4_2000-5164_2525.wav,VTTS_b-4_2000-5164_2525.wav,8380,9265,-885
347,b-1_1414-1514_1423.wav,VTTS_b-1_1414-1514_1423.wav,970,1138,-168
348,b-1_2220-2320_2291.wav,VTTS_b-1_2220-2320_2291.wav,1130,1057,73
349,b-3_3279-3363_3352.wav,VTTS_b-3_3279-3363_3352.wav,5930,5271,659
350,b-3_4498-4605_4592.wav,VTTS_b-3_4498-4605_4592.wav,7000,6385,615
351,b-4_401-500_484.wav,VTTS_b-4_401-500_484.wav,6880,6118,762
352,b-1_3127-3227_3219.wav,VTTS_b-1_3127-3227_3219.wav,2390,6339,-3949
353,b-4_2000-5164_3677.wav,VTTS_b-4_2000-5164_3677.wav,4092,3994,98
354,b-3_6501-6600_6555.wav,VTTS_b-3_6501-6600_6555.wav,5650,7198,-1548
355,b-3_2524-2854_2702.wav,VTTS_b-3_2524-2854_2702.wav,7830,6455,1375
356,b-4_2000-5164_4153.wav,VTTS_b-4_2000-5164_4153.wav,3467,3239,228
357,b-1_1515-1615_1530.wav,VTTS_b-1_1515-1615_1530.wav,2630,2276,354
358,b-3_3628-3714_3709.wav,VTTS_b-3_3628-3714_3709.wav,3990,3878,112
359,b-4_1014-1100_1096.wav,VTTS_b-4_1014-1100_1096.wav,6110,5433,677
360,b-2_1-100_72.wav,VTTS_b-2_1-100_72.wav,1730,2531,-801
361,b-3_2000-2088_2015.wav,VTTS_b-3_2000-2088_2015.wav,5430,5735,-305
362,b-1_1313-1413_1356.wav,VTTS_b-1_1313-1413_1356.wav,3530,3274,256
363,b-4_1221-1300_1252.wav,VTTS_b-4_1221-1300_1252.wav,1550,1567,-17
364,b-4_2000-5164_2410.wav,VTTS_b-4_2000-5164_2410.wav,3410,3320,90
365,b-1_2725-2825_2764.wav,VTTS_b-1_2725-2825_2764.wav,5720,7523,-1803
366,b-1_4394-4429_4423.wav,VTTS_b-1_4394-4429_4423.wav,3480,11610,-8130
367,b-1_3228-3328_3262.wav,VTTS_b-1_3228-3328_3262.wav,1970,1916,54
368,b-4_2000-5164_4021.wav,VTTS_b-4_2000-5164_4021.wav,6117,6200,-83
369,b-1_1919-2017_1970.wav,VTTS_b-1_1919-2017_1970.wav,4110,3715,395
370,b-2_713-814_793.wav,VTTS_b-2_713-814_793.wav,3020,3506,-486
371,b-3_6016-6115_6043.wav,VTTS_b-3_6016-6115_6043.wav,1420,1312,108
372,b-4_2000-5164_2771.wav,VTTS_b-4_2000-5164_2771.wav,4250,4098,152
373,b-4_2000-5164_3418.wav,VTTS_b-4_2000-5164_3418.wav,6058,9172,-3114
374,b-4_501-1014_650.wav,VTTS_b-4_501-1014_650.wav,6600,6049,551
375,b-1_794-1009_811.wav,VTTS_b-1_794-1009_811.wav,5040,5108,-68
376,b-3_3715-3802_3801.wav,VTTS_b-3_3715-3802_3801.wav,5040,5747,-707
377,b-2_2311-2412_2384.wav,VTTS_b-2_2311-2412_2384.wav,1020,894,126
378,b-3_2177-2266_2247.wav,VTTS_b-3_2177-2266_2247.wav,4010,3936,74
379,b-3_3025-3111_3085.wav,VTTS_b-3_3025-3111_3085.wav,6100,6316,-216
380,b-3_4104-4206_4138.wav,VTTS_b-3_4104-4206_4138.wav,8560,9520,-960
381,b-2_2311-2412_2321.wav,VTTS_b-2_2311-2412_2321.wav,1530,1533,-3
382,b-3_1079-1320_1270.wav,VTTS_b-3_1079-1320_1270.wav,5230,5085,145
383,b-4_1901-2000_1927.wav,VTTS_b-4_1901-2000_1927.wav,4390,4052,338
384,b-3_3279-3363_3296.wav,VTTS_b-3_3279-3363_3296.wav,4040,4156,-116
385,b-1_3329-3429_3423.wav,VTTS_b-1_3329-3429_3423.wav,2420,2403,17
386,b-4_501-1014_989.wav,VTTS_b-4_501-1014_989.wav,3360,3483,-123
387,b-4_2000-5164_2684.wav,VTTS_b-4_2000-5164_2684.wav,2167,4795,-2628
388,b-4_2000-5164_3094.wav,VTTS_b-4_2000-5164_3094.wav,3527,6235,-2708
389,b-1_1313-1413_1368.wav,VTTS_b-1_1313-1413_1368.wav,3620,2972,648
390,b-4_2000-5164_4483.wav,VTTS_b-4_2000-5164_4483.wav,3368,3855,-487
391,b-1_3430-3530_3524.wav,VTTS_b-1_3430-3530_3524.wav,2700,3762,-1062
392,b-4_1221-1300_1289.wav,VTTS_b-4_1221-1300_1289.wav,2030,2043,-13
393,b-4_2000-5164_3706.wav,VTTS_b-4_2000-5164_3706.wav,5460,5422,38
394,b-4_2000-5164_3845.wav,VTTS_b-4_2000-5164_3845.wav,10432,10553,-121
395,b-4_2000-5164_4892.wav,VTTS_b-4_2000-5164_4892.wav,1810,1625,185
396,b-3_980-1077_986.wav,VTTS_b-3_980-1077_986.wav,3050,2659,391
397,b-1_794-1009_1004.wav,VTTS_b-1_794-1009_1004.wav,3440,3262,178
398,b-1_4142-4177_4167.wav,VTTS_b-1_4142-4177_4167.wav,2590,3007,-417
399,b-3_5428-5533_5485.wav,VTTS_b-3_5428-5533_5485.wav,3170,3123,47
400,b-4_2000-5164_2984.wav,VTTS_b-4_2000-5164_2984.wav,4330,4272,58
401,b-4_1301-1400_1384.wav,VTTS_b-4_1301-1400_1384.wav,6020,7605,-1585
402,b-3_1568-1665_1620.wav,VTTS_b-3_1568-1665_1620.wav,1180,1451,-271
403,b-4_2000-5164_4105.wav,VTTS_b-4_2000-5164_4105.wav,3896,4307,-411
404,b-4_1101-1220_1119.wav,VTTS_b-4_1101-1220_1119.wav,2230,1846,384
405,b-3_5639-5744_5672.wav,VTTS_b-3_5639-5744_5672.wav,4600,4818,-218
406,b-4_2000-5164_2414.wav,VTTS_b-4_2000-5164_2414.wav,4570,4563,7
407,b-4_2000-5164_3780.wav,VTTS_b-4_2000-5164_3780.wav,6400,6385,15
408,b-4_2000-5164_3850.wav,VTTS_b-4_2000-5164_3850.wav,3238,3181,57
409,b-3_1568-1665_1637.wav,VTTS_b-3_1568-1665_1637.wav,2850,2786,64
410,b-4_2000-5164_5016.wav,VTTS_b-4_2000-5164_5016.wav,5573,5050,523
411,b-3_3628-3714_3674.wav,VTTS_b-3_3628-3714_3674.wav,10350,9195,1155
412,b-4_2000-5164_2846.wav,VTTS_b-4_2000-5164_2846.wav,7910,8777,-867
413,b-3_5009-5427_5152.wav,VTTS_b-3_5009-5427_5152.wav,4540,11610,-7070
414,b-1_4358-4393_4373.wav,VTTS_b-1_4358-4393_4373.wav,2440,2508,-68
415,b-2_917-1018_926.wav,VTTS_b-2_917-1018_926.wav,1250,1660,-410
416,b-1_3531-3631_3603.wav,VTTS_b-1_3531-3631_3603.wav,2080,2055,25
417,b-3_1321-1568_1565.wav,VTTS_b-3_1321-1568_1565.wav,4730,4249,481
418,b-1_2927-3025_2975.wav,VTTS_b-1_2927-3025_2975.wav,3230,3355,-125
419,b-2_815-916_845.wav,VTTS_b-2_815-916_845.wav,2270,2194,76
420,b-3_5009-5427_5087.wav,VTTS_b-3_5009-5427_5087.wav,10310,11610,-1300
421,b-3_5009-5427_5177.wav,VTTS_b-3_5009-5427_5177.wav,2990,3216,-226
422,b-4_2000-5164_3505.wav,VTTS_b-4_2000-5164_3505.wav,6830,11610,-4780
423,b-1_3329-3429_3370.wav,VTTS_b-1_3329-3429_3370.wav,2740,2612,128
424,b-3_1321-1568_1336.wav,VTTS_b-3_1321-1568_1336.wav,2020,2078,-58
425,b-2_815-916_864.wav,VTTS_b-2_815-916_864.wav,1170,1219,-49
426,b-1_686-793_792.wav,VTTS_b-1_686-793_792.wav,1900,1904,-4
427,b-2_1699-1800_1716.wav,VTTS_b-2_1699-1800_1716.wav,1440,1428,12
428,b-3_6116-6215_6157.wav,VTTS_b-3_6116-6215_6157.wav,3580,3529,51
429,b-4_2000-5164_2079.wav,VTTS_b-4_2000-5164_2079.wav,6755,7175,-420
430,b-3_196-293_254.wav,VTTS_b-3_196-293_254.wav,5270,5236,34
431,b-4_2000-5164_3033.wav,VTTS_b-4_2000-5164_3033.wav,7303,9334,-2031
432,b-3_1862-1959_1960.wav,VTTS_b-3_1862-1959_1960.wav,2900,3123,-223
433,b-1_1515-1615_1601.wav,VTTS_b-1_1515-1615_1601.wav,1300,1231,69
434,b-1_2422-2522_2445.wav,VTTS_b-1_2422-2522_2445.wav,1770,1660,110
435,b-3_3025-3111_3037.wav,VTTS_b-3_3025-3111_3037.wav,2880,2635,245
436,b-4_2000-5164_3400.wav,VTTS_b-4_2000-5164_3400.wav,9471,9660,-189
437,b-2_1699-1800_1704.wav,VTTS_b-2_1699-1800_1704.wav,2190,2159,31
438,b-3_1079-1320_1085.wav,VTTS_b-3_1079-1320_1085.wav,7320,7674,-354
439,b-3_4207-4314_4218.wav,VTTS_b-3_4207-4314_4218.wav,10680,11610,-930
440,b-1_2523-2623_2615.wav,VTTS_b-1_2523-2623_2615.wav,1650,1881,-231
441,b-3_3025-3111_3032.wav,VTTS_b-3_3025-3111_3032.wav,3690,3936,-246
442,b-1_2523-2623_2534.wav,VTTS_b-1_2523-2623_2534.wav,2970,2972,-2
443,b-3_980-1077_1074.wav,VTTS_b-3_980-1077_1074.wav,2590,2334,256
444,b-4_1221-1300_1237.wav,VTTS_b-4_1221-1300_1237.wav,3630,4435,-805
445,b-2_101-202_168.wav,VTTS_b-2_101-202_168.wav,1870,1811,59
446,b-3_1764-1861_1804.wav,VTTS_b-3_1764-1861_1804.wav,5680,5085,595
447,b-1_2422-2522_2499.wav,VTTS_b-1_2422-2522_2499.wav,2420,2392,28
448,b-2_1427-1562_1461.wav,VTTS_b-2_1427-1562_1461.wav,4100,4690,-590
449,b-2_917-1018_955.wav,VTTS_b-2_917-1018_955.wav,2590,2357,233
450,b-3_2350-2433_2413.wav,VTTS_b-3_2350-2433_2413.wav,3970,3820,150
451,b-3_4315-4424_4325.wav,VTTS_b-3_4315-4424_4325.wav,5160,4574,586
452,b-1_1313-1413_1383.wav,VTTS_b-1_1313-1413_1383.wav,1850,1649,201
453,b-1_3430-3530_3463.wav,VTTS_b-1_3430-3530_3463.wav,3960,4214,-254
454,b-3_1666-1763_1682.wav,VTTS_b-3_1666-1763_1682.wav,1420,1544,-124
455,b-1_3329-3429_3382.wav,VTTS_b-1_3329-3429_3382.wav,1100,1173,-73
456,b-4_2000-5164_2809.wav,VTTS_b-4_2000-5164_2809.wav,3060,2810,250
457,b-3_4207-4314_4234.wav,VTTS_b-3_4207-4314_4234.wav,2770,2694,76
458,b-1_1919-2017_1943.wav,VTTS_b-1_1919-2017_1943.wav,3120,2949,171
459,b-2_1597-1698_1659.wav,VTTS_b-2_1597-1698_1659.wav,2200,2009,191
460,b-3_2943-3024_3020.wav,VTTS_b-3_2943-3024_3020.wav,3110,3216,-106
461,b-4_2000-5164_4076.wav,VTTS_b-4_2000-5164_4076.wav,4366,5445,-1079
462,b-1_478-578_554.wav,VTTS_b-1_478-578_554.wav,1550,1370,180
463,b-4_2000-5164_4000.wav,VTTS_b-4_2000-5164_4000.wav,3525,3564,-39
464,b-3_6016-6115_6091.wav,VTTS_b-3_6016-6115_6091.wav,5450,5689,-239
465,b-1_2119-2219_2128.wav,VTTS_b-1_2119-2219_2128.wav,2390,2310,80
466,b-4_501-1014_662.wav,VTTS_b-4_501-1014_662.wav,2640,2635,5
467,b-3_4104-4206_4193.wav,VTTS_b-3_4104-4206_4193.wav,2290,2310,-20
468,b-1_3026-3126_3028.wav,VTTS_b-1_3026-3126_3028.wav,2020,1846,174
469,b-4_2000-5164_3357.wav,VTTS_b-4_2000-5164_3357.wav,2422,3541,-1119
470,b-3_294-391_362.wav,VTTS_b-3_294-391_362.wav,4280,3982,298
471,b-1_2422-2522_2432.wav,VTTS_b-1_2422-2522_2432.wav,1780,1393,387
472,b-1_3531-3631_3574.wav,VTTS_b-1_3531-3631_3574.wav,1320,1335,-15
473,b-4_2000-5164_3840.wav,VTTS_b-4_2000-5164_3840.wav,4654,4574,80
474,b-3_4315-4424_4329.wav,VTTS_b-3_4315-4424_4329.wav,4260,3576,684
475,b-3_2524-2854_2822.wav,VTTS_b-3_2524-2854_2822.wav,1170,1091,79
476,b-3_1960-2000_1976.wav,VTTS_b-3_1960-2000_1976.wav,2360,2241,119
477,b-4_2000-5164_2053.wav,VTTS_b-4_2000-5164_2053.wav,8830,8557,273
478,b-3_6301-6400_6326.wav,VTTS_b-3_6301-6400_6326.wav,1580,1509,71
479,b-4_2000-5164_4141.wav,VTTS_b-4_2000-5164_4141.wav,2034,1939,95
480,b-4_2000-5164_4511.wav,VTTS_b-4_2000-5164_4511.wav,5682,6780,-1098
481,b-3_5009-5427_5257.wav,VTTS_b-3_5009-5427_5257.wav,1590,1451,139
482,b-1_3632-3732_3684.wav,VTTS_b-1_3632-3732_3684.wav,4450,4574,-124
483,b-4_501-1014_563.wav,VTTS_b-4_501-1014_563.wav,4180,4435,-255
484,b-2_1019-1120_1072.wav,VTTS_b-2_1019-1120_1072.wav,5190,3309,1881
485,b-3_392-500_435.wav,VTTS_b-3_392-500_435.wav,4930,5108,-178
486,b-4_2000-5164_4934.wav,VTTS_b-4_2000-5164_4934.wav,5272,4911,361
487,b-4_2000-5164_4596.wav,VTTS_b-4_2000-5164_4596.wav,3668,3344,324
488,b-1_1212-1312_1291.wav,VTTS_b-1_1212-1312_1291.wav,1060,1022,38
489,b-2_2209-2310_2293.wav,VTTS_b-2_2209-2310_2293.wav,1340,1544,-204
490,b-1_1111-1211_1126.wav,VTTS_b-1_1111-1211_1126.wav,2410,2844,-434
491,b-4_2000-5164_2097.wav,VTTS_b-4_2000-5164_2097.wav,4505,5085,-580
492,b-3_6701-6800_6729.wav,VTTS_b-3_6701-6800_6729.wav,9840,8475,1365
493,b-3_5009-5427_5304.wav,VTTS_b-3_5009-5427_5304.wav,3920,3901,19
494,b-3_501-930_692.wav,VTTS_b-3_501-930_692.wav,5450,5445,5
495,b-3_2177-2266_2195.wav,VTTS_b-3_2177-2266_2195.wav,8140,7674,466
496,b-1_686-793_786.wav,VTTS_b-1_686-793_786.wav,1700,1556,144
497,b-1_3127-3227_3149.wav,VTTS_b-1_3127-3227_3149.wav,4320,4180,140
498,b-2_407-508_424.wav,VTTS_b-2_407-508_424.wav,2460,1985,475
499,b-3_5853-5956_5900.wav,VTTS_b-3_5853-5956_5900.wav,4210,5573,-1363
500,b-4_2000-5164_4690.wav,VTTS_b-4_2000-5164_4690.wav,9084,8348,736
501,b-1_4106-4141_4138.wav,VTTS_b-1_4106-4141_4138.wav,2570,4052,-1482
502,b-4_1221-1300_1297.wav,VTTS_b-4_1221-1300_1297.wav,7320,7152,168
503,b-3_1568-1665_1599.wav,VTTS_b-3_1568-1665_1599.wav,6260,6351,-91
504,b-3_2855-2942_2929.wav,VTTS_b-3_2855-2942_2929.wav,3070,3088,-18
505,b-4_2000-5164_2135.wav,VTTS_b-4_2000-5164_2135.wav,6420,7384,-964
506,b-2_1-100_20.wav,VTTS_b-2_1-100_20.wav,2040,2159,-119
507,b-4_1901-2000_1966.wav,VTTS_b-4_1901-2000_1966.wav,3630,3738,-108
508,b-4_1301-1400_1306.wav,VTTS_b-4_1301-1400_1306.wav,1990,1741,249
509,b-3_3715-3802_3747.wav,VTTS_b-3_3715-3802_3747.wav,5500,5724,-224
510,b-3_5428-5533_5481.wav,VTTS_b-3_5428-5533_5481.wav,3030,2937,93
511,b-1_2725-2825_2751.wav,VTTS_b-1_2725-2825_2751.wav,1180,1126,54
512,b-4_2000-5164_3329.wav,VTTS_b-4_2000-5164_3329.wav,3049,3506,-457
513,b-4_2000-5164_5074.wav,VTTS_b-4_2000-5164_5074.wav,3123,3135,-12
514,b-4_2000-5164_2451.wav,VTTS_b-4_2000-5164_2451.wav,5100,5178,-78
515,b-4_53-150_80.wav,VTTS_b-4_53-150_80.wav,8470,8081,389
516,b-4_2000-5164_5134.wav,VTTS_b-4_2000-5164_5134.wav,982,906,76
517,b-2_1801-1902_1895.wav,VTTS_b-2_1801-1902_1895.wav,1270,1300,-30
518,b-1_3733-3833_3804.wav,VTTS_b-1_3733-3833_3804.wav,1260,1324,-64
519,b-4_2000-5164_5143.wav,VTTS_b-4_2000-5164_5143.wav,12460,11610,850
520,b-3_2177-2266_2261.wav,VTTS_b-3_2177-2266_2261.wav,5320,5422,-102
521,b-2_1699-1800_1732.wav,VTTS_b-2_1699-1800_1732.wav,4360,3390,970
522,b-2_1903-2038_1999.wav,VTTS_b-2_1903-2038_1999.wav,3690,3878,-188
523,b-3_501-930_702.wav,VTTS_b-3_501-930_702.wav,3790,4063,-273
524,b-3_501-930_597.wav,VTTS_b-3_501-930_597.wav,5760,6571,-811
525,b-1_1010-1110_1030.wav,VTTS_b-1_1010-1110_1030.wav,2560,2264,296
526,b-4_2000-5164_2856.wav,VTTS_b-4_2000-5164_2856.wav,1435,1289,146
527,b-3_4607-5008_4818.wav,VTTS_b-3_4607-5008_4818.wav,4670,5422,-752
528,b-3_1862-1959_1875.wav,VTTS_b-3_1862-1959_1875.wav,4560,4551,9
529,b-3_2177-2266_2220.wav,VTTS_b-3_2177-2266_2220.wav,5110,5097,13
530,b-4_501-1014_612.wav,VTTS_b-4_501-1014_612.wav,3120,3181,-61
531,b-2_1019-1120_1081.wav,VTTS_b-2_1019-1120_1081.wav,2960,4133,-1173
532,b-3_5745-5852_5794.wav,VTTS_b-3_5745-5852_5794.wav,6730,6432,298
533,b-1_1717-1817_1742.wav,VTTS_b-1_1717-1817_1742.wav,2280,2148,132
534,b-3_294-391_312.wav,VTTS_b-3_294-391_312.wav,5480,4783,697
535,b-2_917-1018_965.wav,VTTS_b-2_917-1018_965.wav,3150,3135,15
536,b-3_4607-5008_4661.wav,VTTS_b-3_4607-5008_4661.wav,3350,3193,157
537,b-4_2000-5164_3232.wav,VTTS_b-4_2000-5164_3232.wav,6927,7233,-306
538,b-2_2413-2500_2431.wav,VTTS_b-2_2413-2500_2431.wav,4740,4702,38
539,b-3_3538-3627_3594.wav,VTTS_b-3_3538-3627_3594.wav,8630,8243,387
540,b-4_2000-5164_3634.wav,VTTS_b-4_2000-5164_3634.wav,5191,5793,-602
541,b-4_1707-1813_1713.wav,VTTS_b-4_1707-1813_1713.wav,2430,2368,62
542,b-2_1903-2038_1934.wav,VTTS_b-2_1903-2038_1934.wav,6180,5759,421
543,b-4_2000-5164_2064.wav,VTTS_b-4_2000-5164_2064.wav,5870,6177,-307
544,b-3_1-97_87.wav,VTTS_b-3_1-97_87.wav,6750,5933,817
545,b-4_2000-5164_4818.wav,VTTS_b-4_2000-5164_4818.wav,6517,6316,201
546,b-1_4358-4393_4386.wav,VTTS_b-1_4358-4393_4386.wav,6550,7012,-462
547,b-3_2943-3024_3013.wav,VTTS_b-3_2943-3024_3013.wav,3720,4075,-355
548,b-2_917-1018_932.wav,VTTS_b-2_917-1018_932.wav,3250,5085,-1835
549,b-3_2434-2523_2451.wav,VTTS_b-3_2434-2523_2451.wav,7950,7732,218
550,b-2_611-712_647.wav,VTTS_b-2_611-712_647.wav,7060,6026,1034
551,b-4_1014-1100_1050.wav,VTTS_b-4_1014-1100_1050.wav,4930,4621,309
552,b-4_1707-1813_1737.wav,VTTS_b-4_1707-1813_1737.wav,3320,2810,510
553,b-3_3538-3627_3621.wav,VTTS_b-3_3538-3627_3621.wav,4060,4342,-282
554,b-2_1019-1120_1106.wav,VTTS_b-2_1019-1120_1106.wav,4150,4412,-262
555,b-1_74-174_143.wav,VTTS_b-1_74-174_143.wav,2650,2299,351
556,b-4_2000-5164_5158.wav,VTTS_b-4_2000-5164_5158.wav,2775,2682,93
557,b-3_1321-1568_1516.wav,VTTS_b-3_1321-1568_1516.wav,2570,2740,-170
558,b-1_2725-2825_2733.wav,VTTS_b-1_2725-2825_2733.wav,950,836,114
559,b-2_509-610_539.wav,VTTS_b-2_509-610_539.wav,1520,1254,266
560,b-4_501-1014_815.wav,VTTS_b-4_501-1014_815.wav,4180,3367,813
561,b-3_3803-3888_3856.wav,VTTS_b-3_3803-3888_3856.wav,6800,6583,217
562,b-4_401-500_451.wav,VTTS_b-4_401-500_451.wav,5920,5561,359
563,b-3_4104-4206_4173.wav,VTTS_b-3_4104-4206_4173.wav,9580,9358,222
564,b-3_6116-6215_6210.wav,VTTS_b-3_6116-6215_6210.wav,1440,1347,93
565,b-4_2000-5164_2488.wav,VTTS_b-4_2000-5164_2488.wav,3260,4702,-1442
566,b-4_2000-5164_4471.wav,VTTS_b-4_2000-5164_4471.wav,8671,9276,-605
567,b-4_2000-5164_4169.wav,VTTS_b-4_2000-5164_4169.wav,7449,7129,320
568,b-4_2000-5164_4466.wav,VTTS_b-4_2000-5164_4466.wav,3770,4005,-235
569,b-3_2855-2942_2912.wav,VTTS_b-3_2855-2942_2912.wav,4010,4017,-7
570,b-1_3329-3429_3335.wav,VTTS_b-1_3329-3429_3335.wav,1500,1370,130
571,b-3_5009-5427_5124.wav,VTTS_b-3_5009-5427_5124.wav,7240,8557,-1317
572,b-4_2000-5164_3153.wav,VTTS_b-4_2000-5164_3153.wav,9973,9172,801
573,b-4_2000-5164_3124.wav,VTTS_b-4_2000-5164_3124.wav,8248,8243,5
574,b-2_1019-1120_1078.wav,VTTS_b-2_1019-1120_1078.wav,1000,1440,-440
575,b-4_1401-1505_1428.wav,VTTS_b-4_1401-1505_1428.wav,6300,5178,1122
576,b-3_2524-2854_2673.wav,VTTS_b-3_2524-2854_2673.wav,7600,8522,-922
577,b-4_2000-5164_4695.wav,VTTS_b-4_2000-5164_4695.wav,7758,7488,270
578,b-3_3454-3537_3463.wav,VTTS_b-3_3454-3537_3463.wav,4470,4981,-511
579,b-3_4104-4206_4130.wav,VTTS_b-3_4104-4206_4130.wav,830,824,6
580,b-3_6900-7016_6903.wav,VTTS_b-3_6900-7016_6903.wav,4730,4470,260
581,b-1_1010-1110_1054.wav,VTTS_b-1_1010-1110_1054.wav,4930,4063,867
582,b-1_3531-3631_3605.wav,VTTS_b-1_3531-3631_3605.wav,3640,3506,134
583,b-3_4607-5008_4615.wav,VTTS_b-3_4607-5008_4615.wav,3290,3042,248
584,b-4_1301-1400_1364.wav,VTTS_b-4_1301-1400_1364.wav,6870,6873,-3
585,b-3_392-500_426.wav,VTTS_b-3_392-500_426.wav,3090,2995,95
586,b-3_3279-3363_3349.wav,VTTS_b-3_3279-3363_3349.wav,5950,5550,400
587,b-3_4607-5008_4619.wav,VTTS_b-3_4607-5008_4619.wav,2700,3518,-818
588,b-3_1568-1665_1595.wav,VTTS_b-3_1568-1665_1595.wav,4010,3762,248
589,b-4_301-400_400.wav,VTTS_b-4_301-400_400.wav,5930,11610,-5680
590,b-1_2624-2724_2679.wav,VTTS_b-1_2624-2724_2679.wav,3540,2995,545
591,b-1_2523-2623_2548.wav,VTTS_b-1_2523-2623_2548.wav,3460,4284,-824
592,b-4_1601-1706_1645.wav,VTTS_b-4_1601-1706_1645.wav,8270,8638,-368
593,b-3_1666-1763_1715.wav,VTTS_b-3_1666-1763_1715.wav,2600,2972,-372
594,b-2_1-100_19.wav,VTTS_b-2_1-100_19.wav,1990,1846,144
595,b-1_1616-1716_1693.wav,VTTS_b-1_1616-1716_1693.wav,1660,1591,69
596,b-1_74-174_160.wav,VTTS_b-1_74-174_160.wav,950,1033,-83
597,b-4_501-1014_577.wav,VTTS_b-4_501-1014_577.wav,5490,5248,242
598,b-3_501-930_757.wav,VTTS_b-3_501-930_757.wav,2370,1927,443
599,b-1_3733-3833_3789.wav,VTTS_b-1_3733-3833_3789.wav,3270,3471,-201
600,b-3_2177-2266_2189.wav,VTTS_b-3_2177-2266_2189.wav,8250,8185,65
601,b-4_2000-5164_3784.wav,VTTS_b-4_2000-5164_3784.wav,3690,5062,-1372
602,b-4_2000-5164_2889.wav,VTTS_b-4_2000-5164_2889.wav,5940,5631,309
603,b-4_401-500_499.wav,VTTS_b-4_401-500_499.wav,7770,7546,224
604,b-1_2321-2421_2321.wav,VTTS_b-1_2321-2421_2321.wav,1680,1846,-166
605,b-3_2943-3024_2976.wav,VTTS_b-3_2943-3024_2976.wav,1090,1207,-117
606,b-1_74-174_164.wav,VTTS_b-1_74-174_164.wav,1330,1776,-446
607,b-1_3127-3227_3161.wav,VTTS_b-1_3127-3227_3161.wav,3060,2914,146
608,b-1_3127-3227_3213.wav,VTTS_b-1_3127-3227_3213.wav,1990,1939,51
609,b-2_509-610_593.wav,VTTS_b-2_509-610_593.wav,2570,3379,-809
610,b-1_4106-4141_4117.wav,VTTS_b-1_4106-4141_4117.wav,2420,2902,-482
611,b-1_3329-3429_3411.wav,VTTS_b-1_3329-3429_3411.wav,2300,2717,-417
612,b-3_3538-3627_3612.wav,VTTS_b-3_3538-3627_3612.wav,4830,4598,232
613,b-3_6501-6600_6540.wav,VTTS_b-3_6501-6600_6540.wav,6830,6107,723
614,b-2_1903-2038_2005.wav,VTTS_b-2_1903-2038_2005.wav,2410,1498,912
615,b-4_501-1014_852.wav,VTTS_b-4_501-1014_852.wav,2640,2473,167
616,b-4_1901-2000_1961.wav,VTTS_b-4_1901-2000_1961.wav,4450,3738,712
617,b-1_4214-4285_4251.wav,VTTS_b-1_4214-4285_4251.wav,1670,2206,-536
618,b-1_1111-1211_1156.wav,VTTS_b-1_1111-1211_1156.wav,4150,4122,28
619,b-3_3715-3802_3728.wav,VTTS_b-3_3715-3802_3728.wav,6560,7477,-917
620,b-1_2725-2825_2799.wav,VTTS_b-1_2725-2825_2799.wav,5030,4574,456
621,b-3_1321-1568_1429.wav,VTTS_b-3_1321-1568_1429.wav,6240,6362,-122
622,b-4_1401-1505_1422.wav,VTTS_b-4_1401-1505_1422.wav,4830,11610,-6780
623,b-1_2624-2724_2656.wav,VTTS_b-1_2624-2724_2656.wav,1580,1765,-185
624,b-3_4001-4103_4028.wav,VTTS_b-3_4001-4103_4028.wav,8530,7744,786
625,b-1_2220-2320_2301.wav,VTTS_b-1_2220-2320_2301.wav,1820,2101,-281
626,b-1_3026-3126_3086.wav,VTTS_b-1_3026-3126_3086.wav,3140,3065,75
627,b-4_151-300_254.wav,VTTS_b-4_151-300_254.wav,8430,8290,140
628,b-1_794-1009_847.wav,VTTS_b-1_794-1009_847.wav,3130,3135,-5
629,b-3_501-930_902.wav,VTTS_b-3_501-930_902.wav,4760,4807,-47
630,b-2_2413-2500_2427.wav,VTTS_b-2_2413-2500_2427.wav,3120,2682,438
631,b-3_1321-1568_1332.wav,VTTS_b-3_1321-1568_1332.wav,2620,2694,-74
632,b-3_2524-2854_2833.wav,VTTS_b-3_2524-2854_2833.wav,4140,6908,-2768
633,b-3_5533-5638_5600.wav,VTTS_b-3_5533-5638_5600.wav,3560,3541,19
634,b-1_3430-3530_3471.wav,VTTS_b-1_3430-3530_3471.wav,2510,2287,223
635,b-1_1616-1716_1710.wav,VTTS_b-1_1616-1716_1710.wav,3160,2717,443
636,b-3_4607-5008_4832.wav,VTTS_b-3_4607-5008_4832.wav,2870,3669,-799
637,b-4_2000-5164_3571.wav,VTTS_b-4_2000-5164_3571.wav,1917,1811,106
638,b-3_6501-6600_6512.wav,VTTS_b-3_6501-6600_6512.wav,7760,7558,202
639,b-4_2000-5164_2490.wav,VTTS_b-4_2000-5164_2490.wav,3070,3785,-715
640,b-1_4214-4285_4277.wav,VTTS_b-1_4214-4285_4277.wav,3080,4609,-1529
641,b-3_6016-6115_6069.wav,VTTS_b-3_6016-6115_6069.wav,4440,3994,446
642,b-3_1764-1861_1807.wav,VTTS_b-3_1764-1861_1807.wav,2300,2601,-301
643,b-4_301-400_343.wav,VTTS_b-4_301-400_343.wav,7590,7140,450
644,b-4_1601-1706_1700.wav,VTTS_b-4_1601-1706_1700.wav,3880,3471,409
645,b-4_2000-5164_4357.wav,VTTS_b-4_2000-5164_4357.wav,4909,5143,-234
646,b-3_5009-5427_5418.wav,VTTS_b-3_5009-5427_5418.wav,2550,2485,65
647,b-1_377-477_418.wav,VTTS_b-1_377-477_418.wav,1200,1474,-274
648,b-1_794-1009_925.wav,VTTS_b-1_794-1009_925.wav,2070,1916,154
649,b-1_3127-3227_3217.wav,VTTS_b-1_3127-3227_3217.wav,3300,3204,96
650,b-3_2943-3024_2997.wav,VTTS_b-3_2943-3024_2997.wav,2400,2194,206
651,b-2_1903-2038_1914.wav,VTTS_b-2_1903-2038_1914.wav,3430,2937,493
652,b-3_4207-4314_4277.wav,VTTS_b-3_4207-4314_4277.wav,2600,2879,-279
653,b-2_917-1018_992.wav,VTTS_b-2_917-1018_992.wav,1270,1474,-204
654,b-4_1221-1300_1264.wav,VTTS_b-4_1221-1300_1264.wav,6740,6235,505
655,b-4_2000-5164_3429.wav,VTTS_b-4_2000-5164_3429.wav,2176,2345,-169
656,b-1_1818-1918_1862.wav,VTTS_b-1_1818-1918_1862.wav,1980,2032,-52
657,b-4_2000-5164_3808.wav,VTTS_b-4_2000-5164_3808.wav,3099,2879,220
658,b-3_5533-5638_5636.wav,VTTS_b-3_5533-5638_5636.wav,2900,2728,172
659,b-2_1325-1426_1407.wav,VTTS_b-2_1325-1426_1407.wav,2240,2438,-198
660,b-3_2943-3024_3000.wav,VTTS_b-3_2943-3024_3000.wav,8530,8800,-270
661,b-4_2000-5164_4822.wav,VTTS_b-4_2000-5164_4822.wav,7022,8696,-1674
662,b-4_2000-5164_2136.wav,VTTS_b-4_2000-5164_2136.wav,4040,4795,-755
663,b-1_3531-3631_3566.wav,VTTS_b-1_3531-3631_3566.wav,1270,1358,-88
664,b-1_4106-4141_4110.wav,VTTS_b-1_4106-4141_4110.wav,1690,1625,65
665,b-4_2000-5164_4900.wav,VTTS_b-4_2000-5164_4900.wav,2256,3379,-1123
666,b-3_5009-5427_5150.wav,VTTS_b-3_5009-5427_5150.wav,5050,4621,429
667,b-4_2000-5164_2847.wav,VTTS_b-4_2000-5164_2847.wav,1530,1265,265
668,b-1_1212-1312_1311.wav,VTTS_b-1_1212-1312_1311.wav,2870,2473,397
669,b-3_6900-7016_6933.wav,VTTS_b-3_6900-7016_6933.wav,8300,8313,-13
670,b-4_2000-5164_5063.wav,VTTS_b-4_2000-5164_5063.wav,8473,11610,-3137
671,b-1_1313-1413_1384.wav,VTTS_b-1_1313-1413_1384.wav,2460,1985,475
672,b-3_2089-2176_2113.wav,VTTS_b-3_2089-2176_2113.wav,8350,8557,-207
673,b-1_2321-2421_2344.wav,VTTS_b-1_2321-2421_2344.wav,3290,4017,-727
674,b-1_175-275_176.wav,VTTS_b-1_175-275_176.wav,2540,4598,-2058
675,b-4_301-400_384.wav,VTTS_b-4_301-400_384.wav,4720,4261,459
676,b-4_2000-5164_2985.wav,VTTS_b-4_2000-5164_2985.wav,7654,7105,549
677,b-1_1616-1716_1707.wav,VTTS_b-1_1616-1716_1707.wav,2250,2032,218
678,b-3_2524-2854_2674.wav,VTTS_b-3_2524-2854_2674.wav,3540,3750,-210
679,b-4_2000-5164_3670.wav,VTTS_b-4_2000-5164_3670.wav,5221,5283,-62
680,b-3_6016-6115_6096.wav,VTTS_b-3_6016-6115_6096.wav,7730,8127,-397
681,b-2_1427-1562_1458.wav,VTTS_b-2_1427-1562_1458.wav,1550,1440,110
682,b-4_1014-1100_1087.wav,VTTS_b-4_1014-1100_1087.wav,6020,5747,273
683,b-2_1019-1120_1037.wav,VTTS_b-2_1019-1120_1037.wav,2820,3913,-1093
684,b-1_1616-1716_1681.wav,VTTS_b-1_1616-1716_1681.wav,1930,1718,212
685,b-3_4104-4206_4186.wav,VTTS_b-3_4104-4206_4186.wav,4030,4110,-80
686,b-3_6401-6500_6404.wav,VTTS_b-3_6401-6500_6404.wav,10070,8603,1467
687,b-3_3889-4000_3953.wav,VTTS_b-3_3889-4000_3953.wav,5550,5492,58
688,b-2_509-610_587.wav,VTTS_b-2_509-610_587.wav,6730,7129,-399
689,b-4_2000-5164_2130.wav,VTTS_b-4_2000-5164_2130.wav,6030,5840,190
690,b-3_6301-6400_6358.wav,VTTS_b-3_6301-6400_6358.wav,6700,7697,-997
691,b-4_2000-5164_4874.wav,VTTS_b-4_2000-5164_4874.wav,2486,2833,-347
692,b-4_2000-5164_4767.wav,VTTS_b-4_2000-5164_4767.wav,8599,8951,-352
693,b-2_2413-2500_2470.wav,VTTS_b-2_2413-2500_2470.wav,5860,5457,403
694,b-4_2000-5164_3955.wav,VTTS_b-4_2000-5164_3955.wav,3834,4156,-322
695,b-2_2311-2412_2348.wav,VTTS_b-2_2311-2412_2348.wav,3650,4621,-971
696,b-3_6501-6600_6595.wav,VTTS_b-3_6501-6600_6595.wav,4360,4435,-75
697,b-2_815-916_838.wav,VTTS_b-2_815-916_838.wav,1240,1231,9
698,b-4_2000-5164_2048.wav,VTTS_b-4_2000-5164_2048.wav,4555,5550,-995
699,b-2_1563-1596_1578.wav,VTTS_b-2_1563-1596_1578.wav,4480,7361,-2881
700,b-3_4607-5008_4641.wav,VTTS_b-3_4607-5008_4641.wav,1890,1718,172
701,b-2_611-712_665.wav,VTTS_b-2_611-712_665.wav,2410,3019,-609
702,b-4_2000-5164_4920.wav,VTTS_b-4_2000-5164_4920.wav,6727,6815,-88
703,b-1_650-685_673.wav,VTTS_b-1_650-685_673.wav,1000,1184,-184
704,b-4_2000-5164_3167.wav,VTTS_b-4_2000-5164_3167.wav,2803,2345,458
705,b-3_3112-3197_3135.wav,VTTS_b-3_3112-3197_3135.wav,3200,2728,472
706,b-3_4001-4103_4002.wav,VTTS_b-3_4001-4103_4002.wav,4350,4888,-538
707,b-2_713-814_809.wav,VTTS_b-2_713-814_809.wav,6730,5329,1401
708,b-4_2000-5164_4534.wav,VTTS_b-4_2000-5164_4534.wav,3558,3611,-53
709,b-1_276-376_309.wav,VTTS_b-1_276-376_309.wav,3450,3553,-103
710,b-1_1111-1211_1152.wav,VTTS_b-1_1111-1211_1152.wav,4120,3413,707
711,b-1_2826-2926_2853.wav,VTTS_b-1_2826-2926_2853.wav,1090,1115,-25
712,b-3_1321-1568_1378.wav,VTTS_b-3_1321-1568_1378.wav,3720,3262,458
713,b-1_1515-1615_1587.wav,VTTS_b-1_1515-1615_1587.wav,2280,2125,155
714,b-3_5428-5533_5532.wav,VTTS_b-3_5428-5533_5532.wav,9690,9311,379
715,b-1_377-477_429.wav,VTTS_b-1_377-477_429.wav,2460,3274,-814
716,b-1_3026-3126_3109.wav,VTTS_b-1_3026-3126_3109.wav,3870,3564,306
717,b-3_6301-6400_6381.wav,VTTS_b-3_6301-6400_6381.wav,6400,5608,792
718,b-4_301-400_327.wav,VTTS_b-4_301-400_327.wav,4360,4098,262
719,b-3_3889-4000_3950.wav,VTTS_b-3_3889-4000_3950.wav,9900,10379,-479
720,b-2_2073-2106_2103.wav,VTTS_b-2_2073-2106_2103.wav,3810,4017,-207
721,b-3_501-930_623.wav,VTTS_b-3_501-930_623.wav,8700,8580,120
722,b-1_3632-3732_3637.wav,VTTS_b-1_3632-3732_3637.wav,1120,1057,63
723,b-1_686-793_695.wav,VTTS_b-1_686-793_695.wav,910,975,-65
724,b-4_2000-5164_2874.wav,VTTS_b-4_2000-5164_2874.wav,3805,4563,-758
725,b-4_53-150_146.wav,VTTS_b-4_53-150_146.wav,6990,7976,-986
726,b-4_2000-5164_5114.wav,VTTS_b-4_2000-5164_5114.wav,10716,11610,-894
727,b-3_980-1077_1046.wav,VTTS_b-3_980-1077_1046.wav,5450,4656,794
728,b-2_509-610_594.wav,VTTS_b-2_509-610_594.wav,3080,3402,-322
729,b-1_276-376_281.wav,VTTS_b-1_276-376_281.wav,1290,2322,-1032
730,b-3_5745-5852_5780.wav,VTTS_b-3_5745-5852_5780.wav,6230,6060,170
731,b-3_6401-6500_6457.wav,VTTS_b-3_6401-6500_6457.wav,3740,3320,420
732,b-1_3733-3833_3759.wav,VTTS_b-1_3733-3833_3759.wav,1470,1556,-86
733,b-3_6401-6500_6442.wav,VTTS_b-3_6401-6500_6442.wav,7380,6850,530
734,b-1_4394-4429_4409.wav,VTTS_b-1_4394-4429_4409.wav,1750,1683,67
735,b-4_2000-5164_2696.wav,VTTS_b-4_2000-5164_2696.wav,2755,2740,15
736,b-4_2000-5164_4431.wav,VTTS_b-4_2000-5164_4431.wav,6142,6943,-801
737,b-1_1313-1413_1328.wav,VTTS_b-1_1313-1413_1328.wav,2750,2601,149
738,b-4_1707-1813_1710.wav,VTTS_b-4_1707-1813_1710.wav,14890,11610,3280
739,b-4_501-1014_731.wav,VTTS_b-4_501-1014_731.wav,1700,1672,28
740,b-3_1321-1568_1435.wav,VTTS_b-3_1321-1568_1435.wav,6530,6467,63
741,b-1_2826-2926_2835.wav,VTTS_b-1_2826-2926_2835.wav,1970,2287,-317
742,b-1_2624-2724_2717.wav,VTTS_b-1_2624-2724_2717.wav,1350,1649,-299
743,b-4_2000-5164_4012.wav,VTTS_b-4_2000-5164_4012.wav,2370,2287,83
744,b-3_294-391_371.wav,VTTS_b-3_294-391_371.wav,5190,4795,395
745,b-3_5853-5956_5923.wav,VTTS_b-3_5853-5956_5923.wav,2890,2740,150
746,b-1_3935-4033_3965.wav,VTTS_b-1_3935-4033_3965.wav,1700,1730,-30
747,b-3_4607-5008_4939.wav,VTTS_b-3_4607-5008_4939.wav,3850,3692,158
748,b-3_3279-3363_3359.wav,VTTS_b-3_3279-3363_3359.wav,6110,5793,317
749,b-2_1801-1902_1854.wav,VTTS_b-2_1801-1902_1854.wav,2210,1509,701
750,b-2_815-916_843.wav,VTTS_b-2_815-916_843.wav,4280,5724,-1444
751,b-4_2000-5164_2611.wav,VTTS_b-4_2000-5164_2611.wav,1830,1776,54
752,b-4_1814-1900_1826.wav,VTTS_b-4_1814-1900_1826.wav,5340,5143,197
753,b-3_5639-5744_5740.wav,VTTS_b-3_5639-5744_5740.wav,2920,2821,99
754,b-3_1764-1861_1798.wav,VTTS_b-3_1764-1861_1798.wav,7590,11610,-4020
755,b-2_1801-1902_1856.wav,VTTS_b-2_1801-1902_1856.wav,1900,1521,379
756,b-2_2413-2500_2491.wav,VTTS_b-2_2413-2500_2491.wav,2440,2543,-103
757,b-1_1010-1110_1073.wav,VTTS_b-1_1010-1110_1073.wav,1680,1637,43
758,b-1_2220-2320_2287.wav,VTTS_b-1_2220-2320_2287.wav,1290,1602,-312
759,b-3_6601-6700_6619.wav,VTTS_b-3_6601-6700_6619.wav,2890,2601,289
760,b-1_1616-1716_1682.wav,VTTS_b-1_1616-1716_1682.wav,3890,11366,-7476
761,b-3_4607-5008_4665.wav,VTTS_b-3_4607-5008_4665.wav,9330,7988,1342
762,b-3_1321-1568_1520.wav,VTTS_b-3_1321-1568_1520.wav,2280,2345,-65
763,b-3_3803-3888_3814.wav,VTTS_b-3_3803-3888_3814.wav,5900,6722,-822
764,b-1_74-174_136.wav,VTTS_b-1_74-174_136.wav,2100,1695,405
765,b-4_2000-5164_3045.wav,VTTS_b-4_2000-5164_3045.wav,7791,7848,-57
766,b-4_1014-1100_1035.wav,VTTS_b-4_1014-1100_1035.wav,3400,3170,230
767,b-3_392-500_433.wav,VTTS_b-3_392-500_433.wav,4530,4389,141
768,b-1_1616-1716_1668.wav,VTTS_b-1_1616-1716_1668.wav,6700,5410,1290
769,b-4_1814-1900_1849.wav,VTTS_b-4_1814-1900_1849.wav,2030,1672,358
770,b-2_815-916_836.wav,VTTS_b-2_815-916_836.wav,2480,2276,204
771,b-4_1301-1400_1369.wav,VTTS_b-4_1301-1400_1369.wav,5750,5712,38
772,b-1_2725-2825_2758.wav,VTTS_b-1_2725-2825_2758.wav,1620,2206,-586
773,b-3_6301-6400_6393.wav,VTTS_b-3_6301-6400_6393.wav,8730,8440,290
774,b-3_1666-1763_1703.wav,VTTS_b-3_1666-1763_1703.wav,2720,2937,-217
775,b-2_611-712_685.wav,VTTS_b-2_611-712_685.wav,1870,1939,-69
776,b-1_3430-3530_3446.wav,VTTS_b-1_3430-3530_3446.wav,1750,1556,194
777,b-1_1515-1615_1548.wav,VTTS_b-1_1515-1615_1548.wav,1160,1022,138
778,b-3_4498-4605_4530.wav,VTTS_b-3_4498-4605_4530.wav,3780,3901,-121
779,b-1_579-649_597.wav,VTTS_b-1_579-649_597.wav,2070,1834,236
780,b-3_6601-6700_6670.wav,VTTS_b-3_6601-6700_6670.wav,3460,3576,-116
781,b-3_4607-5008_4865.wav,VTTS_b-3_4607-5008_4865.wav,3570,3599,-29
782,b-1_2119-2219_2158.wav,VTTS_b-1_2119-2219_2158.wav,950,1033,-83
783,b-4_1101-1220_1137.wav,VTTS_b-4_1101-1220_1137.wav,5930,5201,729
784,b-2_407-508_433.wav,VTTS_b-2_407-508_433.wav,2250,2218,32
785,b-4_2000-5164_4409.wav,VTTS_b-4_2000-5164_4409.wav,2870,2566,304
786,b-2_1563-1596_1582.wav,VTTS_b-2_1563-1596_1582.wav,5530,5399,131
787,b-3_6900-7016_6958.wav,VTTS_b-3_6900-7016_6958.wav,2940,2299,641
788,b-3_2434-2523_2518.wav,VTTS_b-3_2434-2523_2518.wav,7210,8127,-917
789,b-2_1597-1698_1646.wav,VTTS_b-2_1597-1698_1646.wav,1390,1277,113
790,b-3_1568-1665_1623.wav,VTTS_b-3_1568-1665_1623.wav,3060,3495,-435
791,b-3_2434-2523_2504.wav,VTTS_b-3_2434-2523_2504.wav,3910,3913,-3
792,b-2_917-1018_943.wav,VTTS_b-2_917-1018_943.wav,3390,4899,-1509
793,b-4_1101-1220_1130.wav,VTTS_b-4_1101-1220_1130.wav,8620,8870,-250
794,b-3_1666-1763_1668.wav,VTTS_b-3_1666-1763_1668.wav,2580,2740,-160
795,b-2_2413-2500_2450.wav,VTTS_b-2_2413-2500_2450.wav,4580,5375,-795
796,b-3_4607-5008_4957.wav,VTTS_b-3_4607-5008_4957.wav,4820,4656,164
797,b-3_2434-2523_2450.wav,VTTS_b-3_2434-2523_2450.wav,3510,3402,108
798,b-3_5009-5427_5059.wav,VTTS_b-3_5009-5427_5059.wav,3390,3646,-256
799,b-4_2000-5164_4615.wav,VTTS_b-4_2000-5164_4615.wav,2531,2368,163
800,b-1_3430-3530_3523.wav,VTTS_b-1_3430-3530_3523.wav,3420,3332,88
801,b-4_1301-1400_1350.wav,VTTS_b-4_1301-1400_1350.wav,7120,6571,549
802,b-2_1121-1222_1163.wav,VTTS_b-2_1121-1222_1163.wav,4710,4598,112
803,b-1_3531-3631_3595.wav,VTTS_b-1_3531-3631_3595.wav,1180,1138,42
804,b-4_2000-5164_4134.wav,VTTS_b-4_2000-5164_4134.wav,7164,8603,-1439
805,b-3_196-293_264.wav,VTTS_b-3_196-293_264.wav,6780,6211,569
806,b-4_2000-5164_3793.wav,VTTS_b-4_2000-5164_3793.wav,3980,3576,404
807,b-2_509-610_577.wav,VTTS_b-2_509-610_577.wav,6850,9218,-2368
808,b-3_1568-1665_1624.wav,VTTS_b-3_1568-1665_1624.wav,6160,6594,-434
809,b-4_2000-5164_2244.wav,VTTS_b-4_2000-5164_2244.wav,1300,1091,209
810,b-2_1019-1120_1048.wav,VTTS_b-2_1019-1120_1048.wav,1740,1718,22
811,b-3_2524-2854_2742.wav,VTTS_b-3_2524-2854_2742.wav,9460,9369,91
812,b-1_2321-2421_2382.wav,VTTS_b-1_2321-2421_2382.wav,2250,2078,172
813,b-1_794-1009_878.wav,VTTS_b-1_794-1009_878.wav,1150,975,175
814,b-3_3279-3363_3331.wav,VTTS_b-3_3279-3363_3331.wav,1480,1393,87
815,b-4_2000-5164_2676.wav,VTTS_b-4_2000-5164_2676.wav,9280,8975,305
816,b-4_2000-5164_2183.wav,VTTS_b-4_2000-5164_2183.wav,7430,7663,-233
817,b-3_1321-1568_1355.wav,VTTS_b-3_1321-1568_1355.wav,2300,2496,-196
818,b-4_2000-5164_2752.wav,VTTS_b-4_2000-5164_2752.wav,7515,7082,433
819,b-3_4425-4497_4475.wav,VTTS_b-3_4425-4497_4475.wav,3380,3715,-335
820,b-4_2000-5164_4435.wav,VTTS_b-4_2000-5164_4435.wav,5105,4458,647
821,b-3_6900-7016_6954.wav,VTTS_b-3_6900-7016_6954.wav,3530,3495,35
822,b-2_1325-1426_1396.wav,VTTS_b-2_1325-1426_1396.wav,2200,1823,377
823,b-3_5009-5427_5355.wav,VTTS_b-3_5009-5427_5355.wav,3670,3367,303
824,b-3_392-500_450.wav,VTTS_b-3_392-500_450.wav,5280,6931,-1651
825,b-4_1506-1600_1566.wav,VTTS_b-4_1506-1600_1566.wav,2750,2752,-2
826,b-3_2089-2176_2144.wav,VTTS_b-3_2089-2176_2144.wav,5980,6641,-661
827,b-4_2000-5164_2153.wav,VTTS_b-4_2000-5164_2153.wav,9885,9718,167
828,b-3_2524-2854_2701.wav,VTTS_b-3_2524-2854_2701.wav,2890,2902,-12
829,b-4_53-150_85.wav,VTTS_b-4_53-150_85.wav,7280,7883,-603
830,b-3_4315-4424_4317.wav,VTTS_b-3_4315-4424_4317.wav,6810,7094,-284
831,b-2_1-100_43.wav,VTTS_b-2_1-100_43.wav,1400,2647,-1247
832,b-1_2018-2118_2065.wav,VTTS_b-1_2018-2118_2065.wav,1600,2032,-432
833,b-4_2000-5164_2930.wav,VTTS_b-4_2000-5164_2930.wav,1727,1498,229
834,b-3_501-930_921.wav,VTTS_b-3_501-930_921.wav,7500,7198,302
835,b-3_2524-2854_2763.wav,VTTS_b-3_2524-2854_2763.wav,2520,2067,453
836,b-4_2000-5164_3311.wav,VTTS_b-4_2000-5164_3311.wav,1764,1544,220
837,b-3_501-930_625.wav,VTTS_b-3_501-930_625.wav,6470,6397,73
838,b-1_686-793_757.wav,VTTS_b-1_686-793_757.wav,3650,3599,51
839,b-4_2000-5164_3651.wav,VTTS_b-4_2000-5164_3651.wav,3424,3971,-547
840,b-4_501-1014_692.wav,VTTS_b-4_501-1014_692.wav,7900,7546,354
841,b-3_3025-3111_3064.wav,VTTS_b-3_3025-3111_3064.wav,5930,5608,322
842,b-3_4607-5008_4766.wav,VTTS_b-3_4607-5008_4766.wav,5070,11610,-6540
843,b-1_74-174_150.wav,VTTS_b-1_74-174_150.wav,2590,3111,-521
844,b-2_407-508_416.wav,VTTS_b-2_407-508_416.wav,1430,1347,83
845,b-4_2000-5164_3421.wav,VTTS_b-4_2000-5164_3421.wav,5402,5329,73
846,b-4_2000-5164_3484.wav,VTTS_b-4_2000-5164_3484.wav,6940,7140,-200
847,b-1_2523-2623_2544.wav,VTTS_b-1_2523-2623_2544.wav,2440,2368,72
848,b-1_1414-1514_1431.wav,VTTS_b-1_1414-1514_1431.wav,5250,4783,467
849,b-3_2524-2854_2646.wav,VTTS_b-3_2524-2854_2646.wav,2530,2914,-384
850,b-3_3364-3453_3418.wav,VTTS_b-3_3364-3453_3418.wav,4530,5538,-1008
851,b-2_1903-2038_1953.wav,VTTS_b-2_1903-2038_1953.wav,1400,1405,-5
852,b-3_6900-7016_6911.wav,VTTS_b-3_6900-7016_6911.wav,2050,1904,146
853,b-4_2000-5164_4987.wav,VTTS_b-4_2000-5164_4987.wav,6117,7430,-1313
854,b-3_1568-1665_1577.wav,VTTS_b-3_1568-1665_1577.wav,4720,4145,575
855,b-1_2624-2724_2662.wav,VTTS_b-1_2624-2724_2662.wav,4210,4180,30
856,b-3_6116-6215_6160.wav,VTTS_b-3_6116-6215_6160.wav,8760,8893,-133
857,b-3_5639-5744_5686.wav,VTTS_b-3_5639-5744_5686.wav,6460,5921,539
858,b-1_478-578_571.wav,VTTS_b-1_478-578_571.wav,1770,1718,52
859,b-3_3198-3278_3207.wav,VTTS_b-3_3198-3278_3207.wav,7110,6594,516
860,b-4_2000-5164_2645.wav,VTTS_b-4_2000-5164_2645.wav,3420,3587,-167
861,b-1_4358-4393_4367.wav,VTTS_b-1_4358-4393_4367.wav,1820,1730,90
862,b-3_2855-2942_2877.wav,VTTS_b-3_2855-2942_2877.wav,2580,2612,-32
863,b-4_2000-5164_4023.wav,VTTS_b-4_2000-5164_4023.wav,8501,8986,-485
864,b-1_1111-1211_1159.wav,VTTS_b-1_1111-1211_1159.wav,2590,3216,-626
865,b-1_4142-4177_4160.wav,VTTS_b-1_4142-4177_4160.wav,3100,3309,-209
866,b-3_501-930_523.wav,VTTS_b-3_501-930_523.wav,5350,5004,346
867,b-2_305-406_314.wav,VTTS_b-2_305-406_314.wav,4100,4249,-149
868,b-4_1-52_20.wav,VTTS_b-4_1-52_20.wav,6190,6943,-753
869,b-3_3803-3888_3811.wav,VTTS_b-3_3803-3888_3811.wav,930,871,59
870,b-4_2000-5164_3000.wav,VTTS_b-4_2000-5164_3000.wav,4439,4296,143
871,b-1_377-477_454.wav,VTTS_b-1_377-477_454.wav,3580,3599,-19
872,b-2_1325-1426_1416.wav,VTTS_b-2_1325-1426_1416.wav,2740,3239,-499
873,b-2_101-202_121.wav,VTTS_b-2_101-202_121.wav,2500,4342,-1842
874,b-4_2000-5164_2972.wav,VTTS_b-4_2000-5164_2972.wav,7500,6745,755
875,b-4_1707-1813_1756.wav,VTTS_b-4_1707-1813_1756.wav,1130,1033,97
876,b-1_1919-2017_1956.wav,VTTS_b-1_1919-2017_1956.wav,5150,4841,309
877,b-3_4425-4497_4493.wav,VTTS_b-3_4425-4497_4493.wav,5330,5259,71
878,b-3_3715-3802_3785.wav,VTTS_b-3_3715-3802_3785.wav,10700,11610,-910
879,b-3_98-195_150.wav,VTTS_b-3_98-195_150.wav,4970,5712,-742
880,b-2_1427-1562_1466.wav,VTTS_b-2_1427-1562_1466.wav,7930,9694,-1764
881,b-1_686-793_698.wav,VTTS_b-1_686-793_698.wav,2310,2241,69
882,b-3_392-500_484.wav,VTTS_b-3_392-500_484.wav,5960,5178,782
883,b-1_2220-2320_2315.wav,VTTS_b-1_2220-2320_2315.wav,2090,1974,116
884,b-2_1597-1698_1653.wav,VTTS_b-2_1597-1698_1653.wav,2020,1869,151
885,b-4_2000-5164_2461.wav,VTTS_b-4_2000-5164_2461.wav,1660,1683,-23
886,b-2_713-814_812.wav,VTTS_b-2_713-814_812.wav,2560,2891,-331
887,b-1_74-174_168.wav,VTTS_b-1_74-174_168.wav,2680,2972,-292
888,b-1_1515-1615_1531.wav,VTTS_b-1_1515-1615_1531.wav,2130,1997,133
889,b-3_6016-6115_6035.wav,VTTS_b-3_6016-6115_6035.wav,4660,6002,-1342
890,b-1_2826-2926_2855.wav,VTTS_b-1_2826-2926_2855.wav,2580,2635,-55
891,b-1_3228-3328_3283.wav,VTTS_b-1_3228-3328_3283.wav,3600,3785,-185
892,b-1_3834-3934_3867.wav,VTTS_b-1_3834-3934_3867.wav,1770,2159,-389
893,b-4_2000-5164_3517.wav,VTTS_b-4_2000-5164_3517.wav,3549,3193,356
894,b-3_4607-5008_4693.wav,VTTS_b-3_4607-5008_4693.wav,3250,3239,11
895,b-4_2000-5164_4521.wav,VTTS_b-4_2000-5164_4521.wav,4330,4481,-151
896,b-4_1901-2000_1959.wav,VTTS_b-4_1901-2000_1959.wav,3350,3123,227
897,b-4_2000-5164_3014.wav,VTTS_b-4_2000-5164_3014.wav,4723,6269,-1546
898,b-1_1313-1413_1387.wav,VTTS_b-1_1313-1413_1387.wav,1680,1962,-282
899,b-1_4430-4465_4432.wav,VTTS_b-1_4430-4465_4432.wav,4100,4598,-498
900,b-4_2000-5164_2303.wav,VTTS_b-4_2000-5164_2303.wav,3240,3274,-34
901,b-4_2000-5164_2191.wav,VTTS_b-4_2000-5164_2191.wav,3290,3425,-135
902,b-4_2000-5164_5146.wav,VTTS_b-4_2000-5164_5146.wav,6195,8069,-1874
903,b-4_2000-5164_3395.wav,VTTS_b-4_2000-5164_3395.wav,1644,1567,77
904,b-1_794-1009_874.wav,VTTS_b-1_794-1009_874.wav,8800,11610,-2810
905,b-4_2000-5164_2677.wav,VTTS_b-4_2000-5164_2677.wav,5310,6838,-1528
906,b-3_2350-2433_2385.wav,VTTS_b-3_2350-2433_2385.wav,8900,9601,-701
907,b-4_2000-5164_4924.wav,VTTS_b-4_2000-5164_4924.wav,5243,5213,30
908,b-2_1427-1562_1455.wav,VTTS_b-2_1427-1562_1455.wav,3530,3077,453
909,b-4_2000-5164_4449.wav,VTTS_b-4_2000-5164_4449.wav,4333,4458,-125
910,b-1_1010-1110_1063.wav,VTTS_b-1_1010-1110_1063.wav,5180,5561,-381
911,b-4_2000-5164_2405.wav,VTTS_b-4_2000-5164_2405.wav,2940,2949,-9
912,b-1_794-1009_890.wav,VTTS_b-1_794-1009_890.wav,3720,3843,-123
913,b-2_1801-1902_1807.wav,VTTS_b-2_1801-1902_1807.wav,1420,1300,120
914,b-3_294-391_379.wav,VTTS_b-3_294-391_379.wav,2410,2159,251
915,b-3_5533-5638_5631.wav,VTTS_b-3_5533-5638_5631.wav,5310,5201,109
916,b-1_3127-3227_3198.wav,VTTS_b-1_3127-3227_3198.wav,1610,1614,-4
917,b-1_2018-2118_2076.wav,VTTS_b-1_2018-2118_2076.wav,2070,2078,-8
918,b-4_1814-1900_1874.wav,VTTS_b-4_1814-1900_1874.wav,4380,3611,769
919,b-3_5533-5638_5591.wav,VTTS_b-3_5533-5638_5591.wav,2900,2984,-84
920,b-1_1515-1615_1572.wav,VTTS_b-1_1515-1615_1572.wav,1320,1428,-108
921,b-1_175-275_224.wav,VTTS_b-1_175-275_224.wav,4450,7372,-2922
922,b-1_3026-3126_3037.wav,VTTS_b-1_3026-3126_3037.wav,2620,2543,77
923,b-1_1-73_31.wav,VTTS_b-1_1-73_31.wav,1710,1707,3
924,b-2_1427-1562_1534.wav,VTTS_b-2_1427-1562_1534.wav,2940,2705,235
925,b-4_2000-5164_4568.wav,VTTS_b-4_2000-5164_4568.wav,8645,9451,-806
926,b-2_1597-1698_1672.wav,VTTS_b-2_1597-1698_1672.wav,3550,4574,-1024
927,b-3_3025-3111_3090.wav,VTTS_b-3_3025-3111_3090.wav,9060,7814,1246
928,b-4_151-300_151.wav,VTTS_b-4_151-300_151.wav,5970,5248,722
929,b-3_5853-5956_5921.wav,VTTS_b-3_5853-5956_5921.wav,3760,3855,-95
930,b-3_1321-1568_1359.wav,VTTS_b-3_1321-1568_1359.wav,8100,8858,-758
931,b-1_3228-3328_3231.wav,VTTS_b-1_3228-3328_3231.wav,1770,1672,98
932,b-3_2855-2942_2916.wav,VTTS_b-3_2855-2942_2916.wav,3850,3959,-109
933,b-1_2422-2522_2469.wav,VTTS_b-1_2422-2522_2469.wav,3560,3564,-4
934,b-3_1321-1568_1485.wav,VTTS_b-3_1321-1568_1485.wav,3980,3913,67
935,b-2_305-406_379.wav,VTTS_b-2_305-406_379.wav,2120,2125,-5
936,b-4_2000-5164_2125.wav,VTTS_b-4_2000-5164_2125.wav,3080,3274,-194
937,b-3_6501-6600_6591.wav,VTTS_b-3_6501-6600_6591.wav,5820,4853,967
938,b-3_1079-1320_1154.wav,VTTS_b-3_1079-1320_1154.wav,4800,4899,-99
939,b-2_815-916_823.wav,VTTS_b-2_815-916_823.wav,2240,2345,-105
940,b-4_2000-5164_4017.wav,VTTS_b-4_2000-5164_4017.wav,1970,1811,159
941,b-1_3531-3631_3630.wav,VTTS_b-1_3531-3631_3630.wav,4230,4505,-275
942,b-4_2000-5164_2082.wav,VTTS_b-4_2000-5164_2082.wav,2220,2763,-543
943,b-1_74-174_144.wav,VTTS_b-1_74-174_144.wav,2950,4040,-1090
944,b-4_501-1014_637.wav,VTTS_b-4_501-1014_637.wav,4070,4772,-702
945,b-3_4607-5008_4864.wav,VTTS_b-3_4607-5008_4864.wav,3700,4238,-538
946,b-1_2624-2724_2671.wav,VTTS_b-1_2624-2724_2671.wav,4310,4412,-102
947,b-3_6900-7016_7005.wav,VTTS_b-3_6900-7016_7005.wav,4100,3785,315
948,b-3_1-97_54.wav,VTTS_b-3_1-97_54.wav,2340,2322,18
949,b-4_501-1014_548.wav,VTTS_b-4_501-1014_548.wav,2110,2055,55
950,b-3_1079-1320_1308.wav,VTTS_b-3_1079-1320_1308.wav,1510,1463,47
951,b-2_2311-2412_2391.wav,VTTS_b-2_2311-2412_2391.wav,4680,4412,268
952,b-1_686-793_759.wav,VTTS_b-1_686-793_759.wav,4910,4667,243
953,b-3_5639-5744_5667.wav,VTTS_b-3_5639-5744_5667.wav,6640,7198,-558
954,b-1_3935-4033_4003.wav,VTTS_b-1_3935-4033_4003.wav,2680,2601,79
955,b-3_3803-3888_3860.wav,VTTS_b-3_3803-3888_3860.wav,2380,3518,-1138
956,b-3_3364-3453_3446.wav,VTTS_b-3_3364-3453_3446.wav,3400,3982,-582
957,b-3_4315-4424_4403.wav,VTTS_b-3_4315-4424_4403.wav,7660,9102,-1442
958,b-4_2000-5164_4708.wav,VTTS_b-4_2000-5164_4708.wav,2420,2090,330
959,b-4_2000-5164_2725.wav,VTTS_b-4_2000-5164_2725.wav,9955,8557,1398
960,b-4_2000-5164_4751.wav,VTTS_b-4_2000-5164_4751.wav,1169,1022,147
961,b-4_2000-5164_3809.wav,VTTS_b-4_2000-5164_3809.wav,5114,5410,-296
962,b-3_501-930_665.wav,VTTS_b-3_501-930_665.wav,3350,3379,-29
963,b-4_1014-1100_1078.wav,VTTS_b-4_1014-1100_1078.wav,4390,4505,-115
964,b-3_3454-3537_3491.wav,VTTS_b-3_3454-3537_3491.wav,4220,4214,6
965,b-4_2000-5164_5087.wav,VTTS_b-4_2000-5164_5087.wav,4496,4458,38
966,b-4_2000-5164_2994.wav,VTTS_b-4_2000-5164_2994.wav,1530,1219,311
967,b-4_2000-5164_2895.wav,VTTS_b-4_2000-5164_2895.wav,3500,3181,319
968,b-3_5533-5638_5537.wav,VTTS_b-3_5533-5638_5537.wav,5830,6316,-486
969,b-1_1818-1918_1866.wav,VTTS_b-1_1818-1918_1866.wav,2000,1950,50
970,b-4_2000-5164_4986.wav,VTTS_b-4_2000-5164_4986.wav,2097,1904,193
971,b-1_4394-4429_4407.wav,VTTS_b-1_4394-4429_4407.wav,1760,1463,297
972,b-2_2107-2193_2156.wav,VTTS_b-2_2107-2193_2156.wav,3550,2844,706
973,b-3_5009-5427_5179.wav,VTTS_b-3_5009-5427_5179.wav,5470,4992,478
974,b-4_1601-1706_1629.wav,VTTS_b-4_1601-1706_1629.wav,3400,3100,300
975,b-3_6501-6600_6548.wav,VTTS_b-3_6501-6600_6548.wav,1260,1254,6
976,b-4_2000-5164_3298.wav,VTTS_b-4_2000-5164_3298.wav,3046,3146,-100
977,b-4_2000-5164_3098.wav,VTTS_b-4_2000-5164_3098.wav,2421,2183,238
978,b-4_2000-5164_4576.wav,VTTS_b-4_2000-5164_4576.wav,3200,5016,-1816
979,b-2_1-100_96.wav,VTTS_b-2_1-100_96.wav,2610,4075,-1465
980,b-2_1325-1426_1404.wav,VTTS_b-2_1325-1426_1404.wav,1880,1637,243
981,b-2_1801-1902_1862.wav,VTTS_b-2_1801-1902_1862.wav,1600,1683,-83
982,b-1_478-578_564.wav,VTTS_b-1_478-578_564.wav,1660,2426,-766
983,b-1_3531-3631_3583.wav,VTTS_b-1_3531-3631_3583.wav,2410,2415,-5
984,b-4_2000-5164_4313.wav,VTTS_b-4_2000-5164_4313.wav,4730,4493,237
985,b-1_1616-1716_1678.wav,VTTS_b-1_1616-1716_1678.wav,1820,2032,-212
986,b-1_579-649_581.wav,VTTS_b-1_579-649_581.wav,4840,4621,219
987,b-1_276-376_300.wav,VTTS_b-1_276-376_300.wav,1410,1521,-111
988,b-1_478-578_507.wav,VTTS_b-1_478-578_507.wav,2530,2752,-222
989,b-2_1699-1800_1724.wav,VTTS_b-2_1699-1800_1724.wav,1910,1811,99
990,b-3_392-500_424.wav,VTTS_b-3_392-500_424.wav,7720,11610,-3890
991,b-4_501-1014_505.wav,VTTS_b-4_501-1014_505.wav,3270,3762,-492
992,b-1_794-1009_854.wav,VTTS_b-1_794-1009_854.wav,1680,1741,-61
993,b-1_377-477_378.wav,VTTS_b-1_377-477_378.wav,1460,1324,136
994,b-4_2000-5164_3503.wav,VTTS_b-4_2000-5164_3503.wav,7801,8464,-663
995,b-4_1101-1220_1207.wav,VTTS_b-4_1101-1220_1207.wav,1700,1556,144
996,b-1_3632-3732_3654.wav,VTTS_b-1_3632-3732_3654.wav,3340,3831,-491
997,b-4_301-400_345.wav,VTTS_b-4_301-400_345.wav,4530,4505,25
998,b-1_3733-3833_3829.wav,VTTS_b-1_3733-3833_3829.wav,2120,1916,204
999,b-4_1301-1400_1398.wav,VTTS_b-4_1301-1400_1398.wav,2160,1939,221
1000,b-4_1506-1600_1567.wav,VTTS_b-4_1506-1600_1567.wav,3730,3483,247
1001,b-1_2826-2926_2834.wav,VTTS_b-1_2826-2926_2834.wav,3060,3065,-5
1002,b-2_611-712_617.wav,VTTS_b-2_611-712_617.wav,1920,2113,-193
1003,b-4_2000-5164_3325.wav,VTTS_b-4_2000-5164_3325.wav,2843,3077,-234
1004,b-2_2040-2072_2054.wav,VTTS_b-2_2040-2072_2054.wav,3260,3437,-177
1005,b-2_305-406_373.wav,VTTS_b-2_305-406_373.wav,1170,1103,67
1006,b-1_686-793_764.wav,VTTS_b-1_686-793_764.wav,3660,3216,444
1007,b-3_1321-1568_1430.wav,VTTS_b-3_1321-1568_1430.wav,1500,1370,130
1008,b-1_1919-2017_1989.wav,VTTS_b-1_1919-2017_1989.wav,2350,2694,-344
1009,b-3_4607-5008_4624.wav,VTTS_b-3_4607-5008_4624.wav,2850,2519,331
1010,b-4_2000-5164_3201.wav,VTTS_b-4_2000-5164_3201.wav,9629,9648,-19
1011,b-4_2000-5164_3018.wav,VTTS_b-4_2000-5164_3018.wav,810,755,55
1012,b-1_74-174_79.wav,VTTS_b-1_74-174_79.wav,1510,1300,210
1013,b-2_1699-1800_1703.wav,VTTS_b-2_1699-1800_1703.wav,10480,9044,1436
1014,b-2_1-100_71.wav,VTTS_b-2_1-100_71.wav,1640,1567,73
1015,b-3_980-1077_1018.wav,VTTS_b-3_980-1077_1018.wav,2740,2833,-93
1016,b-4_2000-5164_3710.wav,VTTS_b-4_2000-5164_3710.wav,5380,5132,248
1017,b-3_5639-5744_5645.wav,VTTS_b-3_5639-5744_5645.wav,4260,4679,-419
1018,b-3_3803-3888_3845.wav,VTTS_b-3_3803-3888_3845.wav,2700,2241,459
1019,b-3_2943-3024_3005.wav,VTTS_b-3_2943-3024_3005.wav,6680,6920,-240
1020,b-1_377-477_397.wav,VTTS_b-1_377-477_397.wav,2070,2392,-322
1021,b-4_151-300_185.wav,VTTS_b-4_151-300_185.wav,4040,3634,406
1022,b-3_1-97_18.wav,VTTS_b-3_1-97_18.wav,7230,7140,90
1023,b-2_1121-1222_1177.wav,VTTS_b-2_1121-1222_1177.wav,8090,6223,1867
1024,b-1_1111-1211_1216.wav,VTTS_b-1_1111-1211_1216.wav,4500,5317,-817
1025,b-3_3454-3537_3503.wav,VTTS_b-3_3454-3537_3503.wav,6940,7616,-676
1026,b-4_501-1014_703.wav,VTTS_b-4_501-1014_703.wav,2870,2078,792
1027,b-3_5009-5427_5076.wav,VTTS_b-3_5009-5427_5076.wav,6290,6246,44
1028,b-2_2209-2310_2221.wav,VTTS_b-2_2209-2310_2221.wav,1630,1916,-286
1029,b-2_2107-2193_2179.wav,VTTS_b-2_2107-2193_2179.wav,1250,1231,19
1030,b-1_1919-2017_2014.wav,VTTS_b-1_1919-2017_2014.wav,2460,2334,126
1031,b-4_2000-5164_4028.wav,VTTS_b-4_2000-5164_4028.wav,5048,4841,207
1032,b-1_2119-2219_2127.wav,VTTS_b-1_2119-2219_2127.wav,2370,2171,199
1033,b-3_6801-6900_6831.wav,VTTS_b-3_6801-6900_6831.wav,6790,7825,-1035
1034,b-3_2434-2523_2456.wav,VTTS_b-3_2434-2523_2456.wav,7300,6571,729
1035,b-4_2000-5164_3728.wav,VTTS_b-4_2000-5164_3728.wav,8750,9973,-1223
1036,b-3_4425-4497_4495.wav,VTTS_b-3_4425-4497_4495.wav,7950,8638,-688
1037,b-3_980-1077_981.wav,VTTS_b-3_980-1077_981.wav,5930,4644,1286
1038,b-1_478-578_508.wav,VTTS_b-1_478-578_508.wav,2230,2345,-115
1039,b-3_5009-5427_5183.wav,VTTS_b-3_5009-5427_5183.wav,3530,3518,12
1040,b-2_1121-1222_1184.wav,VTTS_b-2_1121-1222_1184.wav,4170,4946,-776
1041,b-1_4430-4465_4431.wav,VTTS_b-1_4430-4465_4431.wav,3810,5108,-1298
1042,b-4_2000-5164_2262.wav,VTTS_b-4_2000-5164_2262.wav,5420,5248,172
1043,b-4_1707-1813_1762.wav,VTTS_b-4_1707-1813_1762.wav,3360,3495,-135
1044,b-1_4322-4357_4357.wav,VTTS_b-1_4322-4357_4357.wav,1840,1765,75
1045,b-1_3026-3126_3101.wav,VTTS_b-1_3026-3126_3101.wav,2890,3030,-140
1046,b-4_501-1014_813.wav,VTTS_b-4_501-1014_813.wav,3790,3506,284
1047,b-4_2000-5164_3401.wav,VTTS_b-4_2000-5164_3401.wav,1651,1533,118
1048,b-2_815-916_866.wav,VTTS_b-2_815-916_866.wav,1200,1219,-19
1049,b-4_2000-5164_3541.wav,VTTS_b-4_2000-5164_3541.wav,6324,5863,461
1050,b-4_2000-5164_2003.wav,VTTS_b-4_2000-5164_2003.wav,6502,7732,-1230
1051,b-4_2000-5164_3459.wav,VTTS_b-4_2000-5164_3459.wav,3668,3936,-268
1052,b-4_301-400_305.wav,VTTS_b-4_301-400_305.wav,3340,3402,-62
1053,b-4_2000-5164_2362.wav,VTTS_b-4_2000-5164_2362.wav,5620,5817,-197
1054,b-2_815-916_897.wav,VTTS_b-2_815-916_897.wav,1720,2380,-660
1055,b-1_794-1009_939.wav,VTTS_b-1_794-1009_939.wav,3370,3820,-450
1056,b-4_501-1014_521.wav,VTTS_b-4_501-1014_521.wav,3850,4992,-1142
1057,b-4_2000-5164_4798.wav,VTTS_b-4_2000-5164_4798.wav,8964,11610,-2646
1058,b-3_3364-3453_3450.wav,VTTS_b-3_3364-3453_3450.wav,4950,4737,213
1059,b-4_151-300_232.wav,VTTS_b-4_151-300_232.wav,6290,5817,473
1060,b-3_1079-1320_1289.wav,VTTS_b-3_1079-1320_1289.wav,8960,9300,-340
1061,b-3_4001-4103_4097.wav,VTTS_b-3_4001-4103_4097.wav,6730,7326,-596
1062,b-4_2000-5164_2026.wav,VTTS_b-4_2000-5164_2026.wav,4260,4690,-430
1063,b-4_1014-1100_1024.wav,VTTS_b-4_1014-1100_1024.wav,8960,7059,1901
1064,b-2_1-100_24.wav,VTTS_b-2_1-100_24.wav,4440,6908,-2468
1065,b-4_2000-5164_2323.wav,VTTS_b-4_2000-5164_2323.wav,3925,3553,372
1066,b-4_2000-5164_5113.wav,VTTS_b-4_2000-5164_5113.wav,4873,6711,-1838
1067,b-2_1427-1562_1538.wav,VTTS_b-2_1427-1562_1538.wav,1720,1660,60
1068,b-3_6801-6900_6844.wav,VTTS_b-3_6801-6900_6844.wav,3370,3355,15
1069,b-2_1121-1222_1182.wav,VTTS_b-2_1121-1222_1182.wav,2010,1602,408
1070,b-4_2000-5164_2283.wav,VTTS_b-4_2000-5164_2283.wav,2220,3030,-810
1071,b-4_53-150_86.wav,VTTS_b-4_53-150_86.wav,7420,7790,-370
1072,b-1_1818-1918_1907.wav,VTTS_b-1_1818-1918_1907.wav,2440,2415,25
1073,b-1_2927-3025_3014.wav,VTTS_b-1_2927-3025_3014.wav,1330,1254,76
1074,b-1_2927-3025_3021.wav,VTTS_b-1_2927-3025_3021.wav,1750,1672,78
1075,b-4_1221-1300_1236.wav,VTTS_b-4_1221-1300_1236.wav,3210,3344,-134
1076,b-2_1121-1222_1157.wav,VTTS_b-2_1121-1222_1157.wav,2150,2810,-660
1077,b-2_2413-2500_2494.wav,VTTS_b-2_2413-2500_2494.wav,2230,2136,94
1078,b-1_4430-4465_4449.wav,VTTS_b-1_4430-4465_4449.wav,2180,2473,-293
1079,b-4_2000-5164_4250.wav,VTTS_b-4_2000-5164_4250.wav,3462,3344,118
1080,b-1_3531-3631_3545.wav,VTTS_b-1_3531-3631_3545.wav,4310,4690,-380
1081,b-2_1597-1698_1657.wav,VTTS_b-2_1597-1698_1657.wav,2610,2531,79
1082,b-4_1401-1505_1439.wav,VTTS_b-4_1401-1505_1439.wav,4320,4470,-150
1083,b-4_301-400_394.wav,VTTS_b-4_301-400_394.wav,2980,3135,-155
1084,b-1_2422-2522_2511.wav,VTTS_b-1_2422-2522_2511.wav,3480,2090,1390
1085,b-1_4394-4429_4422.wav,VTTS_b-1_4394-4429_4422.wav,4090,7396,-3306
1086,b-4_2000-5164_3795.wav,VTTS_b-4_2000-5164_3795.wav,4540,4331,209
1087,b-1_3632-3732_3668.wav,VTTS_b-1_3632-3732_3668.wav,1530,1451,79
1088,b-4_501-1014_866.wav,VTTS_b-4_501-1014_866.wav,5060,5097,-37
1089,b-4_501-1014_575.wav,VTTS_b-4_501-1014_575.wav,7440,7129,311
1090,b-1_686-793_719.wav,VTTS_b-1_686-793_719.wav,2700,2426,274
1091,b-2_1597-1698_1625.wav,VTTS_b-2_1597-1698_1625.wav,1430,1382,48
1092,b-3_294-391_360.wav,VTTS_b-3_294-391_360.wav,7370,7303,67
1093,b-3_6701-6800_6776.wav,VTTS_b-3_6701-6800_6776.wav,4390,4574,-184
1094,b-4_2000-5164_4352.wav,VTTS_b-4_2000-5164_4352.wav,3255,3646,-391
1095,b-1_1111-1211_1143.wav,VTTS_b-1_1111-1211_1143.wav,4280,3692,588
1096,b-4_2000-5164_2087.wav,VTTS_b-4_2000-5164_2087.wav,4130,5178,-1048
1097,b-3_5533-5638_5534.wav,VTTS_b-3_5533-5638_5534.wav,6460,6536,-76
1098,b-3_6116-6215_6174.wav,VTTS_b-3_6116-6215_6174.wav,5340,6327,-987
1099,b-4_301-400_358.wav,VTTS_b-4_301-400_358.wav,19330,11610,7720
1100,b-3_3454-3537_3475.wav,VTTS_b-3_3454-3537_3475.wav,4180,4272,-92
1101,b-3_2000-2088_2038.wav,VTTS_b-3_2000-2088_2038.wav,7600,8429,-829
1102,b-2_509-610_582.wav,VTTS_b-2_509-610_582.wav,2710,4853,-2143
1103,b-4_2000-5164_2444.wav,VTTS_b-4_2000-5164_2444.wav,4160,4040,120
1104,b-1_2018-2118_2075.wav,VTTS_b-1_2018-2118_2075.wav,1970,1823,147
1105,b-3_5639-5744_5657.wav,VTTS_b-3_5639-5744_5657.wav,3920,3448,472
1106,b-3_6601-6700_6616.wav,VTTS_b-3_6601-6700_6616.wav,6340,7187,-847
1107,b-4_501-1014_649.wav,VTTS_b-4_501-1014_649.wav,6060,6223,-163
1108,b-2_2311-2412_2402.wav,VTTS_b-2_2311-2412_2402.wav,4170,4098,72
1109,b-3_2089-2176_2100.wav,VTTS_b-3_2089-2176_2100.wav,3130,2844,286
1110,b-2_2311-2412_2377.wav,VTTS_b-2_2311-2412_2377.wav,2980,3030,-50
1111,b-3_3279-3363_3286.wav,VTTS_b-3_3279-3363_3286.wav,8280,6188,2092
1112,b-2_1223-1324_1288.wav,VTTS_b-2_1223-1324_1288.wav,9560,8522,1038
1113,b-3_5428-5533_5459.wav,VTTS_b-3_5428-5533_5459.wav,3730,5004,-1274
1114,b-3_1079-1320_1195.wav,VTTS_b-3_1079-1320_1195.wav,5300,5108,192
1115,b-4_2000-5164_3724.wav,VTTS_b-4_2000-5164_3724.wav,6835,6792,43
1116,b-3_4315-4424_4377.wav,VTTS_b-3_4315-4424_4377.wav,3350,3135,215
1117,b-3_4425-4497_4446.wav,VTTS_b-3_4425-4497_4446.wav,5690,6548,-858
1118,b-3_5957-6015_5972.wav,VTTS_b-3_5957-6015_5972.wav,3380,3599,-219
1119,b-1_377-477_415.wav,VTTS_b-1_377-477_415.wav,1680,1869,-189
1120,b-4_501-1014_809.wav,VTTS_b-4_501-1014_809.wav,2520,2473,47
1121,b-4_2000-5164_2987.wav,VTTS_b-4_2000-5164_2987.wav,6249,6641,-392
1122,b-3_6601-6700_6622.wav,VTTS_b-3_6601-6700_6622.wav,5630,5201,429
1123,b-1_794-1009_943.wav,VTTS_b-1_794-1009_943.wav,4040,4458,-418
1124,b-3_6900-7016_6947.wav,VTTS_b-3_6900-7016_6947.wav,3920,3541,379
1125,b-3_931-979_938.wav,VTTS_b-3_931-979_938.wav,3600,3820,-220
1126,b-1_2321-2421_2326.wav,VTTS_b-1_2321-2421_2326.wav,2730,2810,-80
1127,b-3_501-930_534.wav,VTTS_b-3_501-930_534.wav,6190,5979,211
1128,b-3_5745-5852_5837.wav,VTTS_b-3_5745-5852_5837.wav,6130,5886,244
1129,b-1_1313-1413_1366.wav,VTTS_b-1_1313-1413_1366.wav,2030,1765,265
1130,b-1_175-275_237.wav,VTTS_b-1_175-275_237.wav,1460,1242,218
1131,b-1_4034-4069_4051.wav,VTTS_b-1_4034-4069_4051.wav,3460,3680,-220
1132,b-3_6301-6400_6337.wav,VTTS_b-3_6301-6400_6337.wav,980,929,51
1133,b-1_2220-2320_2285.wav,VTTS_b-1_2220-2320_2285.wav,1820,1753,67
1134,b-3_3025-3111_3072.wav,VTTS_b-3_3025-3111_3072.wav,5300,6699,-1399
1135,b-3_4001-4103_4048.wav,VTTS_b-3_4001-4103_4048.wav,7140,9903,-2763
1136,b-2_1325-1426_1336.wav,VTTS_b-2_1325-1426_1336.wav,2240,3088,-848
1137,b-1_175-275_178.wav,VTTS_b-1_175-275_178.wav,1460,1591,-131
1138,b-3_6801-6900_6805.wav,VTTS_b-3_6801-6900_6805.wav,7010,6629,381
1139,b-3_980-1077_1030.wav,VTTS_b-3_980-1077_1030.wav,6970,7407,-437
1140,b-4_1014-1100_1034.wav,VTTS_b-4_1014-1100_1034.wav,1790,1463,327
1141,b-3_3889-4000_3916.wav,VTTS_b-3_3889-4000_3916.wav,4960,3889,1071
1142,b-4_2000-5164_3213.wav,VTTS_b-4_2000-5164_3213.wav,2759,2972,-213
1143,b-1_3228-3328_3230.wav,VTTS_b-1_3228-3328_3230.wav,1530,1451,79
1144,b-1_3127-3227_3189.wav,VTTS_b-1_3127-3227_3189.wav,2760,2543,217
1145,b-3_5428-5533_5509.wav,VTTS_b-3_5428-5533_5509.wav,7220,7338,-118
1146,b-1_1717-1817_1718.wav,VTTS_b-1_1717-1817_1718.wav,4080,3913,167
1147,b-3_1862-1959_1916.wav,VTTS_b-3_1862-1959_1916.wav,5000,5410,-410
1148,b-4_501-1014_953.wav,VTTS_b-4_501-1014_953.wav,8770,8417,353
1149,b-3_2350-2433_2371.wav,VTTS_b-3_2350-2433_2371.wav,6300,6409,-109
1150,b-4_2000-5164_3976.wav,VTTS_b-4_2000-5164_3976.wav,6195,5677,518
1151,b-2_305-406_399.wav,VTTS_b-2_305-406_399.wav,1560,1440,120
1152,b-2_203-304_255.wav,VTTS_b-2_203-304_255.wav,2230,2183,47
1153,b-2_1597-1698_1648.wav,VTTS_b-2_1597-1698_1648.wav,3950,3820,130
1154,b-2_1325-1426_1341.wav,VTTS_b-2_1325-1426_1341.wav,7050,6861,189
1155,b-3_3364-3453_3378.wav,VTTS_b-3_3364-3453_3378.wav,3420,3274,146
1156,b-3_3889-4000_3947.wav,VTTS_b-3_3889-4000_3947.wav,7010,7163,-153
1157,b-1_2119-2219_2151.wav,VTTS_b-1_2119-2219_2151.wav,1460,1451,9
1158,b-4_1601-1706_1613.wav,VTTS_b-4_1601-1706_1613.wav,7610,9567,-1957
1159,b-3_5533-5638_5603.wav,VTTS_b-3_5533-5638_5603.wav,4000,4005,-5
1160,b-3_2524-2854_2588.wav,VTTS_b-3_2524-2854_2588.wav,2270,2461,-191
1161,b-3_1321-1568_1360.wav,VTTS_b-3_1321-1568_1360.wav,10980,11610,-630
1162,b-3_5853-5956_5872.wav,VTTS_b-3_5853-5956_5872.wav,2090,1869,221
1163,b-3_3279-3363_3312.wav,VTTS_b-3_3279-3363_3312.wav,1140,1068,72
1164,b-1_1616-1716_1685.wav,VTTS_b-1_1616-1716_1685.wav,2080,3065,-985
1165,b-1_3531-3631_3552.wav,VTTS_b-1_3531-3631_3552.wav,3700,6722,-3022
1166,b-3_2434-2523_2501.wav,VTTS_b-3_2434-2523_2501.wav,4110,3855,255
1167,b-3_6801-6900_6885.wav,VTTS_b-3_6801-6900_6885.wav,4010,3738,272
1168,b-3_4607-5008_4963.wav,VTTS_b-3_4607-5008_4963.wav,6830,5759,1071
1169,b-3_2524-2854_2536.wav,VTTS_b-3_2524-2854_2536.wav,5620,6536,-916
1170,b-3_6701-6800_6741.wav,VTTS_b-3_6701-6800_6741.wav,1780,1730,50
1171,b-3_1862-1959_1908.wav,VTTS_b-3_1862-1959_1908.wav,4870,5352,-482
1172,b-1_2826-2926_2900.wav,VTTS_b-1_2826-2926_2900.wav,3000,2937,63
1173,b-3_501-930_696.wav,VTTS_b-3_501-930_696.wav,6510,6142,368
1174,b-4_2000-5164_4951.wav,VTTS_b-4_2000-5164_4951.wav,1452,1242,210
1175,b-4_2000-5164_2317.wav,VTTS_b-4_2000-5164_2317.wav,6980,7163,-183
1176,b-3_2943-3024_2960.wav,VTTS_b-3_2943-3024_2960.wav,8610,9346,-736
1177,b-3_3715-3802_3715.wav,VTTS_b-3_3715-3802_3715.wav,4630,5666,-1036
1178,b-1_3228-3328_3285.wav,VTTS_b-1_3228-3328_3285.wav,1950,2113,-163
1179,b-3_5428-5533_5491.wav,VTTS_b-3_5428-5533_5491.wav,4180,4203,-23
1180,b-4_2000-5164_2099.wav,VTTS_b-4_2000-5164_2099.wav,2800,3611,-811
1181,b-2_1019-1120_1033.wav,VTTS_b-2_1019-1120_1033.wav,2170,2496,-326
1182,b-1_478-578_577.wav,VTTS_b-1_478-578_577.wav,2710,2601,109
1183,b-1_2220-2320_2269.wav,VTTS_b-1_2220-2320_2269.wav,2210,1463,747
1184,b-4_2000-5164_3215.wav,VTTS_b-4_2000-5164_3215.wav,4523,4783,-260
1185,b-2_713-814_785.wav,VTTS_b-2_713-814_785.wav,2790,3820,-1030
1186,b-3_6601-6700_6630.wav,VTTS_b-3_6601-6700_6630.wav,2770,2740,30
1187,b-4_2000-5164_4074.wav,VTTS_b-4_2000-5164_4074.wav,4766,4389,377
1188,b-4_1301-1400_1341.wav,VTTS_b-4_1301-1400_1341.wav,6240,7105,-865
1189,b-1_1414-1514_1438.wav,VTTS_b-1_1414-1514_1438.wav,1580,1707,-127
1190,b-1_377-477_461.wav,VTTS_b-1_377-477_461.wav,3650,3843,-193
1191,b-3_5009-5427_5423.wav,VTTS_b-3_5009-5427_5423.wav,5480,6107,-627
1192,b-1_3026-3126_3043.wav,VTTS_b-1_3026-3126_3043.wav,2900,2461,439
1193,b-2_2073-2106_2099.wav,VTTS_b-2_2073-2106_2099.wav,2410,2299,111
1194,b-1_4214-4285_4263.wav,VTTS_b-1_4214-4285_4263.wav,1210,1219,-9
1195,b-1_3632-3732_3728.wav,VTTS_b-1_3632-3732_3728.wav,2090,1707,383
1196,b-4_2000-5164_3864.wav,VTTS_b-4_2000-5164_3864.wav,1263,1277,-14
1197,b-3_4207-4314_4303.wav,VTTS_b-3_4207-4314_4303.wav,3230,2856,374
1198,b-2_1325-1426_1330.wav,VTTS_b-2_1325-1426_1330.wav,1750,1289,461
1199,b-4_2000-5164_4674.wav,VTTS_b-4_2000-5164_4674.wav,8732,8742,-10
1200,b-3_1321-1568_1493.wav,VTTS_b-3_1321-1568_1493.wav,4270,4667,-397
1201,b-4_2000-5164_4903.wav,VTTS_b-4_2000-5164_4903.wav,3664,3715,-51
1202,b-4_1-52_38.wav,VTTS_b-4_1-52_38.wav,8450,8359,91
1203,b-4_2000-5164_2006.wav,VTTS_b-4_2000-5164_2006.wav,5425,6223,-798
1204,b-2_1325-1426_1394.wav,VTTS_b-2_1325-1426_1394.wav,2330,2136,194
1205,b-2_917-1018_929.wav,VTTS_b-2_917-1018_929.wav,4130,4458,-328
1206,b-4_2000-5164_3377.wav,VTTS_b-4_2000-5164_3377.wav,1616,1625,-9
1207,b-3_5009-5427_5119.wav,VTTS_b-3_5009-5427_5119.wav,7210,7639,-429
1208,b-4_2000-5164_5115.wav,VTTS_b-4_2000-5164_5115.wav,3484,3495,-11
1209,b-3_3025-3111_3051.wav,VTTS_b-3_3025-3111_3051.wav,3500,3495,5
1210,b-3_5428-5533_5462.wav,VTTS_b-3_5428-5533_5462.wav,3370,3529,-159
1211,b-3_501-930_587.wav,VTTS_b-3_501-930_587.wav,8250,7802,448
1212,b-2_1019-1120_1073.wav,VTTS_b-2_1019-1120_1073.wav,5320,7117,-1797
1213,b-2_2194-2208_2204.wav,VTTS_b-2_2194-2208_2204.wav,2730,2659,71
1214,b-2_1903-2038_2037.wav,VTTS_b-2_1903-2038_2037.wav,1140,1428,-288
1215,b-4_2000-5164_3420.wav,VTTS_b-4_2000-5164_3420.wav,6629,6792,-163
1216,b-2_1427-1562_1477.wav,VTTS_b-2_1427-1562_1477.wav,4640,5271,-631
1217,b-3_3803-3888_3870.wav,VTTS_b-3_3803-3888_3870.wav,7100,6118,982
1218,b-4_2000-5164_5154.wav,VTTS_b-4_2000-5164_5154.wav,6190,5584,606
1219,b-3_3112-3197_3131.wav,VTTS_b-3_3112-3197_3131.wav,6410,4458,1952
1220,b-1_2725-2825_2774.wav,VTTS_b-1_2725-2825_2774.wav,1790,1556,234
1221,b-2_1427-1562_1429.wav,VTTS_b-2_1427-1562_1429.wav,4030,4493,-463
1222,b-3_5428-5533_5487.wav,VTTS_b-3_5428-5533_5487.wav,2550,2310,240
1223,b-4_2000-5164_2447.wav,VTTS_b-4_2000-5164_2447.wav,3345,3355,-10
1224,b-3_2000-2088_2043.wav,VTTS_b-3_2000-2088_2043.wav,10770,8278,2492
1225,b-1_1515-1615_1591.wav,VTTS_b-1_1515-1615_1591.wav,1860,1776,84
1226,b-3_501-930_867.wav,VTTS_b-3_501-930_867.wav,6630,7036,-406
1227,b-4_1101-1220_1172.wav,VTTS_b-4_1101-1220_1172.wav,2240,2229,11
1228,b-4_1601-1706_1608.wav,VTTS_b-4_1601-1706_1608.wav,8680,8243,437
1229,b-1_3026-3126_3104.wav,VTTS_b-1_3026-3126_3104.wav,1620,1614,6
1230,b-1_3329-3429_3385.wav,VTTS_b-1_3329-3429_3385.wav,1960,1788,172
1231,b-1_2321-2421_2394.wav,VTTS_b-1_2321-2421_2394.wav,2020,1834,186
1232,b-1_3935-4033_3976.wav,VTTS_b-1_3935-4033_3976.wav,2860,3820,-960
1233,b-1_2220-2320_2267.wav,VTTS_b-1_2220-2320_2267.wav,1610,2635,-1025
1234,b-1_1-73_13.wav,VTTS_b-1_1-73_13.wav,1310,1231,79
1235,b-3_392-500_462.wav,VTTS_b-3_392-500_462.wav,6680,6444,236
1236,b-3_2524-2854_2782.wav,VTTS_b-3_2524-2854_2782.wav,3780,2577,1203
1237,b-4_2000-5164_2016.wav,VTTS_b-4_2000-5164_2016.wav,3395,3320,75
1238,b-1_2624-2724_2661.wav,VTTS_b-1_2624-2724_2661.wav,2150,2136,14
1239,b-3_3454-3537_3528.wav,VTTS_b-3_3454-3537_3528.wav,13250,11610,1640
1240,b-3_6601-6700_6681.wav,VTTS_b-3_6601-6700_6681.wav,4670,3959,711
1241,b-1_1414-1514_1480.wav,VTTS_b-1_1414-1514_1480.wav,3920,3576,344
1242,b-3_4001-4103_4039.wav,VTTS_b-3_4001-4103_4039.wav,6440,7767,-1327
1243,b-3_4207-4314_4309.wav,VTTS_b-3_4207-4314_4309.wav,6380,6316,64
1244,b-3_1079-1320_1320.wav,VTTS_b-3_1079-1320_1320.wav,6350,5584,766
1245,b-1_1515-1615_1585.wav,VTTS_b-1_1515-1615_1585.wav,1320,1486,-166
1246,b-2_407-508_462.wav,VTTS_b-2_407-508_462.wav,3450,4156,-706
1247,b-3_1321-1568_1375.wav,VTTS_b-3_1321-1568_1375.wav,3380,2868,512
1248,b-2_1325-1426_1329.wav,VTTS_b-2_1325-1426_1329.wav,2590,2101,489
1249,b-3_6301-6400_6351.wav,VTTS_b-3_6301-6400_6351.wav,3850,3065,785
1250,b-3_4207-4314_4255.wav,VTTS_b-3_4207-4314_4255.wav,7010,6827,183
1251,b-3_2000-2088_2035.wav,VTTS_b-3_2000-2088_2035.wav,2630,2810,-180
1252,b-4_2000-5164_3460.wav,VTTS_b-4_2000-5164_3460.wav,4446,4679,-233
1253,b-4_2000-5164_4092.wav,VTTS_b-4_2000-5164_4092.wav,6021,7198,-1177
1254,b-4_1601-1706_1643.wav,VTTS_b-4_1601-1706_1643.wav,7450,7721,-271
1255,b-1_794-1009_815.wav,VTTS_b-1_794-1009_815.wav,1140,1091,49
1256,b-1_3935-4033_3970.wav,VTTS_b-1_3935-4033_3970.wav,1460,1451,9
1257,b-1_4142-4177_4155.wav,VTTS_b-1_4142-4177_4155.wav,2080,2566,-486
1258,b-4_2000-5164_2907.wav,VTTS_b-4_2000-5164_2907.wav,7286,8185,-899
1259,b-1_2826-2926_2866.wav,VTTS_b-1_2826-2926_2866.wav,3810,3506,304
1260,b-3_1321-1568_1458.wav,VTTS_b-3_1321-1568_1458.wav,5490,5306,184
1261,b-3_4001-4103_4004.wav,VTTS_b-3_4001-4103_4004.wav,4040,3599,441
1262,b-3_4498-4605_4598.wav,VTTS_b-3_4498-4605_4598.wav,6800,6664,136
1263,b-2_2311-2412_2324.wav,VTTS_b-2_2311-2412_2324.wav,2220,3344,-1124
1264,b-1_2523-2623_2568.wav,VTTS_b-1_2523-2623_2568.wav,1210,1231,-21
1265,b-4_2000-5164_3989.wav,VTTS_b-4_2000-5164_3989.wav,5264,4690,574
1266,b-4_2000-5164_3087.wav,VTTS_b-4_2000-5164_3087.wav,6844,7581,-737
1267,b-3_98-195_184.wav,VTTS_b-3_98-195_184.wav,6940,8615,-1675
1268,b-3_3112-3197_3129.wav,VTTS_b-3_3112-3197_3129.wav,5910,11610,-5700
1269,b-3_6701-6800_6757.wav,VTTS_b-3_6701-6800_6757.wav,1990,1776,214
1270,b-4_2000-5164_3342.wav,VTTS_b-4_2000-5164_3342.wav,7124,11610,-4486
1271,b-1_1515-1615_1522.wav,VTTS_b-1_1515-1615_1522.wav,4440,3843,597
1272,b-2_1121-1222_1196.wav,VTTS_b-2_1121-1222_1196.wav,4180,2461,1719
1273,b-2_1903-2038_2000.wav,VTTS_b-2_1903-2038_2000.wav,3660,3657,3
1274,b-1_794-1009_956.wav,VTTS_b-1_794-1009_956.wav,4110,4052,58
1275,b-3_6016-6115_6075.wav,VTTS_b-3_6016-6115_6075.wav,4930,4435,495
1276,b-4_2000-5164_3913.wav,VTTS_b-4_2000-5164_3913.wav,7462,7268,194
1277,b-2_1801-1902_1837.wav,VTTS_b-2_1801-1902_1837.wav,2120,2345,-225
1278,b-2_509-610_513.wav,VTTS_b-2_509-610_513.wav,2920,4540,-1620
1279,b-3_6116-6215_6140.wav,VTTS_b-3_6116-6215_6140.wav,6540,6269,271
1280,b-1_1313-1413_1377.wav,VTTS_b-1_1313-1413_1377.wav,2890,2554,336
1281,b-2_1903-2038_1929.wav,VTTS_b-2_1903-2038_1929.wav,1470,1231,239
1282,b-4_2000-5164_3490.wav,VTTS_b-4_2000-5164_3490.wav,7903,7163,740
1283,b-4_2000-5164_4877.wav,VTTS_b-4_2000-5164_4877.wav,5776,6049,-273
1284,b-1_3834-3934_3900.wav,VTTS_b-1_3834-3934_3900.wav,1960,2055,-95
1285,b-3_3198-3278_3210.wav,VTTS_b-3_3198-3278_3210.wav,5100,4505,595
1286,b-3_1321-1568_1528.wav,VTTS_b-3_1321-1568_1528.wav,4100,3773,327
1287,b-4_2000-5164_2265.wav,VTTS_b-4_2000-5164_2265.wav,7420,7628,-208
1288,b-3_6301-6400_6350.wav,VTTS_b-3_6301-6400_6350.wav,5540,4737,803
1289,b-1_2725-2825_2793.wav,VTTS_b-1_2725-2825_2793.wav,5000,4830,170
1290,b-3_5009-5427_5339.wav,VTTS_b-3_5009-5427_5339.wav,3380,3924,-544
1291,b-2_611-712_662.wav,VTTS_b-2_611-712_662.wav,2980,3146,-166
1292,b-3_6801-6900_6836.wav,VTTS_b-3_6801-6900_6836.wav,2850,3030,-180
1293,b-4_2000-5164_5034.wav,VTTS_b-4_2000-5164_5034.wav,7749,7477,272
1294,b-2_2311-2412_2331.wav,VTTS_b-2_2311-2412_2331.wav,3490,4598,-1108
1295,b-2_611-712_681.wav,VTTS_b-2_611-712_681.wav,2730,2206,524
1296,b-4_1707-1813_1732.wav,VTTS_b-4_1707-1813_1732.wav,2080,1788,292
1297,b-3_2434-2523_2511.wav,VTTS_b-3_2434-2523_2511.wav,7550,8940,-1390
1298,b-3_5428-5533_5523.wav,VTTS_b-3_5428-5533_5523.wav,8070,7790,280
1299,b-4_401-500_419.wav,VTTS_b-4_401-500_419.wav,2740,3077,-337
1300,b-2_305-406_337.wav,VTTS_b-2_305-406_337.wav,1710,1707,3
1301,b-3_2524-2854_2657.wav,VTTS_b-3_2524-2854_2657.wav,3350,3367,-17
1302,b-3_2943-3024_2946.wav,VTTS_b-3_2943-3024_2946.wav,6210,6014,196
1303,b-1_650-685_665.wav,VTTS_b-1_650-685_665.wav,2460,2043,417
1304,b-4_151-300_265.wav,VTTS_b-4_151-300_265.wav,6750,6502,248
1305,b-3_4607-5008_4989.wav,VTTS_b-3_4607-5008_4989.wav,2270,2136,134
1306,b-4_301-400_381.wav,VTTS_b-4_301-400_381.wav,1260,1312,-52
1307,b-3_5009-5427_5433.wav,VTTS_b-3_5009-5427_5433.wav,4770,4830,-60
1308,b-1_1818-1918_1905.wav,VTTS_b-1_1818-1918_1905.wav,4760,4516,244
1309,b-1_2523-2623_2610.wav,VTTS_b-1_2523-2623_2610.wav,3630,4377,-747
1310,b-3_1862-1959_1873.wav,VTTS_b-3_1862-1959_1873.wav,5780,5224,556
1311,b-1_3531-3631_3570.wav,VTTS_b-1_3531-3631_3570.wav,1780,2717,-937
1312,b-4_2000-5164_2107.wav,VTTS_b-4_2000-5164_2107.wav,6100,6002,98
1313,b-1_1-73_27.wav,VTTS_b-1_1-73_27.wav,2040,1904,136
1314,b-3_6016-6115_6016.wav,VTTS_b-3_6016-6115_6016.wav,3140,2810,330
1315,b-4_2000-5164_3689.wav,VTTS_b-4_2000-5164_3689.wav,8786,8696,90
1316,b-3_3112-3197_3147.wav,VTTS_b-3_3112-3197_3147.wav,8650,8104,546
1317,b-3_6274-6300_6297.wav,VTTS_b-3_6274-6300_6297.wav,1490,1486,4
1318,b-4_2000-5164_4766.wav,VTTS_b-4_2000-5164_4766.wav,7201,7767,-566
1319,b-4_2000-5164_2956.wav,VTTS_b-4_2000-5164_2956.wav,4914,4690,224
1320,b-1_686-793_766.wav,VTTS_b-1_686-793_766.wav,2090,2264,-174
1321,b-3_1321-1568_1524.wav,VTTS_b-3_1321-1568_1524.wav,3740,3483,257
1322,b-3_501-930_613.wav,VTTS_b-3_501-930_613.wav,3430,3402,28
1323,b-1_175-275_263.wav,VTTS_b-1_175-275_263.wav,3440,3855,-415
1324,b-3_3364-3453_3385.wav,VTTS_b-3_3364-3453_3385.wav,8460,6734,1726
1325,b-3_5009-5427_5203.wav,VTTS_b-3_5009-5427_5203.wav,5250,4261,989
1326,b-1_4286-4321_4303.wav,VTTS_b-1_4286-4321_4303.wav,3090,3355,-265
1327,b-1_3026-3126_3039.wav,VTTS_b-1_3026-3126_3039.wav,3150,2833,317
1328,b-3_1321-1568_1482.wav,VTTS_b-3_1321-1568_1482.wav,1690,1533,157
1329,b-4_2000-5164_4309.wav,VTTS_b-4_2000-5164_4309.wav,2757,2844,-87
1330,b-1_1616-1716_1672.wav,VTTS_b-1_1616-1716_1672.wav,1090,1219,-129
1331,b-1_1919-2017_1937.wav,VTTS_b-1_1919-2017_1937.wav,4520,4063,457
1332,b-3_2524-2854_2753.wav,VTTS_b-3_2524-2854_2753.wav,7500,8673,-1173
1333,b-3_6401-6500_6471.wav,VTTS_b-3_6401-6500_6471.wav,3750,3460,290
1334,b-1_686-793_755.wav,VTTS_b-1_686-793_755.wav,2750,3030,-280
1335,b-4_2000-5164_4412.wav,VTTS_b-4_2000-5164_4412.wav,10202,10809,-607
1336,b-2_101-202_110.wav,VTTS_b-2_101-202_110.wav,2430,9091,-6661
1337,b-3_5639-5744_5688.wav,VTTS_b-3_5639-5744_5688.wav,4720,4795,-75
1338,b-2_917-1018_1008.wav,VTTS_b-2_917-1018_1008.wav,1330,1207,123
1339,b-3_1079-1320_1236.wav,VTTS_b-3_1079-1320_1236.wav,3870,3402,468
1340,b-4_1101-1220_1191.wav,VTTS_b-4_1101-1220_1191.wav,5540,4714,826
1341,b-4_2000-5164_3306.wav,VTTS_b-4_2000-5164_3306.wav,3731,3866,-135
1342,b-3_5009-5427_5380.wav,VTTS_b-3_5009-5427_5380.wav,4940,6269,-1329
1343,b-1_3632-3732_3661.wav,VTTS_b-1_3632-3732_3661.wav,2640,3146,-506
1344,b-3_5957-6015_6005.wav,VTTS_b-3_5957-6015_6005.wav,2950,2508,442
1345,b-4_2000-5164_2911.wav,VTTS_b-4_2000-5164_2911.wav,5837,6861,-1024
1346,b-2_407-508_504.wav,VTTS_b-2_407-508_504.wav,2200,2659,-459
1347,b-3_392-500_460.wav,VTTS_b-3_392-500_460.wav,5380,6351,-971
1348,b-1_3834-3934_3849.wav,VTTS_b-1_3834-3934_3849.wav,3940,3576,364
1349,b-1_1313-1413_1363.wav,VTTS_b-1_1313-1413_1363.wav,7360,5909,1451
1350,b-3_3889-4000_3966.wav,VTTS_b-3_3889-4000_3966.wav,3440,2961,479
1351,b-1_1111-1211_1139.wav,VTTS_b-1_1111-1211_1139.wav,3510,3541,-31
1352,b-3_4315-4424_4413.wav,VTTS_b-3_4315-4424_4413.wav,1800,1660,140
1353,b-2_2413-2500_2475.wav,VTTS_b-2_2413-2500_2475.wav,5560,5283,277
1354,b-4_2000-5164_2516.wav,VTTS_b-4_2000-5164_2516.wav,6280,7709,-1429
1355,b-2_2413-2500_2455.wav,VTTS_b-2_2413-2500_2455.wav,1180,1207,-27
1356,b-3_5745-5852_5798.wav,VTTS_b-3_5745-5852_5798.wav,6720,6200,520
1357,b-3_196-293_291.wav,VTTS_b-3_196-293_291.wav,4120,4191,-71
1358,b-3_392-500_474.wav,VTTS_b-3_392-500_474.wav,7430,8046,-616
1359,b-4_1707-1813_1777.wav,VTTS_b-4_1707-1813_1777.wav,1820,1695,125
1360,b-2_1801-1902_1870.wav,VTTS_b-2_1801-1902_1870.wav,3840,4052,-212
1361,b-3_1079-1320_1295.wav,VTTS_b-3_1079-1320_1295.wav,2910,2682,228
1362,b-2_815-916_869.wav,VTTS_b-2_815-916_869.wav,1530,1289,241
1363,b-2_815-916_825.wav,VTTS_b-2_815-916_825.wav,2480,1997,483
1364,b-2_1-100_16.wav,VTTS_b-2_1-100_16.wav,2560,3843,-1283
1365,b-4_2000-5164_3242.wav,VTTS_b-4_2000-5164_3242.wav,2690,2276,414
1366,b-3_2855-2942_2878.wav,VTTS_b-3_2855-2942_2878.wav,4210,4307,-97
1367,b-3_6701-6800_6783.wav,VTTS_b-3_6701-6800_6783.wav,8380,7605,775
1368,b-4_2000-5164_3145.wav,VTTS_b-4_2000-5164_3145.wav,6223,6467,-244
1369,b-4_1401-1505_1446.wav,VTTS_b-4_1401-1505_1446.wav,2620,2357,263
1370,b-1_4322-4357_4342.wav,VTTS_b-1_4322-4357_4342.wav,1910,1834,76
1371,b-1_2018-2118_2081.wav,VTTS_b-1_2018-2118_2081.wav,4310,2786,1524
1372,b-4_2000-5164_4324.wav,VTTS_b-4_2000-5164_4324.wav,4213,4470,-257
1373,b-3_5957-6015_5987.wav,VTTS_b-3_5957-6015_5987.wav,5980,5817,163
1374,b-3_3025-3111_3042.wav,VTTS_b-3_3025-3111_3042.wav,4960,4377,583
1375,b-4_2000-5164_4360.wav,VTTS_b-4_2000-5164_4360.wav,4216,4029,187
1376,b-1_3531-3631_3533.wav,VTTS_b-1_3531-3631_3533.wav,2840,2844,-4
1377,b-2_713-814_727.wav,VTTS_b-2_713-814_727.wav,3310,2624,686
1378,b-3_6016-6115_6024.wav,VTTS_b-3_6016-6115_6024.wav,5010,5108,-98
1379,b-1_1111-1211_1119.wav,VTTS_b-1_1111-1211_1119.wav,2650,2856,-206
1380,b-1_4178-4213_4204.wav,VTTS_b-1_4178-4213_4204.wav,1930,2090,-160
1381,b-2_1-100_59.wav,VTTS_b-2_1-100_59.wav,1600,2368,-768
1382,b-3_5009-5427_5311.wav,VTTS_b-3_5009-5427_5311.wav,8020,8011,9
1383,b-4_2000-5164_2169.wav,VTTS_b-4_2000-5164_2169.wav,3120,3170,-50
1384,b-3_3538-3627_3602.wav,VTTS_b-3_3538-3627_3602.wav,2950,2682,268
1385,b-2_1325-1426_1333.wav,VTTS_b-2_1325-1426_1333.wav,2080,1869,211
1386,b-3_2524-2854_2601.wav,VTTS_b-3_2524-2854_2601.wav,2270,2334,-64
1387,b-3_2524-2854_2671.wav,VTTS_b-3_2524-2854_2671.wav,5920,5283,637
1388,b-4_1814-1900_1888.wav,VTTS_b-4_1814-1900_1888.wav,2870,2786,84
1389,b-4_151-300_245.wav,VTTS_b-4_151-300_245.wav,3130,2775,355
1390,b-3_294-391_316.wav,VTTS_b-3_294-391_316.wav,4320,3808,512
1391,b-3_6217-6274_6261.wav,VTTS_b-3_6217-6274_6261.wav,10420,9927,493
1392,b-3_3715-3802_3776.wav,VTTS_b-3_3715-3802_3776.wav,4000,3866,134
1393,b-3_6601-6700_6656.wav,VTTS_b-3_6601-6700_6656.wav,4640,4957,-317
1394,b-4_501-1014_874.wav,VTTS_b-4_501-1014_874.wav,2270,1974,296
1395,b-1_3935-4033_3989.wav,VTTS_b-1_3935-4033_3989.wav,2930,3146,-216
1396,b-4_2000-5164_3691.wav,VTTS_b-4_2000-5164_3691.wav,5560,4772,788
1397,b-3_5745-5852_5814.wav,VTTS_b-3_5745-5852_5814.wav,3400,3123,277
1398,b-4_1506-1600_1561.wav,VTTS_b-4_1506-1600_1561.wav,7510,8719,-1209
1399,b-3_3112-3197_3187.wav,VTTS_b-3_3112-3197_3187.wav,1090,1057,33
1400,b-2_1019-1120_1050.wav,VTTS_b-2_1019-1120_1050.wav,1550,1962,-412
1401,b-1_1-73_43.wav,VTTS_b-1_1-73_43.wav,4140,4331,-191
1402,b-3_5533-5638_5564.wav,VTTS_b-3_5533-5638_5564.wav,5100,5108,-8
1403,b-3_1079-1320_1138.wav,VTTS_b-3_1079-1320_1138.wav,11620,10693,927
1404,b-2_611-712_678.wav,VTTS_b-2_611-712_678.wav,2210,1974,236
1405,b-4_2000-5164_4396.wav,VTTS_b-4_2000-5164_4396.wav,5209,5271,-62
1406,b-2_1699-1800_1731.wav,VTTS_b-2_1699-1800_1731.wav,1470,2171,-701
1407,b-2_1801-1902_1878.wav,VTTS_b-2_1801-1902_1878.wav,3160,3750,-590
1408,b-3_3715-3802_3734.wav,VTTS_b-3_3715-3802_3734.wav,4630,4702,-72
1409,b-4_2000-5164_4318.wav,VTTS_b-4_2000-5164_4318.wav,7572,9207,-1635
1410,b-4_2000-5164_4430.wav,VTTS_b-4_2000-5164_4430.wav,7140,7245,-105
1411,b-4_1-52_18.wav,VTTS_b-4_1-52_18.wav,2070,1753,317
1412,b-1_1616-1716_1704.wav,VTTS_b-1_1616-1716_1704.wav,840,801,39
1413,b-3_4607-5008_4896.wav,VTTS_b-3_4607-5008_4896.wav,5940,5468,472
1414,b-3_980-1077_1001.wav,VTTS_b-3_980-1077_1001.wav,6120,6118,2
1415,b-2_1597-1698_1645.wav,VTTS_b-2_1597-1698_1645.wav,2410,3657,-1247
1416,b-4_2000-5164_2127.wav,VTTS_b-4_2000-5164_2127.wav,2910,3785,-875
1417,b-3_4425-4497_4450.wav,VTTS_b-3_4425-4497_4450.wav,2030,2299,-269
1418,b-3_4498-4605_4603.wav,VTTS_b-3_4498-4605_4603.wav,9290,9009,281
1419,b-3_6301-6400_6347.wav,VTTS_b-3_6301-6400_6347.wav,5260,4865,395
1420,b-4_2000-5164_2144.wav,VTTS_b-4_2000-5164_2144.wav,8540,8034,506
1421,b-2_203-304_261.wav,VTTS_b-2_203-304_261.wav,5820,6385,-565
1422,b-3_5853-5956_5927.wav,VTTS_b-3_5853-5956_5927.wav,5230,5840,-610
1423,b-3_196-293_250.wav,VTTS_b-3_196-293_250.wav,7610,6908,702
1424,b-4_1301-1400_1394.wav,VTTS_b-4_1301-1400_1394.wav,5840,5863,-23
1425,b-1_579-649_614.wav,VTTS_b-1_579-649_614.wav,1160,1149,11
1426,b-3_392-500_423.wav,VTTS_b-3_392-500_423.wav,5310,6548,-1238
1427,b-3_6401-6500_6473.wav,VTTS_b-3_6401-6500_6473.wav,6360,6084,276
1428,b-4_2000-5164_3943.wav,VTTS_b-4_2000-5164_3943.wav,3279,3204,75
1429,b-3_3803-3888_3851.wav,VTTS_b-3_3803-3888_3851.wav,2900,2844,56
1430,b-1_3430-3530_3489.wav,VTTS_b-1_3430-3530_3489.wav,1640,1741,-101
1431,b-1_4106-4141_4130.wav,VTTS_b-1_4106-4141_4130.wav,3340,4168,-828
1432,b-1_3733-3833_3734.wav,VTTS_b-1_3733-3833_3734.wav,1520,1625,-105
1433,b-3_6217-6274_6259.wav,VTTS_b-3_6217-6274_6259.wav,10260,11610,-1350
1434,b-4_2000-5164_4752.wav,VTTS_b-4_2000-5164_4752.wav,2911,3111,-200
1435,b-4_2000-5164_4332.wav,VTTS_b-4_2000-5164_4332.wav,3105,3170,-65
1436,b-3_2855-2942_2934.wav,VTTS_b-3_2855-2942_2934.wav,8650,9868,-1218
1437,b-3_1321-1568_1406.wav,VTTS_b-3_1321-1568_1406.wav,8930,8800,130
1438,b-2_2413-2500_2438.wav,VTTS_b-2_2413-2500_2438.wav,2110,2438,-328
1439,b-3_2177-2266_2204.wav,VTTS_b-3_2177-2266_2204.wav,6060,6362,-302
1440,b-3_501-930_868.wav,VTTS_b-3_501-930_868.wav,4720,5271,-551
1441,b-3_4607-5008_4915.wav,VTTS_b-3_4607-5008_4915.wav,5510,5375,135
1442,b-2_2311-2412_2396.wav,VTTS_b-2_2311-2412_2396.wav,4620,4075,545
1443,b-1_1818-1918_1854.wav,VTTS_b-1_1818-1918_1854.wav,2390,2322,68
1444,b-3_5853-5956_5864.wav,VTTS_b-3_5853-5956_5864.wav,3370,3332,38
1445,b-4_2000-5164_3767.wav,VTTS_b-4_2000-5164_3767.wav,4100,4180,-80
1446,b-4_1101-1220_1185.wav,VTTS_b-4_1101-1220_1185.wav,1010,650,360
1447,b-3_294-391_304.wav,VTTS_b-3_294-391_304.wav,5560,5654,-94
1448,b-4_2000-5164_3351.wav,VTTS_b-4_2000-5164_3351.wav,10376,10542,-166
1449,b-3_4607-5008_4924.wav,VTTS_b-3_4607-5008_4924.wav,8280,8046,234
1450,b-4_2000-5164_2878.wav,VTTS_b-4_2000-5164_2878.wav,6895,6873,22
1451,b-3_2177-2266_2234.wav,VTTS_b-3_2177-2266_2234.wav,2680,2763,-83
1452,b-2_2413-2500_2418.wav,VTTS_b-2_2413-2500_2418.wav,1140,2287,-1147
1453,b-1_3834-3934_3859.wav,VTTS_b-1_3834-3934_3859.wav,3480,3750,-270
1454,b-4_2000-5164_2704.wav,VTTS_b-4_2000-5164_2704.wav,4140,3913,227
1455,b-4_53-150_110.wav,VTTS_b-4_53-150_110.wav,7110,6467,643
1456,b-3_2434-2523_2503.wav,VTTS_b-3_2434-2523_2503.wav,4410,4423,-13
1457,b-4_2000-5164_2295.wav,VTTS_b-4_2000-5164_2295.wav,7600,7686,-86
1458,b-1_2826-2926_2886.wav,VTTS_b-1_2826-2926_2886.wav,2290,2450,-160
1459,b-4_2000-5164_3403.wav,VTTS_b-4_2000-5164_3403.wav,6058,7094,-1036
1460,b-4_501-1014_817.wav,VTTS_b-4_501-1014_817.wav,2860,2705,155
1461,b-1_2725-2825_2768.wav,VTTS_b-1_2725-2825_2768.wav,1090,1010,80
1462,b-1_3329-3429_3406.wav,VTTS_b-1_3329-3429_3406.wav,1390,1347,43
1463,b-3_1568-1665_1597.wav,VTTS_b-3_1568-1665_1597.wav,4420,4261,159
1464,b-3_2177-2266_2240.wav,VTTS_b-3_2177-2266_2240.wav,5600,5341,259
1465,b-3_6401-6500_6459.wav,VTTS_b-3_6401-6500_6459.wav,3300,3077,223
1466,b-1_2523-2623_2614.wav,VTTS_b-1_2523-2623_2614.wav,2510,2519,-9
1467,b-3_501-930_931.wav,VTTS_b-3_501-930_931.wav,5440,4911,529
1468,b-2_1121-1222_1127.wav,VTTS_b-2_1121-1222_1127.wav,2650,2508,142
1469,b-3_6116-6215_6116.wav,VTTS_b-3_6116-6215_6116.wav,5660,5677,-17
1470,b-3_4425-4497_4465.wav,VTTS_b-3_4425-4497_4465.wav,3540,3866,-326
1471,b-4_2000-5164_4311.wav,VTTS_b-4_2000-5164_4311.wav,2889,2995,-106
1472,b-3_5428-5533_5467.wav,VTTS_b-3_5428-5533_5467.wav,4620,6281,-1661
1473,b-1_3733-3833_3758.wav,VTTS_b-1_3733-3833_3758.wav,2520,2601,-81
1474,b-3_501-930_731.wav,VTTS_b-3_501-930_731.wav,2810,2543,267
1475,b-4_2000-5164_4472.wav,VTTS_b-4_2000-5164_4472.wav,8579,8847,-268
1476,b-3_2350-2433_2429.wav,VTTS_b-3_2350-2433_2429.wav,6540,6908,-368
1477,b-3_1568-1665_1589.wav,VTTS_b-3_1568-1665_1589.wav,2860,2473,387
1478,b-3_3364-3453_3441.wav,VTTS_b-3_3364-3453_3441.wav,3360,3483,-123
1479,b-2_305-406_307.wav,VTTS_b-2_305-406_307.wav,1540,1347,193
1480,b-4_2000-5164_2269.wav,VTTS_b-4_2000-5164_2269.wav,7440,11610,-4170
1481,b-4_2000-5164_3057.wav,VTTS_b-4_2000-5164_3057.wav,7129,7303,-174
1482,b-4_1101-1220_1202.wav,VTTS_b-4_1101-1220_1202.wav,3580,2647,933
1483,b-2_1427-1562_1430.wav,VTTS_b-2_1427-1562_1430.wav,4120,4075,45
1484,b-3_4315-4424_4375.wav,VTTS_b-3_4315-4424_4375.wav,2540,2368,172
1485,b-1_4286-4321_4302.wav,VTTS_b-1_4286-4321_4302.wav,2270,2624,-354
1486,b-4_1601-1706_1691.wav,VTTS_b-4_1601-1706_1691.wav,4010,4423,-413
1487,b-2_2413-2500_2489.wav,VTTS_b-2_2413-2500_2489.wav,2950,3135,-185
1488,b-1_2725-2825_2823.wav,VTTS_b-1_2725-2825_2823.wav,4500,5120,-620
1489,b-3_4207-4314_4285.wav,VTTS_b-3_4207-4314_4285.wav,3810,3669,141
1490,b-2_1801-1902_1809.wav,VTTS_b-2_1801-1902_1809.wav,3180,2821,359
1491,b-4_1101-1220_1196.wav,VTTS_b-4_1101-1220_1196.wav,6540,5375,1165
1492,b-4_1301-1400_1395.wav,VTTS_b-4_1301-1400_1395.wav,6570,6432,138
1493,b-3_3628-3714_3689.wav,VTTS_b-3_3628-3714_3689.wav,6960,8719,-1759
1494,b-4_2000-5164_4261.wav,VTTS_b-4_2000-5164_4261.wav,4707,4853,-146
1495,b-1_686-793_782.wav,VTTS_b-1_686-793_782.wav,3100,5828,-2728
1496,b-2_611-712_696.wav,VTTS_b-2_611-712_696.wav,4080,2961,1119
1497,b-3_980-1077_1033.wav,VTTS_b-3_980-1077_1033.wav,4460,4412,48
1498,b-4_2000-5164_2247.wav,VTTS_b-4_2000-5164_2247.wav,790,778,12
1499,b-3_1666-1763_1758.wav,VTTS_b-3_1666-1763_1758.wav,5100,4667,433
1500,b-1_2523-2623_2557.wav,VTTS_b-1_2523-2623_2557.wav,2670,2229,441
1501,b-1_3531-3631_3540.wav,VTTS_b-1_3531-3631_3540.wav,2130,2136,-6
1502,b-4_1707-1813_1798.wav,VTTS_b-4_1707-1813_1798.wav,4390,4226,164
1503,b-3_6301-6400_6372.wav,VTTS_b-3_6301-6400_6372.wav,5320,5039,281
1504,b-1_2220-2320_2262.wav,VTTS_b-1_2220-2320_2262.wav,2140,1997,143
1505,b-4_2000-5164_3543.wav,VTTS_b-4_2000-5164_3543.wav,6377,7488,-1111
1506,b-1_478-578_504.wav,VTTS_b-1_478-578_504.wav,2310,2577,-267
1507,b-4_2000-5164_5107.wav,VTTS_b-4_2000-5164_5107.wav,5591,7163,-1572
1508,b-1_4214-4285_4230.wav,VTTS_b-1_4214-4285_4230.wav,2430,2241,189
1509,b-3_3538-3627_3539.wav,VTTS_b-3_3538-3627_3539.wav,4640,5259,-619
1510,b-3_2000-2088_2036.wav,VTTS_b-3_2000-2088_2036.wav,8300,8673,-373
1511,b-1_3834-3934_3842.wav,VTTS_b-1_3834-3934_3842.wav,4130,4284,-154
1512,b-3_4498-4605_4528.wav,VTTS_b-3_4498-4605_4528.wav,4810,4772,38
1513,b-4_501-1014_634.wav,VTTS_b-4_501-1014_634.wav,5910,5712,198
1514,b-4_151-300_205.wav,VTTS_b-4_151-300_205.wav,3900,3796,104
1515,b-1_1111-1211_1195.wav,VTTS_b-1_1111-1211_1195.wav,2660,2392,268
1516,b-2_305-406_394.wav,VTTS_b-2_305-406_394.wav,1800,2020,-220
1517,b-4_53-150_144.wav,VTTS_b-4_53-150_144.wav,8310,11610,-3300
1518,b-4_2000-5164_2618.wav,VTTS_b-4_2000-5164_2618.wav,2900,3204,-304
1519,b-4_501-1014_895.wav,VTTS_b-4_501-1014_895.wav,8290,8545,-255
1520,b-2_917-1018_945.wav,VTTS_b-2_917-1018_945.wav,890,906,-16
1521,b-4_1506-1600_1541.wav,VTTS_b-4_1506-1600_1541.wav,5910,5828,82
1522,b-3_980-1077_1071.wav,VTTS_b-3_980-1077_1071.wav,910,801,109
1523,b-3_196-293_290.wav,VTTS_b-3_196-293_290.wav,4930,5224,-294
1524,b-3_5853-5956_5916.wav,VTTS_b-3_5853-5956_5916.wav,5410,5155,255
1525,b-1_4178-4213_4189.wav,VTTS_b-1_4178-4213_4189.wav,1800,1916,-116
1526,b-1_1414-1514_1489.wav,VTTS_b-1_1414-1514_1489.wav,2510,2519,-9
1527,b-1_4466-4498_4472.wav,VTTS_b-1_4466-4498_4472.wav,1430,1741,-311
1528,b-3_2855-2942_2872.wav,VTTS_b-3_2855-2942_2872.wav,3450,3994,-544
1529,b-3_4001-4103_4091.wav,VTTS_b-3_4001-4103_4091.wav,6760,6641,119
1530,b-3_6501-6600_6543.wav,VTTS_b-3_6501-6600_6543.wav,2680,2786,-106
1531,b-2_101-202_113.wav,VTTS_b-2_101-202_113.wav,1440,1451,-11
1532,b-3_5009-5427_5142.wav,VTTS_b-3_5009-5427_5142.wav,2590,2322,268
1533,b-3_98-195_111.wav,VTTS_b-3_98-195_111.wav,6580,6664,-84
1534,b-1_3127-3227_3202.wav,VTTS_b-1_3127-3227_3202.wav,1440,1405,35
1535,b-4_501-1014_837.wav,VTTS_b-4_501-1014_837.wav,1460,1486,-26
1536,b-4_501-1014_752.wav,VTTS_b-4_501-1014_752.wav,2500,2496,4
1537,b-3_2089-2176_2145.wav,VTTS_b-3_2089-2176_2145.wav,3520,3692,-172
1538,b-3_4607-5008_4958.wav,VTTS_b-3_4607-5008_4958.wav,8050,7976,74
1539,b-4_2000-5164_4909.wav,VTTS_b-4_2000-5164_4909.wav,2191,2090,101
1540,b-2_1121-1222_1189.wav,VTTS_b-2_1121-1222_1189.wav,1080,1939,-859
1541,b-3_2089-2176_2108.wav,VTTS_b-3_2089-2176_2108.wav,4600,4307,293
1542,b-2_1699-1800_1747.wav,VTTS_b-2_1699-1800_1747.wav,1810,1869,-59
1543,b-2_2073-2106_2077.wav,VTTS_b-2_2073-2106_2077.wav,1280,1265,15
1544,b-4_2000-5164_4056.wav,VTTS_b-4_2000-5164_4056.wav,4987,5851,-864
1545,b-3_5009-5427_5033.wav,VTTS_b-3_5009-5427_5033.wav,7470,6838,632
1546,b-1_1515-1615_1521.wav,VTTS_b-1_1515-1615_1521.wav,2510,2612,-102
1547,b-1_3632-3732_3729.wav,VTTS_b-1_3632-3732_3729.wav,2350,2194,156
1548,b-3_3889-4000_3902.wav,VTTS_b-3_3889-4000_3902.wav,10090,9810,280
1549,b-4_2000-5164_3222.wav,VTTS_b-4_2000-5164_3222.wav,9022,8766,256
1550,b-3_1666-1763_1737.wav,VTTS_b-3_1666-1763_1737.wav,3730,4319,-589
1551,b-4_2000-5164_2339.wav,VTTS_b-4_2000-5164_2339.wav,5540,5909,-369
1552,b-3_392-500_441.wav,VTTS_b-3_392-500_441.wav,4020,3657,363
1553,b-1_478-578_574.wav,VTTS_b-1_478-578_574.wav,1280,1405,-125
1554,b-4_2000-5164_4069.wav,VTTS_b-4_2000-5164_4069.wav,7942,7605,337
1555,b-3_98-195_135.wav,VTTS_b-3_98-195_135.wav,11150,11169,-19
1556,b-3_5745-5852_5832.wav,VTTS_b-3_5745-5852_5832.wav,4650,4586,64
1557,b-3_4001-4103_4020.wav,VTTS_b-3_4001-4103_4020.wav,5640,5991,-351
1558,b-3_6217-6274_6249.wav,VTTS_b-3_6217-6274_6249.wav,4260,4191,69
1559,b-2_1121-1222_1203.wav,VTTS_b-2_1121-1222_1203.wav,7240,6188,1052
1560,b-3_6401-6500_6499.wav,VTTS_b-3_6401-6500_6499.wav,7430,11610,-4180
1561,b-2_713-814_790.wav,VTTS_b-2_713-814_790.wav,4780,3657,1123
1562,b-4_2000-5164_2313.wav,VTTS_b-4_2000-5164_2313.wav,5415,5341,74
1563,b-3_4001-4103_4094.wav,VTTS_b-3_4001-4103_4094.wav,9120,11610,-2490
1564,b-4_2000-5164_3962.wav,VTTS_b-4_2000-5164_3962.wav,6689,7291,-602
1565,b-4_2000-5164_2548.wav,VTTS_b-4_2000-5164_2548.wav,8990,9694,-704
1566,b-2_1325-1426_1378.wav,VTTS_b-2_1325-1426_1378.wav,4430,4505,-75
1567,b-1_4394-4429_4417.wav,VTTS_b-1_4394-4429_4417.wav,2370,2368,2
1568,b-1_3026-3126_3114.wav,VTTS_b-1_3026-3126_3114.wav,4410,4354,56
1569,b-1_74-174_146.wav,VTTS_b-1_74-174_146.wav,1840,1916,-76
1570,b-1_686-793_694.wav,VTTS_b-1_686-793_694.wav,2620,2380,240
1571,b-2_1223-1324_1230.wav,VTTS_b-2_1223-1324_1230.wav,1650,1602,48
1572,b-3_3025-3111_3050.wav,VTTS_b-3_3025-3111_3050.wav,5940,5457,483
1573,b-3_1666-1763_1679.wav,VTTS_b-3_1666-1763_1679.wav,6620,5991,629
1574,b-3_2267-2349_2279.wav,VTTS_b-3_2267-2349_2279.wav,10180,11297,-1117
1575,b-2_509-610_560.wav,VTTS_b-2_509-610_560.wav,1960,2032,-72
1576,b-3_6401-6500_6445.wav,VTTS_b-3_6401-6500_6445.wav,3790,3843,-53
1577,b-1_1111-1211_1161.wav,VTTS_b-1_1111-1211_1161.wav,3290,3088,202
1578,b-2_2413-2500_2488.wav,VTTS_b-2_2413-2500_2488.wav,1060,964,96
1579,b-1_2018-2118_2031.wav,VTTS_b-1_2018-2118_2031.wav,1080,1033,47
1580,b-1_2826-2926_2883.wav,VTTS_b-1_2826-2926_2883.wav,4160,4110,50
1581,b-4_1221-1300_1282.wav,VTTS_b-4_1221-1300_1282.wav,3070,2775,295
1582,b-4_2000-5164_4429.wav,VTTS_b-4_2000-5164_4429.wav,3701,3959,-258
1583,b-3_1764-1861_1788.wav,VTTS_b-3_1764-1861_1788.wav,690,743,-53
1584,b-3_1321-1568_1511.wav,VTTS_b-3_1321-1568_1511.wav,9980,8522,1458
1585,b-3_3025-3111_3108.wav,VTTS_b-3_3025-3111_3108.wav,9920,8545,1375
1586,b-2_509-610_510.wav,VTTS_b-2_509-610_510.wav,4340,4226,114
1587,b-4_53-150_133.wav,VTTS_b-4_53-150_133.wav,6980,6432,548
1588,b-4_2000-5164_5091.wav,VTTS_b-4_2000-5164_5091.wav,3655,3727,-72
1589,b-3_5428-5533_5469.wav,VTTS_b-3_5428-5533_5469.wav,2830,2682,148
1590,b-3_2267-2349_2319.wav,VTTS_b-3_2267-2349_2319.wav,8660,9137,-477
1591,b-4_1301-1400_1367.wav,VTTS_b-4_1301-1400_1367.wav,5920,6165,-245
1592,b-4_2000-5164_3102.wav,VTTS_b-4_2000-5164_3102.wav,1444,1277,167
1593,b-3_1321-1568_1338.wav,VTTS_b-3_1321-1568_1338.wav,3230,3762,-532
1594,b-3_5533-5638_5577.wav,VTTS_b-3_5533-5638_5577.wav,5530,5956,-426
1595,b-3_4001-4103_4088.wav,VTTS_b-3_4001-4103_4088.wav,9830,9694,136
1596,b-2_611-712_699.wav,VTTS_b-2_611-712_699.wav,2220,1974,246
1597,b-3_3112-3197_3183.wav,VTTS_b-3_3112-3197_3183.wav,8780,8081,699
1598,b-3_3364-3453_3425.wav,VTTS_b-3_3364-3453_3425.wav,1110,1033,77
1599,b-4_1814-1900_1860.wav,VTTS_b-4_1814-1900_1860.wav,7100,8916,-1816
1600,b-1_2624-2724_2637.wav,VTTS_b-1_2624-2724_2637.wav,1840,2043,-203
1601,b-4_2000-5164_3516.wav,VTTS_b-4_2000-5164_3516.wav,2590,2624,-34
1602,b-1_1212-1312_1212.wav,VTTS_b-1_1212-1312_1212.wav,830,813,17
1603,b-3_2524-2854_2542.wav,VTTS_b-3_2524-2854_2542.wav,5490,5793,-303
1604,b-2_2107-2193_2186.wav,VTTS_b-2_2107-2193_2186.wav,1170,1057,113
1605,b-2_1-100_67.wav,VTTS_b-2_1-100_67.wav,2300,2276,24
1606,b-3_2000-2088_2006.wav,VTTS_b-3_2000-2088_2006.wav,2560,2543,17
1607,b-4_2000-5164_2238.wav,VTTS_b-4_2000-5164_2238.wav,6370,6722,-352
1608,b-3_2089-2176_2138.wav,VTTS_b-3_2089-2176_2138.wav,7140,6629,511
1609,b-3_3112-3197_3151.wav,VTTS_b-3_3112-3197_3151.wav,8960,7651,1309
1610,b-3_3279-3363_3337.wav,VTTS_b-3_3279-3363_3337.wav,6000,5619,381
1611,b-3_6701-6800_6778.wav,VTTS_b-3_6701-6800_6778.wav,3980,4098,-118
1612,b-2_713-814_798.wav,VTTS_b-2_713-814_798.wav,1330,1370,-40
1613,b-4_151-300_195.wav,VTTS_b-4_151-300_195.wav,10400,10507,-107
1614,b-3_4607-5008_4768.wav,VTTS_b-3_4607-5008_4768.wav,6290,6455,-165
1615,b-3_5428-5533_5483.wav,VTTS_b-3_5428-5533_5483.wav,2710,2577,133
1616,b-2_203-304_279.wav,VTTS_b-2_203-304_279.wav,1760,2183,-423
1617,b-2_1597-1698_1671.wav,VTTS_b-2_1597-1698_1671.wav,2890,2868,22
1618,b-3_4607-5008_4897.wav,VTTS_b-3_4607-5008_4897.wav,3450,3541,-91
1619,b-3_3112-3197_3155.wav,VTTS_b-3_3112-3197_3155.wav,4170,4400,-230
1620,b-3_2524-2854_2779.wav,VTTS_b-3_2524-2854_2779.wav,7740,9125,-1385
1621,b-4_1814-1900_1814.wav,VTTS_b-4_1814-1900_1814.wav,5290,5770,-480
1622,b-3_501-930_564.wav,VTTS_b-3_501-930_564.wav,3960,3471,489
1623,b-3_2089-2176_2164.wav,VTTS_b-3_2089-2176_2164.wav,4110,3808,302
1624,b-2_2413-2500_2420.wav,VTTS_b-2_2413-2500_2420.wav,1050,940,110
1625,b-3_4607-5008_4765.wav,VTTS_b-3_4607-5008_4765.wav,6050,5944,106
1626,b-1_2422-2522_2512.wav,VTTS_b-1_2422-2522_2512.wav,1820,1869,-49
1627,b-1_1313-1413_1378.wav,VTTS_b-1_1313-1413_1378.wav,5980,5817,163
1628,b-1_2927-3025_2996.wav,VTTS_b-1_2927-3025_2996.wav,810,871,-61
1629,b-1_2321-2421_2370.wav,VTTS_b-1_2321-2421_2370.wav,1910,1985,-75
1630,b-3_2524-2854_2798.wav,VTTS_b-3_2524-2854_2798.wav,5450,5399,51
1631,b-2_2311-2412_2319.wav,VTTS_b-2_2311-2412_2319.wav,1280,1231,49
1632,b-1_2826-2926_2887.wav,VTTS_b-1_2826-2926_2887.wav,3880,3669,211
1633,b-2_305-406_336.wav,VTTS_b-2_305-406_336.wav,2450,2403,47
1634,b-2_815-916_862.wav,VTTS_b-2_815-916_862.wav,1280,1184,96
1635,b-4_401-500_460.wav,VTTS_b-4_401-500_460.wav,6670,6165,505
1636,b-1_2119-2219_2148.wav,VTTS_b-1_2119-2219_2148.wav,1580,1672,-92
1637,b-3_4498-4605_4532.wav,VTTS_b-3_4498-4605_4532.wav,4460,3599,861
1638,b-1_2321-2421_2330.wav,VTTS_b-1_2321-2421_2330.wav,1740,2659,-919
1639,b-3_4425-4497_4457.wav,VTTS_b-3_4425-4497_4457.wav,4850,4040,810
1640,b-2_1699-1800_1755.wav,VTTS_b-2_1699-1800_1755.wav,3060,2647,413
1641,b-4_501-1014_827.wav,VTTS_b-4_501-1014_827.wav,5420,5700,-280
1642,b-3_501-930_635.wav,VTTS_b-3_501-930_635.wav,4300,3692,608
1643,b-1_794-1009_919.wav,VTTS_b-1_794-1009_919.wav,2940,2589,351
1644,b-2_1427-1562_1559.wav,VTTS_b-2_1427-1562_1559.wav,1930,1660,270
1645,b-4_2000-5164_4342.wav,VTTS_b-4_2000-5164_4342.wav,6404,6351,53
1646,b-4_2000-5164_3849.wav,VTTS_b-4_2000-5164_3849.wav,9713,11447,-1734
1647,b-3_5009-5427_5072.wav,VTTS_b-3_5009-5427_5072.wav,6600,6385,215
1648,b-2_2413-2500_2441.wav,VTTS_b-2_2413-2500_2441.wav,2750,3680,-930
1649,b-2_2311-2412_2364.wav,VTTS_b-2_2311-2412_2364.wav,2240,1985,255
1650,b-3_2089-2176_2146.wav,VTTS_b-3_2089-2176_2146.wav,5290,5132,158
1651,b-3_3454-3537_3518.wav,VTTS_b-3_3454-3537_3518.wav,4880,5236,-356
1652,b-4_2000-5164_2316.wav,VTTS_b-4_2000-5164_2316.wav,5770,5468,302
1653,b-2_611-712_664.wav,VTTS_b-2_611-712_664.wav,2770,1927,843
1654,b-1_2220-2320_2294.wav,VTTS_b-1_2220-2320_2294.wav,2480,1800,680
1655,b-1_686-793_752.wav,VTTS_b-1_686-793_752.wav,2140,2415,-275
1656,b-3_5009-5427_5138.wav,VTTS_b-3_5009-5427_5138.wav,11020,11517,-497
1657,b-1_74-174_109.wav,VTTS_b-1_74-174_109.wav,2830,2961,-131
1658,b-3_3889-4000_3920.wav,VTTS_b-3_3889-4000_3920.wav,3850,3471,379
1659,b-2_611-712_691.wav,VTTS_b-2_611-712_691.wav,970,975,-5
1660,b-4_2000-5164_4402.wav,VTTS_b-4_2000-5164_4402.wav,5093,5642,-549
1661,b-3_2855-2942_2909.wav,VTTS_b-3_2855-2942_2909.wav,2430,2798,-368
1662,b-3_2089-2176_2103.wav,VTTS_b-3_2089-2176_2103.wav,4250,5178,-928
1663,b-1_1818-1918_1890.wav,VTTS_b-1_1818-1918_1890.wav,2210,2043,167
1664,b-4_2000-5164_2636.wav,VTTS_b-4_2000-5164_2636.wav,2720,2844,-124
1665,b-3_6301-6400_6369.wav,VTTS_b-3_6301-6400_6369.wav,4090,4690,-600
1666,b-3_5639-5744_5725.wav,VTTS_b-3_5639-5744_5725.wav,3780,3947,-167
1667,b-1_3632-3732_3692.wav,VTTS_b-1_3632-3732_3692.wav,4900,5283,-383
1668,b-2_1121-1222_1140.wav,VTTS_b-2_1121-1222_1140.wav,1440,1184,256
1669,b-1_1313-1413_1396.wav,VTTS_b-1_1313-1413_1396.wav,1840,1741,99
1670,b-3_1960-2000_1965.wav,VTTS_b-3_1960-2000_1965.wav,4140,4063,77
1671,b-2_1325-1426_1363.wav,VTTS_b-2_1325-1426_1363.wav,3150,2635,515
1672,b-4_2000-5164_3154.wav,VTTS_b-4_2000-5164_3154.wav,2722,2635,87
1673,b-2_1325-1426_1387.wav,VTTS_b-2_1325-1426_1387.wav,2370,3111,-741
1674,b-3_6801-6900_6896.wav,VTTS_b-3_6801-6900_6896.wav,5650,5689,-39
1675,b-2_2073-2106_2090.wav,VTTS_b-2_2073-2106_2090.wav,3000,3831,-831
1676,b-1_794-1009_855.wav,VTTS_b-1_794-1009_855.wav,2710,3413,-703
1677,b-1_3935-4033_3988.wav,VTTS_b-1_3935-4033_3988.wav,2260,2183,77
1678,b-2_101-202_139.wav,VTTS_b-2_101-202_139.wav,1860,8255,-6395
1679,b-3_2350-2433_2365.wav,VTTS_b-3_2350-2433_2365.wav,3940,5097,-1157
1680,b-3_2524-2854_2705.wav,VTTS_b-3_2524-2854_2705.wav,5180,4354,826
1681,b-4_2000-5164_4370.wav,VTTS_b-4_2000-5164_4370.wav,2962,3100,-138
1682,b-4_1014-1100_1057.wav,VTTS_b-4_1014-1100_1057.wav,2790,3344,-554
1683,b-1_2018-2118_2077.wav,VTTS_b-1_2018-2118_2077.wav,1980,1509,471
1684,b-4_501-1014_599.wav,VTTS_b-4_501-1014_599.wav,6870,6409,461
1685,b-2_305-406_367.wav,VTTS_b-2_305-406_367.wav,1830,1649,181
1686,b-3_1568-1665_1575.wav,VTTS_b-3_1568-1665_1575.wav,6610,6339,271
1687,b-3_2434-2523_2461.wav,VTTS_b-3_2434-2523_2461.wav,4160,3471,689
1688,b-3_6401-6500_6462.wav,VTTS_b-3_6401-6500_6462.wav,2930,2844,86
1689,b-2_1121-1222_1128.wav,VTTS_b-2_1121-1222_1128.wav,5190,4957,233
1690,b-3_4498-4605_4553.wav,VTTS_b-3_4498-4605_4553.wav,3800,4052,-252
1691,b-2_305-406_333.wav,VTTS_b-2_305-406_333.wav,1600,1858,-258
1692,b-4_2000-5164_2851.wav,VTTS_b-4_2000-5164_2851.wav,1720,1765,-45
1693,b-4_2000-5164_2289.wav,VTTS_b-4_2000-5164_2289.wav,4080,3750,330
1694,b-4_2000-5164_4044.wav,VTTS_b-4_2000-5164_4044.wav,2276,2264,12
1695,b-3_98-195_141.wav,VTTS_b-3_98-195_141.wav,7090,7314,-224
1696,b-4_2000-5164_3063.wav,VTTS_b-4_2000-5164_3063.wav,6885,6026,859
1697,b-4_151-300_290.wav,VTTS_b-4_151-300_290.wav,5560,5445,115
1698,b-4_2000-5164_4162.wav,VTTS_b-4_2000-5164_4162.wav,2587,2972,-385
1699,b-2_1121-1222_1136.wav,VTTS_b-2_1121-1222_1136.wav,1440,2485,-1045
1700,b-4_2000-5164_5135.wav,VTTS_b-4_2000-5164_5135.wav,5452,5433,19
1701,b-1_3430-3530_3451.wav,VTTS_b-1_3430-3530_3451.wav,2890,2717,173
1702,b-2_917-1018_970.wav,VTTS_b-2_917-1018_970.wav,2470,3599,-1129
1703,b-4_501-1014_855.wav,VTTS_b-4_501-1014_855.wav,2900,4238,-1338
1704,b-1_3632-3732_3670.wav,VTTS_b-1_3632-3732_3670.wav,3500,3448,52
1705,b-3_3803-3888_3885.wav,VTTS_b-3_3803-3888_3885.wav,4150,4516,-366
1706,b-3_5745-5852_5790.wav,VTTS_b-3_5745-5852_5790.wav,3470,4772,-1302
1707,b-2_407-508_465.wav,VTTS_b-2_407-508_465.wav,6000,6827,-827
1708,b-3_2434-2523_2476.wav,VTTS_b-3_2434-2523_2476.wav,5170,5132,38
1709,b-2_101-202_132.wav,VTTS_b-2_101-202_132.wav,1120,1080,40
1710,b-3_3279-3363_3305.wav,VTTS_b-3_3279-3363_3305.wav,2690,2206,484
1711,b-4_2000-5164_2418.wav,VTTS_b-4_2000-5164_2418.wav,3545,3692,-147
1712,b-2_1597-1698_1599.wav,VTTS_b-2_1597-1698_1599.wav,6040,5642,398
1713,b-2_509-610_569.wav,VTTS_b-2_509-610_569.wav,2050,2136,-86
1714,b-1_1919-2017_1984.wav,VTTS_b-1_1919-2017_1984.wav,1780,1765,15
1715,b-4_501-1014_933.wav,VTTS_b-4_501-1014_933.wav,6780,7512,-732
1716,b-2_1-100_45.wav,VTTS_b-2_1-100_45.wav,2680,2682,-2
1717,b-4_2000-5164_3081.wav,VTTS_b-4_2000-5164_3081.wav,6093,5724,369
1718,b-1_2422-2522_2437.wav,VTTS_b-1_2422-2522_2437.wav,1420,1289,131
1719,b-3_5009-5427_5357.wav,VTTS_b-3_5009-5427_5357.wav,6240,5793,447
1720,b-3_3279-3363_3318.wav,VTTS_b-3_3279-3363_3318.wav,4280,4005,275
1721,b-2_203-304_259.wav,VTTS_b-2_203-304_259.wav,4130,4412,-282
1722,b-3_5009-5427_5289.wav,VTTS_b-3_5009-5427_5289.wav,4620,4005,615
1723,b-3_4104-4206_4156.wav,VTTS_b-3_4104-4206_4156.wav,5210,5190,20
1724,b-4_2000-5164_2209.wav,VTTS_b-4_2000-5164_2209.wav,2980,3193,-213
1725,b-1_2220-2320_2316.wav,VTTS_b-1_2220-2320_2316.wav,1440,1416,24
1726,b-4_53-150_125.wav,VTTS_b-4_53-150_125.wav,9410,9033,377
1727,b-3_6217-6274_6229.wav,VTTS_b-3_6217-6274_6229.wav,6270,6827,-557
1728,b-3_3538-3627_3608.wav,VTTS_b-3_3538-3627_3608.wav,6420,6838,-418
1729,b-4_2000-5164_2252.wav,VTTS_b-4_2000-5164_2252.wav,3870,4145,-275
1730,b-1_1212-1312_1308.wav,VTTS_b-1_1212-1312_1308.wav,5000,4087,913
1731,b-4_2000-5164_3058.wav,VTTS_b-4_2000-5164_3058.wav,4944,4354,590
1732,b-3_392-500_489.wav,VTTS_b-3_392-500_489.wav,4980,5886,-906
1733,b-3_4498-4605_4577.wav,VTTS_b-3_4498-4605_4577.wav,5790,5492,298
1734,b-1_1010-1110_1100.wav,VTTS_b-1_1010-1110_1100.wav,4430,3669,761
1735,b-3_6900-7016_6960.wav,VTTS_b-3_6900-7016_6960.wav,3990,4040,-50
1736,b-3_2177-2266_2239.wav,VTTS_b-3_2177-2266_2239.wav,4920,4087,833
1737,b-4_501-1014_781.wav,VTTS_b-4_501-1014_781.wav,1980,1660,320
1738,b-3_3198-3278_3200.wav,VTTS_b-3_3198-3278_3200.wav,3980,6014,-2034
1739,b-1_1818-1918_1874.wav,VTTS_b-1_1818-1918_1874.wav,1490,1533,-43
1740,b-4_2000-5164_3461.wav,VTTS_b-4_2000-5164_3461.wav,6875,7430,-555
1741,b-1_3632-3732_3640.wav,VTTS_b-1_3632-3732_3640.wav,1270,1695,-425
1742,b-3_5009-5427_5398.wav,VTTS_b-3_5009-5427_5398.wav,4830,3913,917
1743,b-3_2267-2349_2272.wav,VTTS_b-3_2267-2349_2272.wav,5200,5851,-651
1744,b-3_6116-6215_6162.wav,VTTS_b-3_6116-6215_6162.wav,4080,4238,-158
1745,b-2_203-304_242.wav,VTTS_b-2_203-304_242.wav,2260,2125,135
1746,b-3_3715-3802_3740.wav,VTTS_b-3_3715-3802_3740.wav,5040,7570,-2530
1747,b-3_501-930_877.wav,VTTS_b-3_501-930_877.wav,5600,4586,1014
1748,b-3_4104-4206_4181.wav,VTTS_b-3_4104-4206_4181.wav,7030,7221,-191
1749,b-1_579-649_583.wav,VTTS_b-1_579-649_583.wav,4210,3599,611
1750,b-4_2000-5164_3756.wav,VTTS_b-4_2000-5164_3756.wav,2290,2078,212
1751,b-1_276-376_319.wav,VTTS_b-1_276-376_319.wav,2610,3634,-1024
1752,b-1_1414-1514_1421.wav,VTTS_b-1_1414-1514_1421.wav,1080,1045,35
1753,b-4_501-1014_985.wav,VTTS_b-4_501-1014_985.wav,8840,8858,-18
1754,b-3_1764-1861_1840.wav,VTTS_b-3_1764-1861_1840.wav,5140,5294,-154
1755,b-4_2000-5164_3558.wav,VTTS_b-4_2000-5164_3558.wav,1700,1718,-18
1756,b-4_2000-5164_3687.wav,VTTS_b-4_2000-5164_3687.wav,6635,6455,180
1757,b-1_478-578_488.wav,VTTS_b-1_478-578_488.wav,5640,7059,-1419
1758,b-3_501-930_662.wav,VTTS_b-3_501-930_662.wav,4960,5224,-264
1759,b-3_2524-2854_2717.wav,VTTS_b-3_2524-2854_2717.wav,6000,5712,288
1760,b-4_1101-1220_1173.wav,VTTS_b-4_1101-1220_1173.wav,1920,1834,86
1761,b-4_2000-5164_2168.wav,VTTS_b-4_2000-5164_2168.wav,3720,5886,-2166
1762,b-1_3834-3934_3908.wav,VTTS_b-1_3834-3934_3908.wav,3230,3367,-137
1763,b-4_2000-5164_4842.wav,VTTS_b-4_2000-5164_4842.wav,1926,2473,-547
1764,b-1_478-578_510.wav,VTTS_b-1_478-578_510.wav,2030,1939,91
1765,b-1_2523-2623_2585.wav,VTTS_b-1_2523-2623_2585.wav,3900,5143,-1243
1766,b-3_2855-2942_2881.wav,VTTS_b-3_2855-2942_2881.wav,4010,4458,-448
1767,b-3_1321-1568_1327.wav,VTTS_b-3_1321-1568_1327.wav,6700,6432,268
1768,b-1_2624-2724_2694.wav,VTTS_b-1_2624-2724_2694.wav,3400,4423,-1023
1769,b-1_377-477_390.wav,VTTS_b-1_377-477_390.wav,1500,1625,-125
1770,b-4_2000-5164_4828.wav,VTTS_b-4_2000-5164_4828.wav,7684,8069,-385
1771,b-1_794-1009_887.wav,VTTS_b-1_794-1009_887.wav,5030,5817,-787
1772,b-4_2000-5164_4854.wav,VTTS_b-4_2000-5164_4854.wav,6467,5909,558
1773,b-3_4104-4206_4145.wav,VTTS_b-3_4104-4206_4145.wav,6680,6258,422
1774,b-3_501-930_632.wav,VTTS_b-3_501-930_632.wav,3730,3831,-101
1775,b-2_2311-2412_2401.wav,VTTS_b-2_2311-2412_2401.wav,4120,3866,254
1776,b-1_686-793_737.wav,VTTS_b-1_686-793_737.wav,1000,1080,-80
1777,b-4_1707-1813_1740.wav,VTTS_b-4_1707-1813_1740.wav,1330,1312,18
1778,b-3_2177-2266_2214.wav,VTTS_b-3_2177-2266_2214.wav,5420,6722,-1302
1779,b-3_294-391_323.wav,VTTS_b-3_294-391_323.wav,6850,6653,197
1780,b-1_2826-2926_2899.wav,VTTS_b-1_2826-2926_2899.wav,4390,4122,268
1781,b-4_2000-5164_5024.wav,VTTS_b-4_2000-5164_5024.wav,4706,4830,-124
1782,b-1_175-275_177.wav,VTTS_b-1_175-275_177.wav,2590,2856,-266
1783,b-2_1-100_98.wav,VTTS_b-2_1-100_98.wav,1790,2090,-300
1784,b-3_6501-6600_6535.wav,VTTS_b-3_6501-6600_6535.wav,2890,2798,92
1785,b-4_1101-1220_1104.wav,VTTS_b-4_1101-1220_1104.wav,1260,1091,169
1786,b-1_2624-2724_2687.wav,VTTS_b-1_2624-2724_2687.wav,1770,2798,-1028
1787,b-1_1616-1716_1714.wav,VTTS_b-1_1616-1716_1714.wav,1310,1486,-176
1788,b-3_5533-5638_5625.wav,VTTS_b-3_5533-5638_5625.wav,3270,3088,182
1789,b-3_5957-6015_6006.wav,VTTS_b-3_5957-6015_6006.wav,3490,3750,-260
1790,b-1_4214-4285_4239.wav,VTTS_b-1_4214-4285_4239.wav,1290,1591,-301
1791,b-1_2624-2724_2655.wav,VTTS_b-1_2624-2724_2655.wav,1380,1219,161
1792,b-2_611-712_687.wav,VTTS_b-2_611-712_687.wav,2900,3053,-153
1793,b-3_5853-5956_5942.wav,VTTS_b-3_5853-5956_5942.wav,5710,5712,-2
1794,b-1_1818-1918_1859.wav,VTTS_b-1_1818-1918_1859.wav,4270,3646,624
1795,b-4_2000-5164_4624.wav,VTTS_b-4_2000-5164_4624.wav,3958,4168,-210
1796,b-3_196-293_277.wav,VTTS_b-3_196-293_277.wav,5120,5050,70
1797,b-4_2000-5164_2386.wav,VTTS_b-4_2000-5164_2386.wav,2680,1927,753
1798,b-4_2000-5164_4733.wav,VTTS_b-4_2000-5164_4733.wav,3053,3251,-198
1799,b-1_3127-3227_3179.wav,VTTS_b-1_3127-3227_3179.wav,1640,1474,166
1800,b-3_2524-2854_2661.wav,VTTS_b-3_2524-2854_2661.wav,2360,2368,-8
1801,b-2_2209-2310_2248.wav,VTTS_b-2_2209-2310_2248.wav,2410,2461,-51
1802,b-4_2000-5164_2825.wav,VTTS_b-4_2000-5164_2825.wav,4070,5236,-1166
1803,b-4_2000-5164_2527.wav,VTTS_b-4_2000-5164_2527.wav,6610,7790,-1180
1804,b-2_305-406_360.wav,VTTS_b-2_305-406_360.wav,6530,6896,-366
1805,b-4_2000-5164_2701.wav,VTTS_b-4_2000-5164_2701.wav,6700,6722,-22
1806,b-3_3112-3197_3130.wav,VTTS_b-3_3112-3197_3130.wav,7910,6966,944
1807,b-1_794-1009_974.wav,VTTS_b-1_794-1009_974.wav,1370,1428,-58
1808,b-3_980-1077_1009.wav,VTTS_b-3_980-1077_1009.wav,3550,3146,404
1809,b-4_1-52_41.wav,VTTS_b-4_1-52_41.wav,7920,6374,1546
1810,b-4_301-400_386.wav,VTTS_b-4_301-400_386.wav,2580,2252,328
1811,b-4_2000-5164_5067.wav,VTTS_b-4_2000-5164_5067.wav,3742,3646,96
1812,b-3_6601-6700_6608.wav,VTTS_b-3_6601-6700_6608.wav,9190,7755,1435
1813,b-4_2000-5164_4119.wav,VTTS_b-4_2000-5164_4119.wav,5260,5550,-290
1814,b-2_1223-1324_1244.wav,VTTS_b-2_1223-1324_1244.wav,1890,2334,-444
1815,b-3_392-500_436.wav,VTTS_b-3_392-500_436.wav,7250,6815,435
1816,b-1_74-174_172.wav,VTTS_b-1_74-174_172.wav,3150,4191,-1041
1817,b-1_1818-1918_1875.wav,VTTS_b-1_1818-1918_1875.wav,1790,1649,141
1818,b-3_5009-5427_5307.wav,VTTS_b-3_5009-5427_5307.wav,4770,4737,33
1819,b-3_5533-5638_5609.wav,VTTS_b-3_5533-5638_5609.wav,6290,6397,-107
1820,b-4_2000-5164_3739.wav,VTTS_b-4_2000-5164_3739.wav,5680,5271,409
1821,b-3_6501-6600_6520.wav,VTTS_b-3_6501-6600_6520.wav,2190,1892,298
1822,b-1_377-477_393.wav,VTTS_b-1_377-477_393.wav,1460,1393,67
1823,b-1_794-1009_964.wav,VTTS_b-1_794-1009_964.wav,2660,2624,36
1824,b-2_1699-1800_1771.wav,VTTS_b-2_1699-1800_1771.wav,1810,1730,80
1825,b-2_2040-2072_2066.wav,VTTS_b-2_2040-2072_2066.wav,1090,1068,22
1826,b-3_6701-6800_6761.wav,VTTS_b-3_6701-6800_6761.wav,8340,7872,468
1827,b-3_3715-3802_3756.wav,VTTS_b-3_3715-3802_3756.wav,6600,6362,238
1828,b-3_3112-3197_3162.wav,VTTS_b-3_3112-3197_3162.wav,7440,7210,230
1829,b-3_5957-6015_5981.wav,VTTS_b-3_5957-6015_5981.wav,5130,5550,-420
1830,b-1_794-1009_973.wav,VTTS_b-1_794-1009_973.wav,2930,11610,-8680
1831,b-1_2624-2724_2636.wav,VTTS_b-1_2624-2724_2636.wav,1830,1811,19
1832,b-1_3733-3833_3733.wav,VTTS_b-1_3733-3833_3733.wav,2880,2183,697
1833,b-4_501-1014_876.wav,VTTS_b-4_501-1014_876.wav,9640,9149,491
1834,b-4_501-1014_734.wav,VTTS_b-4_501-1014_734.wav,9300,9706,-406
1835,b-1_2422-2522_2501.wav,VTTS_b-1_2422-2522_2501.wav,3480,3088,392
1836,b-2_2413-2500_2440.wav,VTTS_b-2_2413-2500_2440.wav,2060,1974,86
1837,b-3_4315-4424_4316.wav,VTTS_b-3_4315-4424_4316.wav,1170,1033,137
1838,b-4_2000-5164_2756.wav,VTTS_b-4_2000-5164_2756.wav,5640,5608,32
1839,b-4_1506-1600_1536.wav,VTTS_b-4_1506-1600_1536.wav,2500,2810,-310
1840,b-2_407-508_499.wav,VTTS_b-2_407-508_499.wav,3900,2717,1183
1841,b-1_2725-2825_2792.wav,VTTS_b-1_2725-2825_2792.wav,3100,2833,267
1842,b-1_478-578_546.wav,VTTS_b-1_478-578_546.wav,3580,3564,16
1843,b-1_1010-1110_1023.wav,VTTS_b-1_1010-1110_1023.wav,2010,1881,129
1844,b-1_3935-4033_3938.wav,VTTS_b-1_3935-4033_3938.wav,1380,1370,10
1845,b-1_1-73_38.wav,VTTS_b-1_1-73_38.wav,1460,1486,-26
1846,b-1_1-73_59.wav,VTTS_b-1_1-73_59.wav,1710,1985,-275
1847,b-2_1325-1426_1403.wav,VTTS_b-2_1325-1426_1403.wav,1710,1788,-78
1848,b-3_3889-4000_3961.wav,VTTS_b-3_3889-4000_3961.wav,5970,5445,525
1849,b-1_377-477_453.wav,VTTS_b-1_377-477_453.wav,2640,2171,469
1850,b-3_5009-5427_5136.wav,VTTS_b-3_5009-5427_5136.wav,4280,4354,-74
1851,b-1_3632-3732_3633.wav,VTTS_b-1_3632-3732_3633.wav,2290,3170,-880
1852,b-4_1506-1600_1568.wav,VTTS_b-4_1506-1600_1568.wav,3480,2984,496
1853,b-2_1121-1222_1221.wav,VTTS_b-2_1121-1222_1221.wav,6880,6931,-51
1854,b-3_6401-6500_6486.wav,VTTS_b-3_6401-6500_6486.wav,4280,4238,42
1855,b-3_3025-3111_3061.wav,VTTS_b-3_3025-3111_3061.wav,3050,2891,159
1856,b-1_1212-1312_1293.wav,VTTS_b-1_1212-1312_1293.wav,2980,3251,-271
1857,b-4_1101-1220_1166.wav,VTTS_b-4_1101-1220_1166.wav,2520,2183,337
1858,b-3_6217-6274_6273.wav,VTTS_b-3_6217-6274_6273.wav,4000,4040,-40
1859,b-4_301-400_359.wav,VTTS_b-4_301-400_359.wav,1420,1324,96
1860,b-1_1212-1312_1252.wav,VTTS_b-1_1212-1312_1252.wav,4510,4005,505
1861,b-3_3715-3802_3777.wav,VTTS_b-3_3715-3802_3777.wav,4200,4052,148
1862,b-3_1960-2000_1996.wav,VTTS_b-3_1960-2000_1996.wav,3380,3181,199
1863,b-1_2321-2421_2393.wav,VTTS_b-1_2321-2421_2393.wav,1600,1486,114
1864,b-4_2000-5164_4676.wav,VTTS_b-4_2000-5164_4676.wav,7341,7012,329
1865,b-2_1325-1426_1380.wav,VTTS_b-2_1325-1426_1380.wav,4130,3866,264
1866,b-3_2089-2176_2128.wav,VTTS_b-3_2089-2176_2128.wav,5320,4807,513
1867,b-3_501-930_652.wav,VTTS_b-3_501-930_652.wav,10530,9799,731
1868,b-3_1-97_27.wav,VTTS_b-3_1-97_27.wav,4540,3913,627
1869,b-4_501-1014_613.wav,VTTS_b-4_501-1014_613.wav,3360,3425,-65
1870,b-1_1010-1110_1029.wav,VTTS_b-1_1010-1110_1029.wav,1950,1985,-35
1871,b-1_4286-4321_4311.wav,VTTS_b-1_4286-4321_4311.wav,1600,1625,-25
1872,b-1_3935-4033_3951.wav,VTTS_b-1_3935-4033_3951.wav,3930,3971,-41
1873,b-1_2422-2522_2438.wav,VTTS_b-1_2422-2522_2438.wav,4610,4017,593
1874,b-4_2000-5164_2670.wav,VTTS_b-4_2000-5164_2670.wav,3340,3007,333
1875,b-3_3279-3363_3309.wav,VTTS_b-3_3279-3363_3309.wav,2340,2543,-203
1876,b-3_2267-2349_2291.wav,VTTS_b-3_2267-2349_2291.wav,6680,6327,353
1877,b-2_1121-1222_1174.wav,VTTS_b-2_1121-1222_1174.wav,1760,1637,123
1878,b-4_1707-1813_1759.wav,VTTS_b-4_1707-1813_1759.wav,4970,4748,222
1879,b-4_2000-5164_2148.wav,VTTS_b-4_2000-5164_2148.wav,2495,2450,45
1880,b-2_407-508_445.wav,VTTS_b-2_407-508_445.wav,5540,5480,60
1881,b-4_151-300_224.wav,VTTS_b-4_151-300_224.wav,6560,6118,442
1882,b-3_1079-1320_1124.wav,VTTS_b-3_1079-1320_1124.wav,4440,4087,353
1883,b-3_501-930_804.wav,VTTS_b-3_501-930_804.wav,8320,6978,1342
1884,b-1_3228-3328_3298.wav,VTTS_b-1_3228-3328_3298.wav,2060,2299,-239
1885,b-2_1223-1324_1326.wav,VTTS_b-2_1223-1324_1326.wav,1550,2566,-1016
1886,b-3_1568-1665_1659.wav,VTTS_b-3_1568-1665_1659.wav,11650,11529,121
1887,b-1_4214-4285_4258.wav,VTTS_b-1_4214-4285_4258.wav,2590,2705,-115
1888,b-4_2000-5164_5150.wav,VTTS_b-4_2000-5164_5150.wav,6704,7059,-355
1889,b-1_276-376_292.wav,VTTS_b-1_276-376_292.wav,1320,1370,-50
1890,b-3_5428-5533_5465.wav,VTTS_b-3_5428-5533_5465.wav,6500,7187,-687
1891,b-3_1568-1665_1621.wav,VTTS_b-3_1568-1665_1621.wav,6210,5968,242
1892,b-2_1325-1426_1381.wav,VTTS_b-2_1325-1426_1381.wav,6180,5631,549
1893,b-1_478-578_555.wav,VTTS_b-1_478-578_555.wav,1660,1637,23
1894,b-3_5957-6015_5958.wav,VTTS_b-3_5957-6015_5958.wav,3050,2902,148
1895,b-3_6217-6274_6253.wav,VTTS_b-3_6217-6274_6253.wav,4170,3820,350
1896,b-4_1814-1900_1833.wav,VTTS_b-4_1814-1900_1833.wav,4000,4203,-203
1897,b-3_2267-2349_2331.wav,VTTS_b-3_2267-2349_2331.wav,4740,5782,-1042
1898,b-1_3228-3328_3326.wav,VTTS_b-1_3228-3328_3326.wav,1230,1173,57
1899,b-1_794-1009_988.wav,VTTS_b-1_794-1009_988.wav,4260,6200,-1940
1900,b-3_1862-1959_1872.wav,VTTS_b-3_1862-1959_1872.wav,4380,3982,398
1901,b-2_917-1018_1016.wav,VTTS_b-2_917-1018_1016.wav,1280,2218,-938
1902,b-4_2000-5164_3259.wav,VTTS_b-4_2000-5164_3259.wav,2286,2519,-233
1903,b-1_2018-2118_2051.wav,VTTS_b-1_2018-2118_2051.wav,2410,2310,100
1904,b-4_2000-5164_4760.wav,VTTS_b-4_2000-5164_4760.wav,8817,8835,-18
1905,b-3_1568-1665_1576.wav,VTTS_b-3_1568-1665_1576.wav,6300,6374,-74
1906,b-3_1321-1568_1321.wav,VTTS_b-3_1321-1568_1321.wav,2820,3158,-338
1907,b-3_1079-1320_1135.wav,VTTS_b-3_1079-1320_1135.wav,3040,2752,288
1908,b-4_2000-5164_4115.wav,VTTS_b-4_2000-5164_4115.wav,4880,4017,863
1909,b-3_1960-2000_1991.wav,VTTS_b-3_1960-2000_1991.wav,8300,7372,928
1910,b-3_196-293_212.wav,VTTS_b-3_196-293_212.wav,6250,6211,39
1911,b-1_1919-2017_2002.wav,VTTS_b-1_1919-2017_2002.wav,1810,2020,-210
1912,b-4_501-1014_784.wav,VTTS_b-4_501-1014_784.wav,5890,5608,282
1913,b-1_3733-3833_3831.wav,VTTS_b-1_3733-3833_3831.wav,4910,4830,80
1914,b-4_2000-5164_3527.wav,VTTS_b-4_2000-5164_3527.wav,4638,4702,-64
1915,b-3_2350-2433_2409.wav,VTTS_b-3_2350-2433_2409.wav,3910,4783,-873
1916,b-4_501-1014_533.wav,VTTS_b-4_501-1014_533.wav,1660,1509,151
1917,b-4_2000-5164_3519.wav,VTTS_b-4_2000-5164_3519.wav,2378,2694,-316
1918,b-3_3538-3627_3580.wav,VTTS_b-3_3538-3627_3580.wav,2610,2740,-130
1919,b-3_4607-5008_4904.wav,VTTS_b-3_4607-5008_4904.wav,8850,7895,955
1920,b-4_2000-5164_4216.wav,VTTS_b-4_2000-5164_4216.wav,5712,5724,-12
1921,b-1_3733-3833_3794.wav,VTTS_b-1_3733-3833_3794.wav,4170,3878,292
1922,b-3_501-930_626.wav,VTTS_b-3_501-930_626.wav,5580,5271,309
1923,b-1_2422-2522_2489.wav,VTTS_b-1_2422-2522_2489.wav,4300,4133,167
1924,b-1_3935-4033_3980.wav,VTTS_b-1_3935-4033_3980.wav,2640,4365,-1725
1925,b-1_794-1009_976.wav,VTTS_b-1_794-1009_976.wav,2350,3216,-866
1926,b-2_101-202_130.wav,VTTS_b-2_101-202_130.wav,1720,1776,-56
1927,b-1_2826-2926_2839.wav,VTTS_b-1_2826-2926_2839.wav,2150,2647,-497
1928,b-3_392-500_421.wav,VTTS_b-3_392-500_421.wav,6250,6525,-275
1929,b-4_2000-5164_2254.wav,VTTS_b-4_2000-5164_2254.wav,5145,4609,536
1930,b-4_1901-2000_1969.wav,VTTS_b-4_1901-2000_1969.wav,4150,4191,-41
1931,b-4_2000-5164_3180.wav,VTTS_b-4_2000-5164_3180.wav,7926,7918,8
1932,b-3_5009-5427_5085.wav,VTTS_b-3_5009-5427_5085.wav,10640,10577,63
1933,b-4_2000-5164_3753.wav,VTTS_b-4_2000-5164_3753.wav,3340,3564,-224
1934,b-3_2089-2176_2170.wav,VTTS_b-3_2089-2176_2170.wav,3760,3820,-60
1935,b-4_2000-5164_3709.wav,VTTS_b-4_2000-5164_3709.wav,2360,2171,189
1936,b-4_2000-5164_4700.wav,VTTS_b-4_2000-5164_4700.wav,6365,6107,258
1937,b-2_917-1018_994.wav,VTTS_b-2_917-1018_994.wav,1310,1707,-397
1938,b-4_2000-5164_2744.wav,VTTS_b-4_2000-5164_2744.wav,3875,4214,-339
1939,b-1_3329-3429_3425.wav,VTTS_b-1_3329-3429_3425.wav,2300,2694,-394
1940,b-2_1903-2038_1943.wav,VTTS_b-2_1903-2038_1943.wav,1350,1231,119
1941,b-4_2000-5164_4778.wav,VTTS_b-4_2000-5164_4778.wav,3331,3123,208
1942,b-3_3628-3714_3663.wav,VTTS_b-3_3628-3714_3663.wav,6730,6687,43
1943,b-3_3279-3363_3357.wav,VTTS_b-3_3279-3363_3357.wav,4290,4191,99
1944,b-1_478-578_567.wav,VTTS_b-1_478-578_567.wav,1850,1509,341
1945,b-4_53-150_73.wav,VTTS_b-4_53-150_73.wav,8630,8185,445
1946,b-3_1079-1320_1160.wav,VTTS_b-3_1079-1320_1160.wav,2050,2426,-376
1947,b-1_1515-1615_1559.wav,VTTS_b-1_1515-1615_1559.wav,2240,2322,-82
1948,b-1_3329-3429_3334.wav,VTTS_b-1_3329-3429_3334.wav,1490,1463,27
1949,b-3_1862-1959_1895.wav,VTTS_b-3_1862-1959_1895.wav,7490,7001,489
1950,b-3_5853-5956_5887.wav,VTTS_b-3_5853-5956_5887.wav,2820,2543,277
1951,b-1_2624-2724_2625.wav,VTTS_b-1_2624-2724_2625.wav,1380,1358,22
1952,b-1_3026-3126_3050.wav,VTTS_b-1_3026-3126_3050.wav,2020,2055,-35
1953,b-4_2000-5164_4862.wav,VTTS_b-4_2000-5164_4862.wav,7474,7500,-26
1954,b-2_1427-1562_1460.wav,VTTS_b-2_1427-1562_1460.wav,3670,3924,-254
1955,b-3_4607-5008_4796.wav,VTTS_b-3_4607-5008_4796.wav,2990,3007,-17
1956,b-2_2107-2193_2160.wav,VTTS_b-2_2107-2193_2160.wav,1870,1591,279
1957,b-2_2311-2412_2383.wav,VTTS_b-2_2311-2412_2383.wav,4110,5248,-1138
1958,b-4_2000-5164_4714.wav,VTTS_b-4_2000-5164_4714.wav,962,801,161
1959,b-4_1901-2000_1944.wav,VTTS_b-4_1901-2000_1944.wav,1790,1660,130
1960,b-3_1-97_55.wav,VTTS_b-3_1-97_55.wav,3580,3541,39
1961,b-1_2220-2320_2270.wav,VTTS_b-1_2220-2320_2270.wav,1930,1869,61
1962,b-3_501-930_616.wav,VTTS_b-3_501-930_616.wav,2180,2438,-258
1963,b-3_931-979_948.wav,VTTS_b-3_931-979_948.wav,5050,5886,-836
1964,b-3_2267-2349_2317.wav,VTTS_b-3_2267-2349_2317.wav,5940,4644,1296
1965,b-2_1223-1324_1235.wav,VTTS_b-2_1223-1324_1235.wav,2770,2868,-98
1966,b-1_3531-3631_3551.wav,VTTS_b-1_3531-3631_3551.wav,1940,1962,-22
1967,b-1_1717-1817_1772.wav,VTTS_b-1_1717-1817_1772.wav,5950,5016,934
1968,b-1_74-174_115.wav,VTTS_b-1_74-174_115.wav,1410,1498,-88
1969,b-3_6116-6215_6141.wav,VTTS_b-3_6116-6215_6141.wav,2980,2926,54
1970,b-1_1212-1312_1312.wav,VTTS_b-1_1212-1312_1312.wav,4050,3785,265
1971,b-1_2119-2219_2206.wav,VTTS_b-1_2119-2219_2206.wav,1810,3994,-2184
1972,b-3_6801-6900_6813.wav,VTTS_b-3_6801-6900_6813.wav,1600,1463,137
1973,b-4_2000-5164_2617.wav,VTTS_b-4_2000-5164_2617.wav,1825,2032,-207
1974,b-3_1321-1568_1400.wav,VTTS_b-3_1321-1568_1400.wav,7770,6908,862
1975,b-1_4466-4498_4476.wav,VTTS_b-1_4466-4498_4476.wav,1560,1660,-100
1976,b-4_2000-5164_4418.wav,VTTS_b-4_2000-5164_4418.wav,7038,7419,-381
1977,b-4_501-1014_1006.wav,VTTS_b-4_501-1014_1006.wav,6180,5770,410
1978,b-4_501-1014_672.wav,VTTS_b-4_501-1014_672.wav,2840,3065,-225
1979,b-1_2523-2623_2550.wav,VTTS_b-1_2523-2623_2550.wav,3440,3518,-78
1980,b-3_6217-6274_6269.wav,VTTS_b-3_6217-6274_6269.wav,5070,5770,-700
1981,b-2_1223-1324_1262.wav,VTTS_b-2_1223-1324_1262.wav,840,1393,-553
1982,b-4_2000-5164_4707.wav,VTTS_b-4_2000-5164_4707.wav,4625,4017,608
1983,b-1_2321-2421_2323.wav,VTTS_b-1_2321-2421_2323.wav,2660,2647,13
1984,b-1_3430-3530_3516.wav,VTTS_b-1_3430-3530_3516.wav,4840,4899,-59
1985,b-4_2000-5164_2411.wav,VTTS_b-4_2000-5164_2411.wav,7120,7233,-113
1986,b-1_175-275_230.wav,VTTS_b-1_175-275_230.wav,1230,1207,23
1987,b-3_3889-4000_3967.wav,VTTS_b-3_3889-4000_3967.wav,4720,5840,-1120
1988,b-2_2194-2208_2195.wav,VTTS_b-2_2194-2208_2195.wav,1890,2009,-119
1989,b-2_101-202_177.wav,VTTS_b-2_101-202_177.wav,2060,3309,-1249
1990,b-3_6900-7016_6942.wav,VTTS_b-3_6900-7016_6942.wav,4200,4110,90
1991,b-4_2000-5164_3666.wav,VTTS_b-4_2000-5164_3666.wav,6979,9868,-2889
1992,b-4_501-1014_873.wav,VTTS_b-4_501-1014_873.wav,6020,5933,87
1993,b-4_2000-5164_3782.wav,VTTS_b-4_2000-5164_3782.wav,1970,1881,89
1994,b-1_4034-4069_4052.wav,VTTS_b-1_4034-4069_4052.wav,2230,2937,-707
1995,b-3_6900-7016_7009.wav,VTTS_b-3_6900-7016_7009.wav,2280,2125,155
1996,b-1_4430-4465_4442.wav,VTTS_b-1_4430-4465_4442.wav,1340,2032,-692
1997,b-4_2000-5164_3949.wav,VTTS_b-4_2000-5164_3949.wav,4115,4133,-18
1998,b-3_5428-5533_5434.wav,VTTS_b-3_5428-5533_5434.wav,5660,5526,134
1999,b-4_2000-5164_3663.wav,VTTS_b-4_2000-5164_3663.wav,7697,7721,-24
2000,b-1_794-1009_983.wav,VTTS_b-1_794-1009_983.wav,3630,3495,135
2001,b-2_1563-1596_1566.wav,VTTS_b-2_1563-1596_1566.wav,1110,1022,88
2002,b-2_1121-1222_1210.wav,VTTS_b-2_1121-1222_1210.wav,1250,1184,66
2003,b-1_2018-2118_2087.wav,VTTS_b-1_2018-2118_2087.wav,5520,4934,586
2004,b-1_3329-3429_3390.wav,VTTS_b-1_3329-3429_3390.wav,6010,4899,1111
2005,b-4_501-1014_904.wav,VTTS_b-4_501-1014_904.wav,7240,7976,-736
2006,b-4_2000-5164_3119.wav,VTTS_b-4_2000-5164_3119.wav,10980,11610,-630
2007,b-4_1101-1220_1212.wav,VTTS_b-4_1101-1220_1212.wav,10190,9543,647
2008,b-4_1-52_12.wav,VTTS_b-4_1-52_12.wav,4350,4644,-294
2009,b-3_1079-1320_1253.wav,VTTS_b-3_1079-1320_1253.wav,5180,4493,687
2010,b-4_2000-5164_4371.wav,VTTS_b-4_2000-5164_4371.wav,5393,6467,-1074
2011,b-3_1666-1763_1702.wav,VTTS_b-3_1666-1763_1702.wav,8310,8719,-409
2012,b-3_1764-1861_1802.wav,VTTS_b-3_1764-1861_1802.wav,3150,3077,73
2013,b-3_4207-4314_4256.wav,VTTS_b-3_4207-4314_4256.wav,5050,4296,754
2014,b-4_2000-5164_4678.wav,VTTS_b-4_2000-5164_4678.wav,3648,3390,258
2015,b-1_3228-3328_3317.wav,VTTS_b-1_3228-3328_3317.wav,2690,3088,-398
2016,b-2_1121-1222_1192.wav,VTTS_b-2_1121-1222_1192.wav,1820,1741,79
2017,b-3_2855-2942_2910.wav,VTTS_b-3_2855-2942_2910.wav,5290,5782,-492
2018,b-4_501-1014_946.wav,VTTS_b-4_501-1014_946.wav,5350,4609,741
2019,b-4_2000-5164_2002.wav,VTTS_b-4_2000-5164_2002.wav,7277,7779,-502
2020,b-1_2018-2118_2088.wav,VTTS_b-1_2018-2118_2088.wav,1360,1591,-231
2021,b-4_2000-5164_4551.wav,VTTS_b-4_2000-5164_4551.wav,3992,4249,-257
2022,b-1_1010-1110_1109.wav,VTTS_b-1_1010-1110_1109.wav,1310,1428,-118
2023,b-4_501-1014_632.wav,VTTS_b-4_501-1014_632.wav,2850,2694,156
2024,b-4_2000-5164_4961.wav,VTTS_b-4_2000-5164_4961.wav,4643,4540,103
2025,b-1_2523-2623_2563.wav,VTTS_b-1_2523-2623_2563.wav,3570,3820,-250
2026,b-1_2422-2522_2502.wav,VTTS_b-1_2422-2522_2502.wav,4090,4818,-728
2027,b-3_2000-2088_2032.wav,VTTS_b-3_2000-2088_2032.wav,7000,6734,266
2028,b-4_2000-5164_5123.wav,VTTS_b-4_2000-5164_5123.wav,3390,3646,-256
2029,b-1_1919-2017_1954.wav,VTTS_b-1_1919-2017_1954.wav,3170,2786,384
2030,b-2_1223-1324_1308.wav,VTTS_b-2_1223-1324_1308.wav,4160,4969,-809
2031,b-1_3632-3732_3711.wav,VTTS_b-1_3632-3732_3711.wav,2500,3982,-1482
2032,b-1_4178-4213_4202.wav,VTTS_b-1_4178-4213_4202.wav,2030,2218,-188
2033,b-4_2000-5164_3884.wav,VTTS_b-4_2000-5164_3884.wav,3063,2902,161
2034,b-1_3834-3934_3928.wav,VTTS_b-1_3834-3934_3928.wav,2870,2392,478
2035,b-1_3430-3530_3465.wav,VTTS_b-1_3430-3530_3465.wav,5120,5817,-697
2036,b-2_1-100_81.wav,VTTS_b-2_1-100_81.wav,940,1010,-70
2037,b-3_2089-2176_2131.wav,VTTS_b-3_2089-2176_2131.wav,5160,5538,-378
2038,b-3_1764-1861_1844.wav,VTTS_b-3_1764-1861_1844.wav,6620,6513,107
2039,b-3_98-195_99.wav,VTTS_b-3_98-195_99.wav,6890,5921,969
2040,b-4_2000-5164_2054.wav,VTTS_b-4_2000-5164_2054.wav,6195,6281,-86
2041,b-4_2000-5164_2649.wav,VTTS_b-4_2000-5164_2649.wav,1300,1637,-337
2042,b-2_1801-1902_1842.wav,VTTS_b-2_1801-1902_1842.wav,1600,2078,-478
2043,b-1_1616-1716_1662.wav,VTTS_b-1_1616-1716_1662.wav,2720,2821,-101
2044,b-1_1414-1514_1508.wav,VTTS_b-1_1414-1514_1508.wav,2510,3309,-799
2045,b-3_1568-1665_1660.wav,VTTS_b-3_1568-1665_1660.wav,5730,5468,262
2046,b-4_2000-5164_3869.wav,VTTS_b-4_2000-5164_3869.wav,5264,5689,-425
2047,b-3_3112-3197_3191.wav,VTTS_b-3_3112-3197_3191.wav,5550,4598,952
2048,b-3_6801-6900_6830.wav,VTTS_b-3_6801-6900_6830.wav,980,998,-18
2049,b-1_1919-2017_1945.wav,VTTS_b-1_1919-2017_1945.wav,1320,1242,78
2050,b-2_407-508_485.wav,VTTS_b-2_407-508_485.wav,2740,2728,12
2051,b-2_1-100_95.wav,VTTS_b-2_1-100_95.wav,5010,7697,-2687
2052,b-3_2524-2854_2545.wav,VTTS_b-3_2524-2854_2545.wav,4250,4145,105
2053,b-4_2000-5164_2025.wav,VTTS_b-4_2000-5164_2025.wav,8085,7744,341
2054,b-4_2000-5164_3216.wav,VTTS_b-4_2000-5164_3216.wav,8126,10507,-2381
2055,b-2_509-610_598.wav,VTTS_b-2_509-610_598.wav,1930,1904,26
2056,b-1_2624-2724_2675.wav,VTTS_b-1_2624-2724_2675.wav,1810,1834,-24
2057,b-4_2000-5164_3832.wav,VTTS_b-4_2000-5164_3832.wav,5511,5642,-131
2058,b-2_1427-1562_1560.wav,VTTS_b-2_1427-1562_1560.wav,2100,2879,-779
2059,b-1_2826-2926_2832.wav,VTTS_b-1_2826-2926_2832.wav,1810,1718,92
2060,b-1_1111-1211_1127.wav,VTTS_b-1_1111-1211_1127.wav,3360,3007,353
2061,b-2_407-508_434.wav,VTTS_b-2_407-508_434.wav,2030,1823,207
2062,b-4_1014-1100_1051.wav,VTTS_b-4_1014-1100_1051.wav,4510,4632,-122
2063,b-4_2000-5164_3034.wav,VTTS_b-4_2000-5164_3034.wav,4853,5190,-337
2064,b-4_2000-5164_3047.wav,VTTS_b-4_2000-5164_3047.wav,7202,6931,271
2065,b-1_2119-2219_2166.wav,VTTS_b-1_2119-2219_2166.wav,2920,2856,64
2066,b-3_4498-4605_4573.wav,VTTS_b-3_4498-4605_4573.wav,2910,2833,77
2067,b-4_2000-5164_2080.wav,VTTS_b-4_2000-5164_2080.wav,4100,4226,-126
2068,b-3_3803-3888_3813.wav,VTTS_b-3_3803-3888_3813.wav,12640,10902,1738
2069,b-4_1014-1100_1056.wav,VTTS_b-4_1014-1100_1056.wav,4970,4528,442
2070,b-4_2000-5164_4060.wav,VTTS_b-4_2000-5164_4060.wav,1988,2136,-148
2071,b-3_5009-5427_5167.wav,VTTS_b-3_5009-5427_5167.wav,5440,5375,65
2072,b-3_3628-3714_3672.wav,VTTS_b-3_3628-3714_3672.wav,4300,4505,-205
2073,b-1_3632-3732_3665.wav,VTTS_b-1_3632-3732_3665.wav,3340,3866,-526
2074,b-1_2624-2724_2699.wav,VTTS_b-1_2624-2724_2699.wav,2430,2844,-414
2075,b-4_501-1014_561.wav,VTTS_b-4_501-1014_561.wav,1290,1115,175
2076,b-2_1019-1120_1067.wav,VTTS_b-2_1019-1120_1067.wav,1900,2392,-492
2077,b-1_3733-3833_3772.wav,VTTS_b-1_3733-3833_3772.wav,2770,3460,-690
2078,b-3_1666-1763_1685.wav,VTTS_b-3_1666-1763_1685.wav,10530,10519,11
2079,b-3_294-391_322.wav,VTTS_b-3_294-391_322.wav,7210,7140,70
2080,b-1_2826-2926_2891.wav,VTTS_b-1_2826-2926_2891.wav,4300,4760,-460
2081,b-4_2000-5164_2810.wav,VTTS_b-4_2000-5164_2810.wav,12360,11088,1272
2082,b-1_1-73_64.wav,VTTS_b-1_1-73_64.wav,2500,3471,-971
2083,b-2_1699-1800_1776.wav,VTTS_b-2_1699-1800_1776.wav,2550,2426,124
2084,b-3_3454-3537_3535.wav,VTTS_b-3_3454-3537_3535.wav,2410,2786,-376
2085,b-2_1563-1596_1588.wav,VTTS_b-2_1563-1596_1588.wav,7230,7999,-769
2086,b-4_2000-5164_3835.wav,VTTS_b-4_2000-5164_3835.wav,6369,6769,-400
2087,b-3_501-930_778.wav,VTTS_b-3_501-930_778.wav,3520,3483,37
2088,b-3_6900-7016_6925.wav,VTTS_b-3_6900-7016_6925.wav,6610,6420,190
2089,b-2_305-406_377.wav,VTTS_b-2_305-406_377.wav,1630,1393,237
2090,b-3_196-293_258.wav,VTTS_b-3_196-293_258.wav,3610,4354,-744
2091,b-3_2089-2176_2112.wav,VTTS_b-3_2089-2176_2112.wav,6410,7628,-1218
2092,b-1_3430-3530_3431.wav,VTTS_b-1_3430-3530_3431.wav,5710,4690,1020
2093,b-1_4358-4393_4376.wav,VTTS_b-1_4358-4393_4376.wav,3790,4191,-401
2094,b-4_2000-5164_3136.wav,VTTS_b-4_2000-5164_3136.wav,2626,2473,153
2095,b-2_1-100_35.wav,VTTS_b-2_1-100_35.wav,1520,1823,-303
2096,b-3_6900-7016_7000.wav,VTTS_b-3_6900-7016_7000.wav,8120,6989,1131
2097,b-1_1616-1716_1688.wav,VTTS_b-1_1616-1716_1688.wav,2190,2020,170
2098,b-4_1401-1505_1449.wav,VTTS_b-4_1401-1505_1449.wav,5440,5782,-342
2099,b-4_1401-1505_1488.wav,VTTS_b-4_1401-1505_1488.wav,6520,7198,-678
2100,b-1_377-477_443.wav,VTTS_b-1_377-477_443.wav,3020,2961,59
2101,b-4_1901-2000_1982.wav,VTTS_b-4_1901-2000_1982.wav,4790,4214,576
2102,b-4_1601-1706_1689.wav,VTTS_b-4_1601-1706_1689.wav,5250,4807,443
2103,b-2_1427-1562_1524.wav,VTTS_b-2_1427-1562_1524.wav,7440,11610,-4170
2104,b-2_203-304_204.wav,VTTS_b-2_203-304_204.wav,1570,1660,-90
2105,b-2_1325-1426_1354.wav,VTTS_b-2_1325-1426_1354.wav,7630,7047,583
2106,b-4_1506-1600_1584.wav,VTTS_b-4_1506-1600_1584.wav,6880,6188,692
2107,b-2_917-1018_927.wav,VTTS_b-2_917-1018_927.wav,2550,3135,-585
2108,b-3_2000-2088_2064.wav,VTTS_b-3_2000-2088_2064.wav,2720,3402,-682
2109,b-3_6116-6215_6212.wav,VTTS_b-3_6116-6215_6212.wav,980,917,63
2110,b-2_1-100_62.wav,VTTS_b-2_1-100_62.wav,2910,4319,-1409
2111,b-2_713-814_742.wav,VTTS_b-2_713-814_742.wav,2450,2078,372
2112,b-3_1321-1568_1473.wav,VTTS_b-3_1321-1568_1473.wav,3800,3379,421
2113,b-4_2000-5164_5027.wav,VTTS_b-4_2000-5164_5027.wav,5094,4748,346
2114,b-3_1321-1568_1343.wav,VTTS_b-3_1321-1568_1343.wav,4690,5526,-836
2115,b-1_175-275_244.wav,VTTS_b-1_175-275_244.wav,1660,1440,220
2116,b-2_713-814_776.wav,VTTS_b-2_713-814_776.wav,1280,1277,3
2117,b-3_4498-4605_4546.wav,VTTS_b-3_4498-4605_4546.wav,5790,6153,-363
2118,b-4_2000-5164_3542.wav,VTTS_b-4_2000-5164_3542.wav,2827,2879,-52
2119,b-1_3127-3227_3148.wav,VTTS_b-1_3127-3227_3148.wav,1730,1579,151
2120,b-4_53-150_102.wav,VTTS_b-4_53-150_102.wav,6860,7279,-419
2121,b-3_3454-3537_3481.wav,VTTS_b-3_3454-3537_3481.wav,6120,6037,83
2122,b-3_2524-2854_2624.wav,VTTS_b-3_2524-2854_2624.wav,10980,10252,728
2123,b-2_1903-2038_1906.wav,VTTS_b-2_1903-2038_1906.wav,5310,4818,492
2124,b-2_305-406_341.wav,VTTS_b-2_305-406_341.wav,1540,1289,251
2125,b-3_2000-2088_2018.wav,VTTS_b-3_2000-2088_2018.wav,7400,7001,399
2126,b-2_1903-2038_2035.wav,VTTS_b-2_1903-2038_2035.wav,9320,7407,1913
2127,b-4_2000-5164_4367.wav,VTTS_b-4_2000-5164_4367.wav,6097,6560,-463
2128,b-1_1010-1110_1027.wav,VTTS_b-1_1010-1110_1027.wav,1210,1103,107
2129,b-3_4607-5008_4916.wav,VTTS_b-3_4607-5008_4916.wav,4640,4354,286
2130,b-3_1321-1568_1568.wav,VTTS_b-3_1321-1568_1568.wav,8630,8580,50
2131,b-3_6900-7016_6900.wav,VTTS_b-3_6900-7016_6900.wav,7300,7001,299
2132,b-3_1321-1568_1423.wav,VTTS_b-3_1321-1568_1423.wav,3790,3274,516
2133,b-1_3329-3429_3352.wav,VTTS_b-1_3329-3429_3352.wav,1200,1254,-54
2134,b-2_1903-2038_1978.wav,VTTS_b-2_1903-2038_1978.wav,3710,3309,401
2135,b-4_53-150_75.wav,VTTS_b-4_53-150_75.wav,9550,7546,2004
2136,b-3_3803-3888_3857.wav,VTTS_b-3_3803-3888_3857.wav,4430,3889,541
2137,b-3_1079-1320_1205.wav,VTTS_b-3_1079-1320_1205.wav,5930,5933,-3
2138,b-1_3228-3328_3248.wav,VTTS_b-1_3228-3328_3248.wav,2430,2380,50
2139,b-4_2000-5164_2905.wav,VTTS_b-4_2000-5164_2905.wav,6151,5712,439
2140,b-3_5009-5427_5359.wav,VTTS_b-3_5009-5427_5359.wav,5480,6084,-604
2141,b-2_713-814_717.wav,VTTS_b-2_713-814_717.wav,6550,7930,-1380
2142,b-1_3733-3833_3784.wav,VTTS_b-1_3733-3833_3784.wav,4740,5712,-972
2143,b-1_3834-3934_3836.wav,VTTS_b-1_3834-3934_3836.wav,4110,4005,105
2144,b-3_4001-4103_4098.wav,VTTS_b-3_4001-4103_4098.wav,3790,3727,63
2145,b-4_2000-5164_2494.wav,VTTS_b-4_2000-5164_2494.wav,4200,6629,-2429
2146,b-1_478-578_519.wav,VTTS_b-1_478-578_519.wav,2010,1869,141
2147,b-1_4178-4213_4208.wav,VTTS_b-1_4178-4213_4208.wav,3120,3158,-38
2148,b-2_1903-2038_1937.wav,VTTS_b-2_1903-2038_1937.wav,2520,2659,-139
2149,b-3_5533-5638_5607.wav,VTTS_b-3_5533-5638_5607.wav,5340,5968,-628
2150,b-3_3364-3453_3426.wav,VTTS_b-3_3364-3453_3426.wav,8650,8011,639
2151,b-2_407-508_411.wav,VTTS_b-2_407-508_411.wav,2260,1939,321
2152,b-4_2000-5164_3950.wav,VTTS_b-4_2000-5164_3950.wav,7153,8359,-1206
2153,b-3_2350-2433_2398.wav,VTTS_b-3_2350-2433_2398.wav,6080,5875,205
2154,b-3_5009-5427_5071.wav,VTTS_b-3_5009-5427_5071.wav,3010,3483,-473
2155,b-1_3531-3631_3629.wav,VTTS_b-1_3531-3631_3629.wav,3490,3216,274
2156,b-4_2000-5164_3973.wav,VTTS_b-4_2000-5164_3973.wav,6294,6281,13
2157,b-1_3935-4033_4025.wav,VTTS_b-1_3935-4033_4025.wav,1180,1173,7
2158,b-1_1717-1817_1775.wav,VTTS_b-1_1717-1817_1775.wav,1440,1416,24
2159,b-1_1010-1110_1108.wav,VTTS_b-1_1010-1110_1108.wav,2070,2368,-298
2160,b-1_2725-2825_2775.wav,VTTS_b-1_2725-2825_2775.wav,2080,1927,153
2161,b-3_2089-2176_2161.wav,VTTS_b-3_2089-2176_2161.wav,4510,4621,-111
2162,b-2_1019-1120_1114.wav,VTTS_b-2_1019-1120_1114.wav,1840,1347,493
2163,b-3_6900-7016_6963.wav,VTTS_b-3_6900-7016_6963.wav,6370,6444,-74
2164,b-2_2413-2500_2466.wav,VTTS_b-2_2413-2500_2466.wav,2800,3170,-370
2165,b-3_6900-7016_6901.wav,VTTS_b-3_6900-7016_6901.wav,6360,5608,752
2166,b-1_3531-3631_3567.wav,VTTS_b-1_3531-3631_3567.wav,4590,5039,-449
2167,b-3_1-97_43.wav,VTTS_b-3_1-97_43.wav,7010,6711,299
2168,b-4_2000-5164_4595.wav,VTTS_b-4_2000-5164_4595.wav,15858,11610,4248
2169,b-1_3632-3732_3662.wav,VTTS_b-1_3632-3732_3662.wav,2440,2589,-149
2170,b-1_1111-1211_1128.wav,VTTS_b-1_1111-1211_1128.wav,2170,3100,-930
2171,b-4_2000-5164_4442.wav,VTTS_b-4_2000-5164_4442.wav,2710,2961,-251
2172,b-4_1506-1600_1591.wav,VTTS_b-4_1506-1600_1591.wav,3510,3796,-286
2173,b-4_2000-5164_3696.wav,VTTS_b-4_2000-5164_3696.wav,1529,1440,89
2174,b-3_2855-2942_2859.wav,VTTS_b-3_2855-2942_2859.wav,5250,5561,-311
2175,b-1_2927-3025_2938.wav,VTTS_b-1_2927-3025_2938.wav,4080,4075,5
2176,b-4_501-1014_940.wav,VTTS_b-4_501-1014_940.wav,4260,4481,-221
2177,b-3_3025-3111_3045.wav,VTTS_b-3_3025-3111_3045.wav,6510,6142,368
2178,b-3_4104-4206_4204.wav,VTTS_b-3_4104-4206_4204.wav,8420,9927,-1507
2179,b-3_5009-5427_5153.wav,VTTS_b-3_5009-5427_5153.wav,3170,2833,337
2180,b-3_4315-4424_4361.wav,VTTS_b-3_4315-4424_4361.wav,4720,4481,239
2181,b-2_2311-2412_2337.wav,VTTS_b-2_2311-2412_2337.wav,3140,3413,-273
2182,b-1_4286-4321_4315.wav,VTTS_b-1_4286-4321_4315.wav,1620,1544,76
2183,b-3_3889-4000_3990.wav,VTTS_b-3_3889-4000_3990.wav,4810,5085,-275
2184,b-3_501-930_528.wav,VTTS_b-3_501-930_528.wav,4370,4145,225
2185,b-4_1-52_50.wav,VTTS_b-4_1-52_50.wav,14140,11610,2530
2186,b-2_1325-1426_1427.wav,VTTS_b-2_1325-1426_1427.wav,2000,2415,-415
2187,b-3_5009-5427_5383.wav,VTTS_b-3_5009-5427_5383.wav,9670,11192,-1522
2188,b-3_5745-5852_5843.wav,VTTS_b-3_5745-5852_5843.wav,9810,9300,510
2189,b-2_1-100_75.wav,VTTS_b-2_1-100_75.wav,1390,1254,136
2190,b-3_6601-6700_6606.wav,VTTS_b-3_6601-6700_6606.wav,5390,6200,-810
2191,b-3_2434-2523_2514.wav,VTTS_b-3_2434-2523_2514.wav,6930,7396,-466
2192,b-4_1-52_42.wav,VTTS_b-4_1-52_42.wav,8280,6049,2231
2193,b-1_4142-4177_4165.wav,VTTS_b-1_4142-4177_4165.wav,2290,2241,49
2194,b-3_5009-5427_5108.wav,VTTS_b-3_5009-5427_5108.wav,3550,2868,682
2195,b-1_1111-1211_1116.wav,VTTS_b-1_1111-1211_1116.wav,3730,3727,3
2196,b-1_4106-4141_4122.wav,VTTS_b-1_4106-4141_4122.wav,1070,1022,48
2197,b-1_1212-1312_1238.wav,VTTS_b-1_1212-1312_1238.wav,3240,2798,442
2198,b-1_3632-3732_3659.wav,VTTS_b-1_3632-3732_3659.wav,2690,3007,-317
2199,b-1_3632-3732_3717.wav,VTTS_b-1_3632-3732_3717.wav,3170,3959,-789
2200,b-4_1707-1813_1711.wav,VTTS_b-4_1707-1813_1711.wav,6020,5596,424
2201,b-3_3715-3802_3800.wav,VTTS_b-3_3715-3802_3800.wav,5300,5863,-563
2202,b-1_4178-4213_4195.wav,VTTS_b-1_4178-4213_4195.wav,4030,4423,-393
2203,b-1_478-578_573.wav,VTTS_b-1_478-578_573.wav,4640,4168,472
2204,b-1_1818-1918_1851.wav,VTTS_b-1_1818-1918_1851.wav,4420,4725,-305
2205,b-3_4607-5008_4798.wav,VTTS_b-3_4607-5008_4798.wav,3120,3030,90
2206,b-2_2073-2106_2087.wav,VTTS_b-2_2073-2106_2087.wav,1340,1358,-18
2207,b-4_1506-1600_1540.wav,VTTS_b-4_1506-1600_1540.wav,1680,1416,264
2208,b-3_1079-1320_1284.wav,VTTS_b-3_1079-1320_1284.wav,2930,3936,-1006
2209,b-3_294-391_296.wav,VTTS_b-3_294-391_296.wav,3960,3611,349
2210,b-2_1427-1562_1530.wav,VTTS_b-2_1427-1562_1530.wav,4500,4145,355
2211,b-1_3127-3227_3201.wav,VTTS_b-1_3127-3227_3201.wav,2080,2032,48
2212,b-3_6900-7016_6930.wav,VTTS_b-3_6900-7016_6930.wav,3110,2647,463
2213,b-4_1707-1813_1731.wav,VTTS_b-4_1707-1813_1731.wav,5470,6920,-1450
2214,b-3_6900-7016_6924.wav,VTTS_b-3_6900-7016_6924.wav,6900,7152,-252
2215,b-2_1019-1120_1082.wav,VTTS_b-2_1019-1120_1082.wav,5750,7732,-1982
2216,b-3_501-930_897.wav,VTTS_b-3_501-930_897.wav,840,836,4
2217,b-1_4214-4285_4260.wav,VTTS_b-1_4214-4285_4260.wav,1470,1579,-109
2218,b-1_377-477_470.wav,VTTS_b-1_377-477_470.wav,2820,4087,-1267
2219,b-3_3803-3888_3883.wav,VTTS_b-3_3803-3888_3883.wav,4900,4598,302
2220,b-1_1414-1514_1481.wav,VTTS_b-1_1414-1514_1481.wav,3800,3587,213
2221,b-1_74-174_105.wav,VTTS_b-1_74-174_105.wav,5930,4772,1158
2222,b-4_501-1014_504.wav,VTTS_b-4_501-1014_504.wav,3450,3146,304
2223,b-2_611-712_677.wav,VTTS_b-2_611-712_677.wav,3630,3657,-27
2224,b-4_2000-5164_2664.wav,VTTS_b-4_2000-5164_2664.wav,5600,6397,-797
2225,b-3_3198-3278_3248.wav,VTTS_b-3_3198-3278_3248.wav,2940,2694,246
2226,b-3_6701-6800_6743.wav,VTTS_b-3_6701-6800_6743.wav,3220,4423,-1203
2227,b-1_2119-2219_2165.wav,VTTS_b-1_2119-2219_2165.wav,1310,1335,-25
2228,b-1_2523-2623_2616.wav,VTTS_b-1_2523-2623_2616.wav,1460,1451,9
2229,b-1_3935-4033_3960.wav,VTTS_b-1_3935-4033_3960.wav,2410,2763,-353
2230,b-4_2000-5164_2945.wav,VTTS_b-4_2000-5164_2945.wav,5161,4981,180
2231,b-3_3198-3278_3257.wav,VTTS_b-3_3198-3278_3257.wav,6360,5921,439
2232,b-1_1919-2017_1939.wav,VTTS_b-1_1919-2017_1939.wav,3490,4435,-945
2233,b-1_2725-2825_2778.wav,VTTS_b-1_2725-2825_2778.wav,1540,1509,31
2234,b-1_1212-1312_1220.wav,VTTS_b-1_1212-1312_1220.wav,1620,1649,-29
2235,b-3_3628-3714_3651.wav,VTTS_b-3_3628-3714_3651.wav,3550,3587,-37
2236,b-4_1014-1100_1089.wav,VTTS_b-4_1014-1100_1089.wav,4510,4423,87
2237,b-4_1014-1100_1018.wav,VTTS_b-4_1014-1100_1018.wav,2400,2589,-189
2238,b-4_2000-5164_2152.wav,VTTS_b-4_2000-5164_2152.wav,1580,1602,-22
2239,b-1_4214-4285_4248.wav,VTTS_b-1_4214-4285_4248.wav,3360,3762,-402
2240,b-1_686-793_728.wav,VTTS_b-1_686-793_728.wav,1320,1347,-27
2241,b-3_3715-3802_3723.wav,VTTS_b-3_3715-3802_3723.wav,4280,3936,344
2242,b-1_2018-2118_2104.wav,VTTS_b-1_2018-2118_2104.wav,1800,1776,24
2243,b-1_4070-4105_4081.wav,VTTS_b-1_4070-4105_4081.wav,2220,2218,2
2244,b-2_2073-2106_2080.wav,VTTS_b-2_2073-2106_2080.wav,2020,1474,546
2245,b-4_2000-5164_3041.wav,VTTS_b-4_2000-5164_3041.wav,5994,5341,653
2246,b-1_2119-2219_2164.wav,VTTS_b-1_2119-2219_2164.wav,1660,1660,0
2247,b-3_3112-3197_3199.wav,VTTS_b-3_3112-3197_3199.wav,6160,6432,-272
2248,b-1_2018-2118_2029.wav,VTTS_b-1_2018-2118_2029.wav,2400,2194,206
2249,b-3_2524-2854_2710.wav,VTTS_b-3_2524-2854_2710.wav,7140,6803,337
2250,b-2_1019-1120_1054.wav,VTTS_b-2_1019-1120_1054.wav,1470,1370,100
2251,b-4_2000-5164_5109.wav,VTTS_b-4_2000-5164_5109.wav,6117,9996,-3879
2252,b-1_2523-2623_2579.wav,VTTS_b-1_2523-2623_2579.wav,1700,1765,-65
2253,b-1_276-376_377.wav,VTTS_b-1_276-376_377.wav,870,1033,-163
2254,b-1_3329-3429_3377.wav,VTTS_b-1_3329-3429_3377.wav,1380,1347,33
2255,b-4_2000-5164_3491.wav,VTTS_b-4_2000-5164_3491.wav,1341,1184,157
2256,b-3_3364-3453_3449.wav,VTTS_b-3_3364-3453_3449.wav,3440,3367,73
2257,b-4_2000-5164_3798.wav,VTTS_b-4_2000-5164_3798.wav,1800,1707,93
2258,b-2_1903-2038_1921.wav,VTTS_b-2_1903-2038_1921.wav,6600,4888,1712
2259,b-4_2000-5164_2302.wav,VTTS_b-4_2000-5164_2302.wav,1940,1765,175
2260,b-1_1313-1413_1348.wav,VTTS_b-1_1313-1413_1348.wav,1630,1509,121
2261,b-3_4104-4206_4128.wav,VTTS_b-3_4104-4206_4128.wav,1470,1474,-4
2262,b-1_2018-2118_2033.wav,VTTS_b-1_2018-2118_2033.wav,9540,8104,1436
2263,b-4_2000-5164_4058.wav,VTTS_b-4_2000-5164_4058.wav,6475,5968,507
2264,b-3_5009-5427_5202.wav,VTTS_b-3_5009-5427_5202.wav,7110,7837,-727
2265,b-4_1901-2000_1939.wav,VTTS_b-4_1901-2000_1939.wav,4300,5155,-855
2266,b-4_53-150_108.wav,VTTS_b-4_53-150_108.wav,7860,8766,-906
2267,b-4_2000-5164_3675.wav,VTTS_b-4_2000-5164_3675.wav,7660,10321,-2661
2268,b-1_3834-3934_3874.wav,VTTS_b-1_3834-3934_3874.wav,2320,2612,-292
2269,b-1_2624-2724_2641.wav,VTTS_b-1_2624-2724_2641.wav,1440,1451,-11
2270,b-3_1568-1665_1574.wav,VTTS_b-3_1568-1665_1574.wav,2670,2670,0
2271,b-3_4001-4103_4054.wav,VTTS_b-3_4001-4103_4054.wav,6790,6873,-83
2272,b-3_6016-6115_6059.wav,VTTS_b-3_6016-6115_6059.wav,7480,5492,1988
2273,b-2_1699-1800_1710.wav,VTTS_b-2_1699-1800_1710.wav,3290,3193,97
2274,b-1_74-174_104.wav,VTTS_b-1_74-174_104.wav,3740,3564,176
2275,b-3_5009-5427_5338.wav,VTTS_b-3_5009-5427_5338.wav,4320,3796,524
2276,b-1_3329-3429_3358.wav,VTTS_b-1_3329-3429_3358.wav,5680,6037,-357
2277,b-1_276-376_348.wav,VTTS_b-1_276-376_348.wav,3370,5085,-1715
2278,b-3_980-1077_980.wav,VTTS_b-3_980-1077_980.wav,4540,4319,221
2279,b-3_2855-2942_2914.wav,VTTS_b-3_2855-2942_2914.wav,4590,4807,-217
2280,b-4_2000-5164_4006.wav,VTTS_b-4_2000-5164_4006.wav,3794,4331,-537
2281,b-4_501-1014_793.wav,VTTS_b-4_501-1014_793.wav,7690,8522,-832
2282,b-4_2000-5164_3233.wav,VTTS_b-4_2000-5164_3233.wav,3009,2879,130
2283,b-1_2927-3025_2972.wav,VTTS_b-1_2927-3025_2972.wav,3680,3866,-186
2284,b-4_2000-5164_4043.wav,VTTS_b-4_2000-5164_4043.wav,5791,6095,-304
2285,b-2_1427-1562_1536.wav,VTTS_b-2_1427-1562_1536.wav,2310,2473,-163
2286,b-1_3834-3934_3926.wav,VTTS_b-1_3834-3934_3926.wav,4350,4574,-224
2287,b-1_276-376_352.wav,VTTS_b-1_276-376_352.wav,2250,2032,218
2288,b-4_2000-5164_3108.wav,VTTS_b-4_2000-5164_3108.wav,1712,1486,226
2289,b-2_203-304_257.wav,VTTS_b-2_203-304_257.wav,1080,1057,23
2290,b-1_2220-2320_2300.wav,VTTS_b-1_2220-2320_2300.wav,2870,3286,-416
2291,b-1_2927-3025_2952.wav,VTTS_b-1_2927-3025_2952.wav,4430,6177,-1747
2292,b-3_501-930_573.wav,VTTS_b-3_501-930_573.wav,4830,4481,349
2293,b-3_3889-4000_3910.wav,VTTS_b-3_3889-4000_3910.wav,5410,5062,348
2294,b-3_4315-4424_4401.wav,VTTS_b-3_4315-4424_4401.wav,4090,4389,-299
2295,b-2_2107-2193_2174.wav,VTTS_b-2_2107-2193_2174.wav,3770,6734,-2964
2296,b-1_175-275_222.wav,VTTS_b-1_175-275_222.wav,1810,1834,-24
2297,b-3_2000-2088_2020.wav,VTTS_b-3_2000-2088_2020.wav,7520,5294,2226
2298,b-3_3803-3888_3817.wav,VTTS_b-3_3803-3888_3817.wav,8470,8440,30
2299,b-3_6217-6274_6217.wav,VTTS_b-3_6217-6274_6217.wav,12550,11610,940
2300,b-1_3430-3530_3444.wav,VTTS_b-1_3430-3530_3444.wav,1980,1974,6
2301,b-3_2000-2088_2017.wav,VTTS_b-3_2000-2088_2017.wav,7470,7523,-53
2302,b-2_1597-1698_1680.wav,VTTS_b-2_1597-1698_1680.wav,5340,4296,1044
2303,b-4_2000-5164_3827.wav,VTTS_b-4_2000-5164_3827.wav,9012,9636,-624
2304,b-3_1321-1568_1362.wav,VTTS_b-3_1321-1568_1362.wav,3180,3065,115
2305,b-3_5533-5638_5541.wav,VTTS_b-3_5533-5638_5541.wav,4550,3843,707
2306,b-1_2725-2825_2771.wav,VTTS_b-1_2725-2825_2771.wav,4470,4516,-46
2307,b-1_1212-1312_1267.wav,VTTS_b-1_1212-1312_1267.wav,2970,2670,300
2308,b-3_980-1077_1072.wav,VTTS_b-3_980-1077_1072.wav,2220,2125,95
2309,b-3_5533-5638_5593.wav,VTTS_b-3_5533-5638_5593.wav,2140,2461,-321
2310,b-3_6801-6900_6862.wav,VTTS_b-3_6801-6900_6862.wav,3050,3019,31
2311,b-1_3733-3833_3790.wav,VTTS_b-1_3733-3833_3790.wav,2260,2403,-143
2312,b-1_3228-3328_3254.wav,VTTS_b-1_3228-3328_3254.wav,1440,1393,47
2313,b-1_3733-3833_3828.wav,VTTS_b-1_3733-3833_3828.wav,1260,1080,180
2314,b-3_501-930_855.wav,VTTS_b-3_501-930_855.wav,5960,5433,527
2315,b-1_1212-1312_1243.wav,VTTS_b-1_1212-1312_1243.wav,1280,1300,-20
2316,b-3_6801-6900_6873.wav,VTTS_b-3_6801-6900_6873.wav,7250,8649,-1399
2317,b-4_2000-5164_4966.wav,VTTS_b-4_2000-5164_4966.wav,6141,6293,-152
2318,b-4_2000-5164_2249.wav,VTTS_b-4_2000-5164_2249.wav,1410,1416,-6
2319,b-4_2000-5164_3957.wav,VTTS_b-4_2000-5164_3957.wav,3932,3889,43
2320,b-4_2000-5164_2761.wav,VTTS_b-4_2000-5164_2761.wav,5500,5050,450
2321,b-3_2267-2349_2322.wav,VTTS_b-3_2267-2349_2322.wav,6420,7593,-1173
2322,b-3_4607-5008_4842.wav,VTTS_b-3_4607-5008_4842.wav,3350,3251,99
2323,b-3_5009-5427_5410.wav,VTTS_b-3_5009-5427_5410.wav,6770,6432,338
2324,b-3_1079-1320_1321.wav,VTTS_b-3_1079-1320_1321.wav,1920,1916,4
2325,b-1_4286-4321_4299.wav,VTTS_b-1_4286-4321_4299.wav,1900,1660,240
2326,b-4_2000-5164_4460.wav,VTTS_b-4_2000-5164_4460.wav,5064,5201,-137
2327,b-4_151-300_234.wav,VTTS_b-4_151-300_234.wav,3370,3297,73
2328,b-3_6301-6400_6389.wav,VTTS_b-3_6301-6400_6389.wav,8420,7674,746
2329,b-3_392-500_443.wav,VTTS_b-3_392-500_443.wav,3240,3204,36
2330,b-2_1325-1426_1328.wav,VTTS_b-2_1325-1426_1328.wav,4500,3320,1180
2331,b-2_1223-1324_1293.wav,VTTS_b-2_1223-1324_1293.wav,3750,3831,-81
2332,b-1_3834-3934_3902.wav,VTTS_b-1_3834-3934_3902.wav,2700,2740,-40
2333,b-1_4394-4429_4403.wav,VTTS_b-1_4394-4429_4403.wav,2320,2426,-106
2334,b-4_2000-5164_4413.wav,VTTS_b-4_2000-5164_4413.wav,1825,2229,-404
2335,b-3_5853-5956_5928.wav,VTTS_b-3_5853-5956_5928.wav,5340,5399,-59
2336,b-3_196-293_292.wav,VTTS_b-3_196-293_292.wav,4860,4888,-28
2337,b-4_1101-1220_1189.wav,VTTS_b-4_1101-1220_1189.wav,5180,4656,524
2338,b-3_5533-5638_5570.wav,VTTS_b-3_5533-5638_5570.wav,3970,3762,208
2339,b-3_4607-5008_4791.wav,VTTS_b-3_4607-5008_4791.wav,6850,9288,-2438
2340,b-3_4607-5008_4701.wav,VTTS_b-3_4607-5008_4701.wav,6720,6118,602
2341,b-4_501-1014_725.wav,VTTS_b-4_501-1014_725.wav,2750,4052,-1302
2342,b-3_2524-2854_2844.wav,VTTS_b-3_2524-2854_2844.wav,2700,2833,-133
2343,b-1_2422-2522_2425.wav,VTTS_b-1_2422-2522_2425.wav,2570,2717,-147
2344,b-1_650-685_670.wav,VTTS_b-1_650-685_670.wav,2770,3042,-272
2345,b-3_3025-3111_3073.wav,VTTS_b-3_3025-3111_3073.wav,5760,6374,-614
2346,b-3_1079-1320_1126.wav,VTTS_b-3_1079-1320_1126.wav,7010,6838,172
2347,b-4_2000-5164_2601.wav,VTTS_b-4_2000-5164_2601.wav,4845,4865,-20
2348,b-1_4466-4498_4488.wav,VTTS_b-1_4466-4498_4488.wav,3790,3657,133
2349,b-2_1903-2038_1965.wav,VTTS_b-2_1903-2038_1965.wav,1960,1358,602
2350,b-4_1014-1100_1098.wav,VTTS_b-4_1014-1100_1098.wav,7250,5178,2072
2351,b-3_4607-5008_4950.wav,VTTS_b-3_4607-5008_4950.wav,5920,5747,173
2352,b-4_1707-1813_1803.wav,VTTS_b-4_1707-1813_1803.wav,6710,6327,383
2353,b-4_2000-5164_3454.wav,VTTS_b-4_2000-5164_3454.wav,3317,4481,-1164
2354,b-4_2000-5164_4259.wav,VTTS_b-4_2000-5164_4259.wav,4375,5457,-1082
2355,b-1_579-649_588.wav,VTTS_b-1_579-649_588.wav,4130,4226,-96
2356,b-3_6401-6500_6434.wav,VTTS_b-3_6401-6500_6434.wav,5860,6734,-874
2357,b-2_2413-2500_2472.wav,VTTS_b-2_2413-2500_2472.wav,2200,1416,784
2358,b-3_1862-1959_1898.wav,VTTS_b-3_1862-1959_1898.wav,2630,2380,250
2359,b-2_407-508_414.wav,VTTS_b-2_407-508_414.wav,4290,4644,-354
2360,b-3_6701-6800_6770.wav,VTTS_b-3_6701-6800_6770.wav,1970,2194,-224
2361,b-3_4607-5008_4774.wav,VTTS_b-3_4607-5008_4774.wav,2760,2670,90
2362,b-1_4286-4321_4309.wav,VTTS_b-1_4286-4321_4309.wav,3050,2577,473
2363,b-3_2855-2942_2940.wav,VTTS_b-3_2855-2942_2940.wav,4210,4470,-260
2364,b-3_4315-4424_4326.wav,VTTS_b-3_4315-4424_4326.wav,4210,5399,-1189
2365,b-1_3935-4033_4005.wav,VTTS_b-1_3935-4033_4005.wav,2000,2032,-32
2366,b-3_6701-6800_6751.wav,VTTS_b-3_6701-6800_6751.wav,7650,7755,-105
2367,b-1_478-578_491.wav,VTTS_b-1_478-578_491.wav,4750,5213,-463
2368,b-2_305-406_371.wav,VTTS_b-2_305-406_371.wav,5080,3866,1214
2369,b-4_2000-5164_3393.wav,VTTS_b-4_2000-5164_3393.wav,1101,1091,10
2370,b-3_1079-1320_1220.wav,VTTS_b-3_1079-1320_1220.wav,7120,7140,-20
2371,b-3_3628-3714_3644.wav,VTTS_b-3_3628-3714_3644.wav,4570,4690,-120
2372,b-3_5533-5638_5551.wav,VTTS_b-3_5533-5638_5551.wav,4000,4296,-296
2373,b-1_2624-2724_2642.wav,VTTS_b-1_2624-2724_2642.wav,1780,1765,15
2374,b-4_2000-5164_5010.wav,VTTS_b-4_2000-5164_5010.wav,3710,3228,482
2375,b-1_4142-4177_4146.wav,VTTS_b-1_4142-4177_4146.wav,4590,4458,132
2376,b-3_1568-1665_1636.wav,VTTS_b-3_1568-1665_1636.wav,2700,2485,215
2377,b-4_2000-5164_4858.wav,VTTS_b-4_2000-5164_4858.wav,9419,9079,340
2378,b-1_4466-4498_4470.wav,VTTS_b-1_4466-4498_4470.wav,1480,1382,98
2379,b-4_2000-5164_3109.wav,VTTS_b-4_2000-5164_3109.wav,2298,3042,-744
2380,b-1_3733-3833_3735.wav,VTTS_b-1_3733-3833_3735.wav,3080,4957,-1877
2381,b-4_2000-5164_4507.wav,VTTS_b-4_2000-5164_4507.wav,2060,1939,121
2382,b-4_501-1014_579.wav,VTTS_b-4_501-1014_579.wav,7270,6618,652
2383,b-4_151-300_280.wav,VTTS_b-4_151-300_280.wav,4400,4830,-430
2384,b-3_4104-4206_4114.wav,VTTS_b-3_4104-4206_4114.wav,7540,9776,-2236
2385,b-4_2000-5164_2679.wav,VTTS_b-4_2000-5164_2679.wav,6540,6769,-229
2386,b-4_2000-5164_4129.wav,VTTS_b-4_2000-5164_4129.wav,5438,4818,620
2387,b-1_2523-2623_2599.wav,VTTS_b-1_2523-2623_2599.wav,4170,4423,-253
2388,b-2_407-508_483.wav,VTTS_b-2_407-508_483.wav,3700,3622,78
2389,b-2_407-508_493.wav,VTTS_b-2_407-508_493.wav,2140,1579,561
2390,b-3_5009-5427_5427.wav,VTTS_b-3_5009-5427_5427.wav,3380,3309,71
2391,b-3_3025-3111_3092.wav,VTTS_b-3_3025-3111_3092.wav,5960,5666,294
2392,b-2_1597-1698_1670.wav,VTTS_b-2_1597-1698_1670.wav,2090,1440,650
2393,b-3_3889-4000_3914.wav,VTTS_b-3_3889-4000_3914.wav,8420,8336,84
2394,b-1_4286-4321_4290.wav,VTTS_b-1_4286-4321_4290.wav,4730,5561,-831
2395,b-1_2220-2320_2307.wav,VTTS_b-1_2220-2320_2307.wav,1620,1672,-52
2396,b-1_3834-3934_3913.wav,VTTS_b-1_3834-3934_3913.wav,1960,1892,68
2397,b-3_2524-2854_2775.wav,VTTS_b-3_2524-2854_2775.wav,5820,5271,549
2398,b-4_1301-1400_1303.wav,VTTS_b-4_1301-1400_1303.wav,7190,6827,363
2399,b-2_815-916_908.wav,VTTS_b-2_815-916_908.wav,1700,1649,51
2400,b-2_917-1018_935.wav,VTTS_b-2_917-1018_935.wav,1850,1892,-42
2401,b-1_3228-3328_3304.wav,VTTS_b-1_3228-3328_3304.wav,1870,2218,-348
2402,b-1_4106-4141_4126.wav,VTTS_b-1_4106-4141_4126.wav,2220,2194,26
2403,b-3_6701-6800_6759.wav,VTTS_b-3_6701-6800_6759.wav,4320,4226,94
2404,b-2_407-508_488.wav,VTTS_b-2_407-508_488.wav,3010,2566,444
2405,b-3_3889-4000_3948.wav,VTTS_b-3_3889-4000_3948.wav,7820,7407,413
2406,b-4_1401-1505_1502.wav,VTTS_b-4_1401-1505_1502.wav,4440,4052,388
2407,b-2_1019-1120_1105.wav,VTTS_b-2_1019-1120_1105.wav,2070,2287,-217
2408,b-3_501-930_839.wav,VTTS_b-3_501-930_839.wav,5460,4865,595
2409,b-1_3935-4033_4006.wav,VTTS_b-1_3935-4033_4006.wav,1460,1416,44
2410,b-4_2000-5164_4414.wav,VTTS_b-4_2000-5164_4414.wav,7226,6978,248
2411,b-2_1325-1426_1382.wav,VTTS_b-2_1325-1426_1382.wav,1600,1869,-269
2412,b-1_4034-4069_4056.wav,VTTS_b-1_4034-4069_4056.wav,1950,2543,-593
2413,b-4_2000-5164_3141.wav,VTTS_b-4_2000-5164_3141.wav,4296,4423,-127
2414,b-2_2209-2310_2303.wav,VTTS_b-2_2209-2310_2303.wav,1700,1660,40
2415,b-3_4607-5008_4978.wav,VTTS_b-3_4607-5008_4978.wav,4730,4667,63
2416,b-3_3803-3888_3815.wav,VTTS_b-3_3803-3888_3815.wav,13080,11610,1470
2417,b-1_1616-1716_1686.wav,VTTS_b-1_1616-1716_1686.wav,3640,5956,-2316
2418,b-1_3329-3429_3387.wav,VTTS_b-1_3329-3429_3387.wav,4490,5759,-1269
2419,b-1_2826-2926_2911.wav,VTTS_b-1_2826-2926_2911.wav,2390,3959,-1569
2420,b-4_1506-1600_1519.wav,VTTS_b-4_1506-1600_1519.wav,7550,9718,-2168
2421,b-2_1427-1562_1490.wav,VTTS_b-2_1427-1562_1490.wav,1500,1834,-334
2422,b-3_1-97_3.wav,VTTS_b-3_1-97_3.wav,9260,9067,193
2423,b-4_501-1014_896.wav,VTTS_b-4_501-1014_896.wav,2430,1869,561
2424,b-3_2524-2854_2840.wav,VTTS_b-3_2524-2854_2840.wav,7550,7407,143
2425,b-2_509-610_595.wav,VTTS_b-2_509-610_595.wav,3950,4238,-288
2426,b-3_1568-1665_1648.wav,VTTS_b-3_1568-1665_1648.wav,4370,4040,330
2427,b-1_3127-3227_3144.wav,VTTS_b-1_3127-3227_3144.wav,4410,5468,-1058
2428,b-4_2000-5164_2521.wav,VTTS_b-4_2000-5164_2521.wav,5580,6490,-910
2429,b-4_2000-5164_2882.wav,VTTS_b-4_2000-5164_2882.wav,3175,2972,203
2430,b-3_5009-5427_5286.wav,VTTS_b-3_5009-5427_5286.wav,1670,1440,230
2431,b-4_2000-5164_4172.wav,VTTS_b-4_2000-5164_4172.wav,5150,6095,-945
2432,b-1_2220-2320_2298.wav,VTTS_b-1_2220-2320_2298.wav,3130,3924,-794
2433,b-2_1699-1800_1756.wav,VTTS_b-2_1699-1800_1756.wav,2120,1974,146
2434,b-1_2523-2623_2573.wav,VTTS_b-1_2523-2623_2573.wav,2590,3936,-1346
2435,b-3_6900-7016_6993.wav,VTTS_b-3_6900-7016_6993.wav,11760,11297,463
2436,b-3_2089-2176_2117.wav,VTTS_b-3_2089-2176_2117.wav,3450,3495,-45
2437,b-4_1814-1900_1819.wav,VTTS_b-4_1814-1900_1819.wav,8250,11610,-3360
2438,b-4_2000-5164_2918.wav,VTTS_b-4_2000-5164_2918.wav,4566,4540,26
2439,b-1_3228-3328_3310.wav,VTTS_b-1_3228-3328_3310.wav,1590,1591,-1
2440,b-3_2177-2266_2265.wav,VTTS_b-3_2177-2266_2265.wav,3810,2659,1151
2441,b-4_2000-5164_3262.wav,VTTS_b-4_2000-5164_3262.wav,6360,9485,-3125
2442,b-3_1862-1959_1896.wav,VTTS_b-3_1862-1959_1896.wav,6760,6177,583
2443,b-4_501-1014_724.wav,VTTS_b-4_501-1014_724.wav,3850,3796,54
2444,b-3_501-930_612.wav,VTTS_b-3_501-930_612.wav,3110,2786,324
2445,b-4_2000-5164_4913.wav,VTTS_b-4_2000-5164_4913.wav,3142,2752,390
2446,b-1_1717-1817_1736.wav,VTTS_b-1_1717-1817_1736.wav,1560,1544,16
2447,b-3_6601-6700_6643.wav,VTTS_b-3_6601-6700_6643.wav,10180,9311,869
2448,b-3_501-930_802.wav,VTTS_b-3_501-930_802.wav,9670,7697,1973
2449,b-4_2000-5164_2361.wav,VTTS_b-4_2000-5164_2361.wav,8020,8185,-165
2450,b-4_301-400_390.wav,VTTS_b-4_301-400_390.wav,5750,6095,-345
2451,b-3_5009-5427_5171.wav,VTTS_b-3_5009-5427_5171.wav,7060,7941,-881
2452,b-3_1666-1763_1741.wav,VTTS_b-3_1666-1763_1741.wav,6240,5944,296
2453,b-3_5009-5427_5322.wav,VTTS_b-3_5009-5427_5322.wav,5350,5933,-583
2454,b-4_501-1014_598.wav,VTTS_b-4_501-1014_598.wav,1890,1950,-60
2455,b-1_3026-3126_3046.wav,VTTS_b-1_3026-3126_3046.wav,1090,998,92
2456,b-3_1321-1568_1409.wav,VTTS_b-3_1321-1568_1409.wav,3790,4505,-715
2457,b-4_1901-2000_1953.wav,VTTS_b-4_1901-2000_1953.wav,4010,4261,-251
2458,b-3_1764-1861_1816.wav,VTTS_b-3_1764-1861_1816.wav,4320,4435,-115
2459,b-3_4607-5008_4843.wav,VTTS_b-3_4607-5008_4843.wav,5640,4888,752
2460,b-3_931-979_937.wav,VTTS_b-3_931-979_937.wav,7940,9416,-1476
2461,b-3_5957-6015_6004.wav,VTTS_b-3_5957-6015_6004.wav,2220,2241,-21
2462,b-1_794-1009_1006.wav,VTTS_b-1_794-1009_1006.wav,2270,2067,203
2463,b-4_2000-5164_2962.wav,VTTS_b-4_2000-5164_2962.wav,5138,4702,436
2464,b-1_1010-1110_1087.wav,VTTS_b-1_1010-1110_1087.wav,5030,4807,223
2465,b-3_2089-2176_2109.wav,VTTS_b-3_2089-2176_2109.wav,9790,10739,-949
2466,b-3_980-1077_988.wav,VTTS_b-3_980-1077_988.wav,6600,6281,319
2467,b-2_1903-2038_2032.wav,VTTS_b-2_1903-2038_2032.wav,3330,3611,-281
2468,b-2_203-304_270.wav,VTTS_b-2_203-304_270.wav,1280,1231,49
2469,b-1_1-73_44.wav,VTTS_b-1_1-73_44.wav,4610,5027,-417
2470,b-4_2000-5164_4859.wav,VTTS_b-4_2000-5164_4859.wav,3678,4609,-931
2471,b-3_3454-3537_3529.wav,VTTS_b-3_3454-3537_3529.wav,8090,7581,509
2472,b-1_4358-4393_4377.wav,VTTS_b-1_4358-4393_4377.wav,2430,2589,-159
2473,b-3_4498-4605_4518.wav,VTTS_b-3_4498-4605_4518.wav,1400,2020,-620
2474,b-3_4607-5008_4650.wav,VTTS_b-3_4607-5008_4650.wav,5050,4899,151
2475,b-4_2000-5164_3500.wav,VTTS_b-4_2000-5164_3500.wav,1935,1869,66
2476,b-1_1414-1514_1493.wav,VTTS_b-1_1414-1514_1493.wav,4790,4690,100
2477,b-3_2350-2433_2419.wav,VTTS_b-3_2350-2433_2419.wav,9280,8359,921
2478,b-4_501-1014_714.wav,VTTS_b-4_501-1014_714.wav,3500,3622,-122
2479,b-3_980-1077_1069.wav,VTTS_b-3_980-1077_1069.wav,11050,10368,682
2480,b-3_6116-6215_6184.wav,VTTS_b-3_6116-6215_6184.wav,5440,5805,-365
2481,b-1_1111-1211_1210.wav,VTTS_b-1_1111-1211_1210.wav,2040,2206,-166
2482,b-3_2524-2854_2737.wav,VTTS_b-3_2524-2854_2737.wav,9790,9857,-67
2483,b-4_2000-5164_3523.wav,VTTS_b-4_2000-5164_3523.wav,2675,2334,341
2484,b-4_151-300_196.wav,VTTS_b-4_151-300_196.wav,2680,2485,195
2485,b-1_3329-3429_3395.wav,VTTS_b-1_3329-3429_3395.wav,3780,4029,-249
2486,b-4_2000-5164_2924.wav,VTTS_b-4_2000-5164_2924.wav,2660,2485,175
2487,b-3_3364-3453_3447.wav,VTTS_b-3_3364-3453_3447.wav,2640,2844,-204
2488,b-3_6900-7016_6969.wav,VTTS_b-3_6900-7016_6969.wav,4550,4284,266
2489,b-4_2000-5164_2185.wav,VTTS_b-4_2000-5164_2185.wav,7490,6920,570
2490,b-2_1699-1800_1739.wav,VTTS_b-2_1699-1800_1739.wav,1370,1242,128
2491,b-4_301-400_334.wav,VTTS_b-4_301-400_334.wav,2170,2043,127
2492,b-1_1111-1211_1187.wav,VTTS_b-1_1111-1211_1187.wav,3920,4191,-271
2493,b-3_5428-5533_5507.wav,VTTS_b-3_5428-5533_5507.wav,5980,5306,674
2494,b-3_6016-6115_6072.wav,VTTS_b-3_6016-6115_6072.wav,2600,3065,-465
2495,b-2_407-508_477.wav,VTTS_b-2_407-508_477.wav,4520,4400,120
2496,b-4_2000-5164_4415.wav,VTTS_b-4_2000-5164_4415.wav,5245,6223,-978
2497,b-1_1818-1918_1830.wav,VTTS_b-1_1818-1918_1830.wav,3250,3030,220
2498,b-3_2434-2523_2472.wav,VTTS_b-3_2434-2523_2472.wav,5190,4772,418
2499,b-3_6601-6700_6634.wav,VTTS_b-3_6601-6700_6634.wav,2030,1509,521
2500,b-1_794-1009_851.wav,VTTS_b-1_794-1009_851.wav,2150,2043,107
2501,b-3_6900-7016_6992.wav,VTTS_b-3_6900-7016_6992.wav,4330,3773,557
2502,b-4_1-52_24.wav,VTTS_b-4_1-52_24.wav,8510,8197,313
2503,b-3_392-500_495.wav,VTTS_b-3_392-500_495.wav,3500,3599,-99
2504,b-4_501-1014_841.wav,VTTS_b-4_501-1014_841.wav,7040,8824,-1784
2505,b-1_2422-2522_2428.wav,VTTS_b-1_2422-2522_2428.wav,3150,4748,-1598
2506,b-3_6116-6215_6180.wav,VTTS_b-3_6116-6215_6180.wav,6980,7384,-404
2507,b-3_1079-1320_1307.wav,VTTS_b-3_1079-1320_1307.wav,4080,4110,-30
2508,b-4_2000-5164_5077.wav,VTTS_b-4_2000-5164_5077.wav,1226,1289,-63
2509,b-4_501-1014_539.wav,VTTS_b-4_501-1014_539.wav,6330,6049,281
2510,b-4_501-1014_671.wav,VTTS_b-4_501-1014_671.wav,3720,3646,74
2511,b-3_6701-6800_6760.wav,VTTS_b-3_6701-6800_6760.wav,5480,7500,-2020
2512,b-1_3632-3732_3639.wav,VTTS_b-1_3632-3732_3639.wav,4110,4168,-58
2513,b-2_1597-1698_1662.wav,VTTS_b-2_1597-1698_1662.wav,2560,2020,540
2514,b-1_2523-2623_2554.wav,VTTS_b-1_2523-2623_2554.wav,3920,3878,42
2515,b-1_2321-2421_2343.wav,VTTS_b-1_2321-2421_2343.wav,2280,2055,225
2516,b-3_6501-6600_6528.wav,VTTS_b-3_6501-6600_6528.wav,3530,3796,-266
2517,b-2_1427-1562_1469.wav,VTTS_b-2_1427-1562_1469.wav,4100,5422,-1322
2518,b-3_4315-4424_4336.wav,VTTS_b-3_4315-4424_4336.wav,9030,8231,799
2519,b-4_2000-5164_2540.wav,VTTS_b-4_2000-5164_2540.wav,8420,8499,-79
2520,b-4_2000-5164_3906.wav,VTTS_b-4_2000-5164_3906.wav,5531,5341,190
2521,b-4_2000-5164_3203.wav,VTTS_b-4_2000-5164_3203.wav,9519,8812,707
2522,b-4_1901-2000_1952.wav,VTTS_b-4_1901-2000_1952.wav,4650,4087,563
2523,b-1_1414-1514_1497.wav,VTTS_b-1_1414-1514_1497.wav,6180,6792,-612
2524,b-3_5428-5533_5428.wav,VTTS_b-3_5428-5533_5428.wav,8030,7883,147
2525,b-4_1814-1900_1880.wav,VTTS_b-4_1814-1900_1880.wav,7390,6989,401
2526,b-1_2321-2421_2378.wav,VTTS_b-1_2321-2421_2378.wav,3850,5027,-1177
2527,b-4_2000-5164_3891.wav,VTTS_b-4_2000-5164_3891.wav,2805,2694,111
2528,b-4_2000-5164_3147.wav,VTTS_b-4_2000-5164_3147.wav,3439,3413,26
2529,b-4_2000-5164_3714.wav,VTTS_b-4_2000-5164_3714.wav,3495,3437,58
2530,b-1_1818-1918_1853.wav,VTTS_b-1_1818-1918_1853.wav,2150,2461,-311
2531,b-4_2000-5164_2200.wav,VTTS_b-4_2000-5164_2200.wav,4885,4969,-84
2532,b-3_6401-6500_6465.wav,VTTS_b-3_6401-6500_6465.wav,9550,9694,-144
2533,b-3_4207-4314_4207.wav,VTTS_b-3_4207-4314_4207.wav,4980,5004,-24
2534,b-1_2624-2724_2630.wav,VTTS_b-1_2624-2724_2630.wav,1270,1277,-7
2535,b-3_1764-1861_1819.wav,VTTS_b-3_1764-1861_1819.wav,7390,7941,-551
2536,b-1_4214-4285_4244.wav,VTTS_b-1_4214-4285_4244.wav,1490,1509,-19
2537,b-3_5639-5744_5700.wav,VTTS_b-3_5639-5744_5700.wav,2570,2043,527
2538,b-3_3279-3363_3341.wav,VTTS_b-3_3279-3363_3341.wav,3800,4156,-356
2539,b-3_4607-5008_4656.wav,VTTS_b-3_4607-5008_4656.wav,6490,6084,406
2540,b-3_294-391_306.wav,VTTS_b-3_294-391_306.wav,3390,3402,-12
2541,b-3_501-930_526.wav,VTTS_b-3_501-930_526.wav,5680,5793,-113
2542,b-2_1903-2038_1931.wav,VTTS_b-2_1903-2038_1931.wav,1530,1509,21
2543,b-4_2000-5164_2394.wav,VTTS_b-4_2000-5164_2394.wav,2330,2276,54
2544,b-3_2177-2266_2227.wav,VTTS_b-3_2177-2266_2227.wav,6280,3437,2843
2545,b-3_501-930_684.wav,VTTS_b-3_501-930_684.wav,6740,6420,320
2546,b-3_2434-2523_2499.wav,VTTS_b-3_2434-2523_2499.wav,5220,4992,228
2547,b-3_3454-3537_3498.wav,VTTS_b-3_3454-3537_3498.wav,6650,6920,-270
2548,b-2_2413-2500_2487.wav,VTTS_b-2_2413-2500_2487.wav,3030,2740,290
2549,b-3_6701-6800_6764.wav,VTTS_b-3_6701-6800_6764.wav,9620,9242,378
2550,b-3_98-195_136.wav,VTTS_b-3_98-195_136.wav,5680,4865,815
2551,b-3_392-500_475.wav,VTTS_b-3_392-500_475.wav,6160,6502,-342
2552,b-1_2220-2320_2284.wav,VTTS_b-1_2220-2320_2284.wav,1240,1091,149
2553,b-1_2119-2219_2177.wav,VTTS_b-1_2119-2219_2177.wav,1430,1405,25
2554,b-2_407-508_442.wav,VTTS_b-2_407-508_442.wav,4910,5538,-628
2555,b-2_2413-2500_2417.wav,VTTS_b-2_2413-2500_2417.wav,2320,2554,-234
2556,b-4_2000-5164_3504.wav,VTTS_b-4_2000-5164_3504.wav,1105,998,107
2557,b-3_3715-3802_3778.wav,VTTS_b-3_3715-3802_3778.wav,4880,4075,805
2558,b-4_2000-5164_4296.wav,VTTS_b-4_2000-5164_4296.wav,1642,1939,-297
2559,b-4_2000-5164_4450.wav,VTTS_b-4_2000-5164_4450.wav,8171,8684,-513
2560,b-3_3889-4000_3959.wav,VTTS_b-3_3889-4000_3959.wav,7730,7210,520
2561,b-1_1111-1211_1138.wav,VTTS_b-1_1111-1211_1138.wav,2120,2067,53
2562,b-1_1212-1312_1219.wav,VTTS_b-1_1212-1312_1219.wav,2520,2218,302
2563,b-2_917-1018_995.wav,VTTS_b-2_917-1018_995.wav,5970,6734,-764
2564,b-3_3025-3111_3034.wav,VTTS_b-3_3025-3111_3034.wav,4870,4830,40
2565,b-1_3733-3833_3736.wav,VTTS_b-1_3733-3833_3736.wav,5370,6351,-981
2566,b-3_294-391_375.wav,VTTS_b-3_294-391_375.wav,3500,3622,-122
2567,b-3_2267-2349_2313.wav,VTTS_b-3_2267-2349_2313.wav,4880,5317,-437
2568,b-3_5009-5427_5053.wav,VTTS_b-3_5009-5427_5053.wav,6230,6304,-74
2569,b-4_2000-5164_4274.wav,VTTS_b-4_2000-5164_4274.wav,6017,6084,-67
2570,b-1_377-477_452.wav,VTTS_b-1_377-477_452.wav,5100,4563,537
2571,b-4_2000-5164_3002.wav,VTTS_b-4_2000-5164_3002.wav,6314,6513,-199
2572,b-4_2000-5164_4800.wav,VTTS_b-4_2000-5164_4800.wav,13247,11610,1637
2573,b-3_5853-5956_5950.wav,VTTS_b-3_5853-5956_5950.wav,5620,5341,279
2574,b-3_4607-5008_4816.wav,VTTS_b-3_4607-5008_4816.wav,3810,3773,37
2575,b-2_1325-1426_1366.wav,VTTS_b-2_1325-1426_1366.wav,8170,7802,368
2576,b-3_3198-3278_3277.wav,VTTS_b-3_3198-3278_3277.wav,4790,3947,843
2577,b-1_3733-3833_3741.wav,VTTS_b-1_3733-3833_3741.wav,2890,2543,347
2578,b-1_2826-2926_2849.wav,VTTS_b-1_2826-2926_2849.wav,2040,2183,-143
2579,b-1_3632-3732_3702.wav,VTTS_b-1_3632-3732_3702.wav,1590,1440,150
2580,b-3_4607-5008_4870.wav,VTTS_b-3_4607-5008_4870.wav,9160,9985,-825
2581,b-4_2000-5164_4603.wav,VTTS_b-4_2000-5164_4603.wav,5242,5016,226
2582,b-4_501-1014_905.wav,VTTS_b-4_501-1014_905.wav,3070,2682,388
2583,b-1_478-578_511.wav,VTTS_b-1_478-578_511.wav,1150,1138,12
2584,b-3_2943-3024_2962.wav,VTTS_b-3_2943-3024_2962.wav,6530,6931,-401
2585,b-3_6601-6700_6686.wav,VTTS_b-3_6601-6700_6686.wav,4360,4098,262
2586,b-4_1221-1300_1292.wav,VTTS_b-4_1221-1300_1292.wav,6030,5817,213
2587,b-3_4207-4314_4235.wav,VTTS_b-3_4207-4314_4235.wav,3850,3936,-86
2588,b-3_1079-1320_1310.wav,VTTS_b-3_1079-1320_1310.wav,6190,5851,339
2589,b-2_1223-1324_1254.wav,VTTS_b-2_1223-1324_1254.wav,2260,1858,402
2590,b-4_2000-5164_4055.wav,VTTS_b-4_2000-5164_4055.wav,3954,3936,18
2591,b-3_5009-5427_5100.wav,VTTS_b-3_5009-5427_5100.wav,9370,9880,-510
2592,b-2_1427-1562_1457.wav,VTTS_b-2_1427-1562_1457.wav,8290,5875,2415
2593,b-1_2422-2522_2470.wav,VTTS_b-1_2422-2522_2470.wav,2760,2763,-3
2594,b-3_3538-3627_3583.wav,VTTS_b-3_3538-3627_3583.wav,4770,5097,-327
2595,b-2_2073-2106_2091.wav,VTTS_b-2_2073-2106_2091.wav,2480,2113,367
2596,b-4_2000-5164_4593.wav,VTTS_b-4_2000-5164_4593.wav,3653,3286,367
2597,b-4_2000-5164_2662.wav,VTTS_b-4_2000-5164_2662.wav,3380,3251,129
2598,b-1_4142-4177_4171.wav,VTTS_b-1_4142-4177_4171.wav,3460,3518,-58
2599,b-1_4214-4285_4224.wav,VTTS_b-1_4214-4285_4224.wav,2340,2461,-121
2600,b-2_2413-2500_2468.wav,VTTS_b-2_2413-2500_2468.wav,2760,2612,148
2601,b-4_501-1014_689.wav,VTTS_b-4_501-1014_689.wav,2090,2241,-151
2602,b-4_151-300_256.wav,VTTS_b-4_151-300_256.wav,5600,5445,155
2603,b-2_1801-1902_1852.wav,VTTS_b-2_1801-1902_1852.wav,1110,1033,77
2604,b-4_1301-1400_1319.wav,VTTS_b-4_1301-1400_1319.wav,5650,5364,286
2605,b-3_6401-6500_6494.wav,VTTS_b-3_6401-6500_6494.wav,4060,4493,-433
2606,b-2_203-304_227.wav,VTTS_b-2_203-304_227.wav,1250,1091,159
2607,b-3_6601-6700_6629.wav,VTTS_b-3_6601-6700_6629.wav,3380,3100,280
2608,b-3_1666-1763_1713.wav,VTTS_b-3_1666-1763_1713.wav,2630,3146,-516
2609,b-3_5745-5852_5757.wav,VTTS_b-3_5745-5852_5757.wav,3240,3367,-127
2610,b-3_6217-6274_6272.wav,VTTS_b-3_6217-6274_6272.wav,5060,4818,242
2611,b-3_6701-6800_6772.wav,VTTS_b-3_6701-6800_6772.wav,5430,6885,-1455
2612,b-2_1903-2038_1948.wav,VTTS_b-2_1903-2038_1948.wav,3570,2775,795
2613,b-3_98-195_146.wav,VTTS_b-3_98-195_146.wav,3420,3297,123
2614,b-1_478-578_544.wav,VTTS_b-1_478-578_544.wav,2460,2554,-94
2615,b-4_2000-5164_4083.wav,VTTS_b-4_2000-5164_4083.wav,5379,5306,73
2616,b-2_1121-1222_1151.wav,VTTS_b-2_1121-1222_1151.wav,1280,1834,-554
2617,b-1_2119-2219_2171.wav,VTTS_b-1_2119-2219_2171.wav,1730,1672,58
2618,b-3_4607-5008_4814.wav,VTTS_b-3_4607-5008_4814.wav,6540,5863,677
2619,b-4_2000-5164_2032.wav,VTTS_b-4_2000-5164_2032.wav,4485,4133,352
2620,b-3_2000-2088_2086.wav,VTTS_b-3_2000-2088_2086.wav,6950,7593,-643
2621,b-3_931-979_935.wav,VTTS_b-3_931-979_935.wav,7140,7198,-58
2622,b-3_2089-2176_2158.wav,VTTS_b-3_2089-2176_2158.wav,4480,4098,382
2623,b-3_2089-2176_2176.wav,VTTS_b-3_2089-2176_2176.wav,8210,6827,1383
2624,b-3_6301-6400_6331.wav,VTTS_b-3_6301-6400_6331.wav,1840,1544,296
2625,b-4_1014-1100_1023.wav,VTTS_b-4_1014-1100_1023.wav,9490,9660,-170
2626,b-4_2000-5164_3243.wav,VTTS_b-4_2000-5164_3243.wav,3270,3320,-50
2627,b-4_2000-5164_3897.wav,VTTS_b-4_2000-5164_3897.wav,3978,3866,112
2628,b-3_980-1077_1015.wav,VTTS_b-3_980-1077_1015.wav,970,1103,-133
2629,b-2_1223-1324_1303.wav,VTTS_b-2_1223-1324_1303.wav,2070,1858,212
2630,b-4_501-1014_576.wav,VTTS_b-4_501-1014_576.wav,2160,1834,326
2631,b-3_4207-4314_4284.wav,VTTS_b-3_4207-4314_4284.wav,6680,6060,620
2632,b-3_3715-3802_3721.wav,VTTS_b-3_3715-3802_3721.wav,4180,4365,-185
2633,b-2_407-508_450.wav,VTTS_b-2_407-508_450.wav,1500,1393,107
2634,b-2_2209-2310_2304.wav,VTTS_b-2_2209-2310_2304.wav,1820,1788,32
2635,b-4_2000-5164_4267.wav,VTTS_b-4_2000-5164_4267.wav,4559,5306,-747
2636,b-4_2000-5164_3236.wav,VTTS_b-4_2000-5164_3236.wav,2866,3471,-605
2637,b-3_2267-2349_2316.wav,VTTS_b-3_2267-2349_2316.wav,5370,5817,-447
2638,b-3_2524-2854_2597.wav,VTTS_b-3_2524-2854_2597.wav,4310,4540,-230
2639,b-1_276-376_335.wav,VTTS_b-1_276-376_335.wav,1630,2299,-669
2640,b-3_5009-5427_5397.wav,VTTS_b-3_5009-5427_5397.wav,9970,9091,879
2641,b-4_2000-5164_3231.wav,VTTS_b-4_2000-5164_3231.wav,3197,3100,97
2642,b-4_2000-5164_4158.wav,VTTS_b-4_2000-5164_4158.wav,3782,3855,-73
2643,b-3_6801-6900_6874.wav,VTTS_b-3_6801-6900_6874.wav,6380,5271,1109
2644,b-1_794-1009_916.wav,VTTS_b-1_794-1009_916.wav,1530,6316,-4786
2645,b-4_2000-5164_4908.wav,VTTS_b-4_2000-5164_4908.wav,4977,4551,426
2646,b-3_1079-1320_1215.wav,VTTS_b-3_1079-1320_1215.wav,5760,5317,443
2647,b-1_1717-1817_1806.wav,VTTS_b-1_1717-1817_1806.wav,3900,2937,963
2648,b-2_1427-1562_1565.wav,VTTS_b-2_1427-1562_1565.wav,6030,5074,956
2649,b-2_2073-2106_2101.wav,VTTS_b-2_2073-2106_2101.wav,1600,1567,33
2650,b-2_2040-2072_2055.wav,VTTS_b-2_2040-2072_2055.wav,2970,2589,381
2651,b-1_1212-1312_1233.wav,VTTS_b-1_1212-1312_1233.wav,1590,1440,150
2652,b-3_3628-3714_3670.wav,VTTS_b-3_3628-3714_3670.wav,6950,7558,-608
2653,b-3_4607-5008_4753.wav,VTTS_b-3_4607-5008_4753.wav,5320,5712,-392
2654,b-4_1101-1220_1110.wav,VTTS_b-4_1101-1220_1110.wav,3060,2844,216
2655,b-3_4607-5008_4609.wav,VTTS_b-3_4607-5008_4609.wav,4040,3077,963
2656,b-1_3632-3732_3701.wav,VTTS_b-1_3632-3732_3701.wav,1630,1660,-30
2657,b-1_1515-1615_1556.wav,VTTS_b-1_1515-1615_1556.wav,3540,3495,45
2658,b-3_2524-2854_2651.wav,VTTS_b-3_2524-2854_2651.wav,2700,2601,99
2659,b-3_6301-6400_6346.wav,VTTS_b-3_6301-6400_6346.wav,8540,8382,158
2660,b-3_5009-5427_5291.wav,VTTS_b-3_5009-5427_5291.wav,5840,5700,140
2661,b-3_4104-4206_4143.wav,VTTS_b-3_4104-4206_4143.wav,6930,7036,-106
2662,b-4_1301-1400_1317.wav,VTTS_b-4_1301-1400_1317.wav,4860,4493,367
2663,b-3_1321-1568_1349.wav,VTTS_b-3_1321-1568_1349.wav,5910,5294,616
2664,b-3_4607-5008_4849.wav,VTTS_b-3_4607-5008_4849.wav,4910,4540,370
2665,b-3_1321-1568_1433.wav,VTTS_b-3_1321-1568_1433.wav,2800,3251,-451
2666,b-2_1427-1562_1563.wav,VTTS_b-2_1427-1562_1563.wav,3000,3239,-239
2667,b-3_2000-2088_2084.wav,VTTS_b-3_2000-2088_2084.wav,7170,7303,-133
2668,b-4_1221-1300_1281.wav,VTTS_b-4_1221-1300_1281.wav,2940,2856,84
2669,b-1_377-477_467.wav,VTTS_b-1_377-477_467.wav,1420,1358,62
2670,b-1_2119-2219_2185.wav,VTTS_b-1_2119-2219_2185.wav,930,1057,-127
2671,b-3_3628-3714_3660.wav,VTTS_b-3_3628-3714_3660.wav,8960,8371,589
2672,b-3_2434-2523_2500.wav,VTTS_b-3_2434-2523_2500.wav,6100,7767,-1667
2673,b-4_2000-5164_4739.wav,VTTS_b-4_2000-5164_4739.wav,4578,4830,-252
2674,b-1_794-1009_883.wav,VTTS_b-1_794-1009_883.wav,3590,4458,-868
2675,b-3_6116-6215_6207.wav,VTTS_b-3_6116-6215_6207.wav,5240,6455,-1215
2676,b-4_2000-5164_3053.wav,VTTS_b-4_2000-5164_3053.wav,8383,8220,163
2677,b-3_4104-4206_4159.wav,VTTS_b-3_4104-4206_4159.wav,5090,5306,-216
2678,b-4_2000-5164_4513.wav,VTTS_b-4_2000-5164_4513.wav,7555,8882,-1327
2679,b-1_4358-4393_4383.wav,VTTS_b-1_4358-4393_4383.wav,4980,3193,1787
2680,b-1_2422-2522_2472.wav,VTTS_b-1_2422-2522_2472.wav,3320,4005,-685
2681,b-3_3628-3714_3683.wav,VTTS_b-3_3628-3714_3683.wav,5440,4714,726
2682,b-3_1764-1861_1846.wav,VTTS_b-3_1764-1861_1846.wav,6490,5724,766
2683,b-3_4607-5008_4812.wav,VTTS_b-3_4607-5008_4812.wav,4330,3901,429
2684,b-3_2089-2176_2093.wav,VTTS_b-3_2089-2176_2093.wav,3540,3843,-303
2685,b-3_4001-4103_4019.wav,VTTS_b-3_4001-4103_4019.wav,7870,7605,265
2686,b-1_2927-3025_2962.wav,VTTS_b-1_2927-3025_2962.wav,2420,2682,-262
2687,b-4_1014-1100_1084.wav,VTTS_b-4_1014-1100_1084.wav,5340,4992,348
2688,b-1_686-793_794.wav,VTTS_b-1_686-793_794.wav,2440,2241,199
2689,b-3_5009-5427_5098.wav,VTTS_b-3_5009-5427_5098.wav,9150,9590,-440
2690,b-2_713-814_745.wav,VTTS_b-2_713-814_745.wav,1830,1985,-155
2691,b-3_6301-6400_6396.wav,VTTS_b-3_6301-6400_6396.wav,3190,2914,276
2692,b-4_301-400_377.wav,VTTS_b-4_301-400_377.wav,1470,1440,30
2693,b-1_1515-1615_1611.wav,VTTS_b-1_1515-1615_1611.wav,2510,2485,25
2694,b-2_1563-1596_1580.wav,VTTS_b-2_1563-1596_1580.wav,3040,2659,381
2695,b-4_2000-5164_3132.wav,VTTS_b-4_2000-5164_3132.wav,2481,2136,345
2696,b-3_5957-6015_6014.wav,VTTS_b-3_5957-6015_6014.wav,6090,7755,-1665
2697,b-4_2000-5164_4280.wav,VTTS_b-4_2000-5164_4280.wav,3738,3820,-82
2698,b-1_2927-3025_3009.wav,VTTS_b-1_2927-3025_3009.wav,840,975,-135
2699,b-4_1221-1300_1253.wav,VTTS_b-4_1221-1300_1253.wav,10090,11610,-1520
2700,b-4_2000-5164_3792.wav,VTTS_b-4_2000-5164_3792.wav,2840,2949,-109
2701,b-3_1321-1568_1451.wav,VTTS_b-3_1321-1568_1451.wav,6480,6838,-358
2702,b-4_2000-5164_3893.wav,VTTS_b-4_2000-5164_3893.wav,4074,4574,-500
2703,b-3_4607-5008_4671.wav,VTTS_b-3_4607-5008_4671.wav,2650,2728,-78
2704,b-4_2000-5164_4179.wav,VTTS_b-4_2000-5164_4179.wav,5580,5236,344
2705,b-4_2000-5164_4566.wav,VTTS_b-4_2000-5164_4566.wav,7209,6792,417
2706,b-1_3026-3126_3092.wav,VTTS_b-1_3026-3126_3092.wav,2060,2426,-366
2707,b-1_3632-3732_3705.wav,VTTS_b-1_3632-3732_3705.wav,2170,2937,-767
2708,b-4_1901-2000_1997.wav,VTTS_b-4_1901-2000_1997.wav,3170,2844,326
2709,b-4_2000-5164_4613.wav,VTTS_b-4_2000-5164_4613.wav,2566,2368,198
2710,b-4_501-1014_787.wav,VTTS_b-4_501-1014_787.wav,3490,3367,123
2711,b-3_196-293_196.wav,VTTS_b-3_196-293_196.wav,3330,3344,-14
2712,b-3_501-930_874.wav,VTTS_b-3_501-930_874.wav,5640,6618,-978
2713,b-4_2000-5164_2479.wav,VTTS_b-4_2000-5164_2479.wav,3500,3518,-18
2714,b-3_2524-2854_2551.wav,VTTS_b-3_2524-2854_2551.wav,7290,6920,370
2715,b-2_305-406_392.wav,VTTS_b-2_305-406_392.wav,1970,2090,-120
2716,b-3_5009-5427_5354.wav,VTTS_b-3_5009-5427_5354.wav,5330,4830,500
2717,b-3_392-500_399.wav,VTTS_b-3_392-500_399.wav,5540,5550,-10
2718,b-1_3026-3126_3076.wav,VTTS_b-1_3026-3126_3076.wav,1580,1393,187
2719,b-3_4607-5008_4754.wav,VTTS_b-3_4607-5008_4754.wav,3840,4365,-525
2720,b-1_4214-4285_4222.wav,VTTS_b-1_4214-4285_4222.wav,1580,1370,210
2721,b-3_501-930_550.wav,VTTS_b-3_501-930_550.wav,3280,2844,436
2722,b-3_1862-1959_1955.wav,VTTS_b-3_1862-1959_1955.wav,9900,11610,-1710
2723,b-3_501-930_870.wav,VTTS_b-3_501-930_870.wav,6360,7175,-815
2724,b-4_1901-2000_1994.wav,VTTS_b-4_1901-2000_1994.wav,5590,6571,-981
2725,b-1_3430-3530_3483.wav,VTTS_b-1_3430-3530_3483.wav,1400,1498,-98
2726,b-4_2000-5164_2689.wav,VTTS_b-4_2000-5164_2689.wav,2816,2577,239
2727,b-2_1903-2038_1932.wav,VTTS_b-2_1903-2038_1932.wav,2310,2740,-430
2728,b-1_1616-1716_1715.wav,VTTS_b-1_1616-1716_1715.wav,4730,4168,562
2729,b-3_6401-6500_6497.wav,VTTS_b-3_6401-6500_6497.wav,1860,1997,-137
2730,b-3_501-930_594.wav,VTTS_b-3_501-930_594.wav,6670,6026,644
2731,b-4_2000-5164_2709.wav,VTTS_b-4_2000-5164_2709.wav,5660,6954,-1294
2732,b-3_294-391_329.wav,VTTS_b-3_294-391_329.wav,5320,5085,235
2733,b-4_2000-5164_4393.wav,VTTS_b-4_2000-5164_4393.wav,3043,3947,-904
2734,b-4_2000-5164_3197.wav,VTTS_b-4_2000-5164_3197.wav,4568,5236,-668
2735,b-1_1515-1615_1577.wav,VTTS_b-1_1515-1615_1577.wav,1890,1892,-2
2736,b-1_4322-4357_4323.wav,VTTS_b-1_4322-4357_4323.wav,1560,1405,155
2737,b-3_392-500_463.wav,VTTS_b-3_392-500_463.wav,4060,4133,-73
2738,b-2_1427-1562_1433.wav,VTTS_b-2_1427-1562_1433.wav,7210,7581,-371
2739,b-3_5639-5744_5709.wav,VTTS_b-3_5639-5744_5709.wav,4800,4063,737
2740,b-3_6116-6215_6150.wav,VTTS_b-3_6116-6215_6150.wav,3600,4969,-1369
2741,b-3_3803-3888_3858.wav,VTTS_b-3_3803-3888_3858.wav,2440,2670,-230
2742,b-2_1-100_21.wav,VTTS_b-2_1-100_21.wav,2290,2473,-183
2743,b-1_2523-2623_2535.wav,VTTS_b-1_2523-2623_2535.wav,4480,5143,-663
2744,b-4_2000-5164_3540.wav,VTTS_b-4_2000-5164_3540.wav,2595,2415,180
2745,b-4_2000-5164_2147.wav,VTTS_b-4_2000-5164_2147.wav,7000,8266,-1266
2746,b-4_2000-5164_4804.wav,VTTS_b-4_2000-5164_4804.wav,1894,1753,141
2747,b-1_2725-2825_2730.wav,VTTS_b-1_2725-2825_2730.wav,6480,5654,826
2748,b-4_501-1014_586.wav,VTTS_b-4_501-1014_586.wav,5700,5863,-163
2749,b-4_1901-2000_1993.wav,VTTS_b-4_1901-2000_1993.wav,7130,7396,-266
2750,b-3_4607-5008_4795.wav,VTTS_b-3_4607-5008_4795.wav,6920,7152,-232
2751,b-3_392-500_434.wav,VTTS_b-3_392-500_434.wav,5000,5224,-224
2752,b-4_2000-5164_3007.wav,VTTS_b-4_2000-5164_3007.wav,3266,2972,294
2753,b-2_509-610_538.wav,VTTS_b-2_509-610_538.wav,1220,1242,-22
2754,b-3_2855-2942_2915.wav,VTTS_b-3_2855-2942_2915.wav,3540,3843,-303
2755,b-2_1427-1562_1558.wav,VTTS_b-2_1427-1562_1558.wav,2430,2543,-113
2756,b-1_1717-1817_1807.wav,VTTS_b-1_1717-1817_1807.wav,2910,6049,-3139
2757,b-1_3935-4033_4019.wav,VTTS_b-1_3935-4033_4019.wav,1320,1219,101
2758,b-2_2107-2193_2108.wav,VTTS_b-2_2107-2193_2108.wav,2290,2531,-241
2759,b-3_6016-6115_6063.wav,VTTS_b-3_6016-6115_6063.wav,3370,3251,119
2760,b-3_1321-1568_1416.wav,VTTS_b-3_1321-1568_1416.wav,3460,3402,58
2761,b-4_301-400_347.wav,VTTS_b-4_301-400_347.wav,9660,9578,82
2762,b-1_276-376_350.wav,VTTS_b-1_276-376_350.wav,4280,4505,-225
2763,b-3_1079-1320_1187.wav,VTTS_b-3_1079-1320_1187.wav,3890,3727,163
2764,b-3_2943-3024_2964.wav,VTTS_b-3_2943-3024_2964.wav,3670,4214,-544
2765,b-3_2267-2349_2309.wav,VTTS_b-3_2267-2349_2309.wav,3030,2949,81
2766,b-3_3803-3888_3849.wav,VTTS_b-3_3803-3888_3849.wav,4020,3738,282
2767,b-3_4607-5008_4889.wav,VTTS_b-3_4607-5008_4889.wav,10590,11610,-1020
2768,b-1_175-275_192.wav,VTTS_b-1_175-275_192.wav,1080,1173,-93
2769,b-3_2267-2349_2278.wav,VTTS_b-3_2267-2349_2278.wav,3700,3471,229
2770,b-4_501-1014_728.wav,VTTS_b-4_501-1014_728.wav,1700,1637,63
2771,b-1_2826-2926_2892.wav,VTTS_b-1_2826-2926_2892.wav,5670,6235,-565
2772,b-3_1321-1568_1322.wav,VTTS_b-3_1321-1568_1322.wav,2840,2589,251
2773,b-1_4394-4429_4398.wav,VTTS_b-1_4394-4429_4398.wav,1920,1916,4
2774,b-1_1-73_23.wav,VTTS_b-1_1-73_23.wav,2440,2241,199
2775,b-1_2119-2219_2143.wav,VTTS_b-1_2119-2219_2143.wav,1490,1776,-286
2776,b-2_407-508_410.wav,VTTS_b-2_407-508_410.wav,3960,3193,767
2777,b-2_815-916_913.wav,VTTS_b-2_815-916_913.wav,4090,4272,-182
2778,b-4_2000-5164_2486.wav,VTTS_b-4_2000-5164_2486.wav,3160,3204,-44
2779,b-2_407-508_460.wav,VTTS_b-2_407-508_460.wav,3640,3437,203
2780,b-4_2000-5164_3507.wav,VTTS_b-4_2000-5164_3507.wav,5926,5724,202
2781,b-3_1321-1568_1417.wav,VTTS_b-3_1321-1568_1417.wav,970,813,157
2782,b-1_276-376_296.wav,VTTS_b-1_276-376_296.wav,1940,1881,59
2783,b-3_1-97_42.wav,VTTS_b-3_1-97_42.wav,4870,4400,470
2784,b-4_2000-5164_4964.wav,VTTS_b-4_2000-5164_4964.wav,7290,7442,-152
2785,b-1_1818-1918_1858.wav,VTTS_b-1_1818-1918_1858.wav,1630,1428,202
2786,b-2_1019-1120_1058.wav,VTTS_b-2_1019-1120_1058.wav,1460,1091,369
2787,b-2_611-712_688.wav,VTTS_b-2_611-712_688.wav,7350,6304,1046
2788,b-1_2927-3025_2947.wav,VTTS_b-1_2927-3025_2947.wav,2610,2705,-95
2789,b-2_2209-2310_2305.wav,VTTS_b-2_2209-2310_2305.wav,4540,4807,-267
2790,b-4_2000-5164_4065.wav,VTTS_b-4_2000-5164_4065.wav,5890,5770,120
2791,b-1_2826-2926_2896.wav,VTTS_b-1_2826-2926_2896.wav,3240,3413,-173
2792,b-2_1223-1324_1250.wav,VTTS_b-2_1223-1324_1250.wav,5750,6037,-287
2793,b-2_2413-2500_2459.wav,VTTS_b-2_2413-2500_2459.wav,3780,3901,-121
2794,b-4_2000-5164_3257.wav,VTTS_b-4_2000-5164_3257.wav,1603,1416,187
2795,b-3_6900-7016_6997.wav,VTTS_b-3_6900-7016_6997.wav,3490,3181,309
2796,b-4_2000-5164_5096.wav,VTTS_b-4_2000-5164_5096.wav,2145,1834,311
2797,b-4_2000-5164_4805.wav,VTTS_b-4_2000-5164_4805.wav,1802,1707,95
2798,b-4_501-1014_530.wav,VTTS_b-4_501-1014_530.wav,4580,4017,563
2799,b-4_401-500_406.wav,VTTS_b-4_401-500_406.wav,3430,3181,249
2800,b-1_2018-2118_2115.wav,VTTS_b-1_2018-2118_2115.wav,1630,1950,-320
2801,b-4_2000-5164_4985.wav,VTTS_b-4_2000-5164_4985.wav,5519,5027,492
2802,b-3_2089-2176_2118.wav,VTTS_b-3_2089-2176_2118.wav,2890,2496,394
2803,b-2_509-610_567.wav,VTTS_b-2_509-610_567.wav,3080,2868,212
2804,b-3_4607-5008_4678.wav,VTTS_b-3_4607-5008_4678.wav,3930,3889,41
2805,b-3_3889-4000_3996.wav,VTTS_b-3_3889-4000_3996.wav,8060,7837,223
2806,b-3_6401-6500_6431.wav,VTTS_b-3_6401-6500_6431.wav,4100,5085,-985
2807,b-3_1862-1959_1894.wav,VTTS_b-3_1862-1959_1894.wav,1990,1962,28
2808,b-3_3889-4000_3927.wav,VTTS_b-3_3889-4000_3927.wav,2960,2856,104
2809,b-3_1321-1568_1333.wav,VTTS_b-3_1321-1568_1333.wav,10840,11459,-619
2810,b-4_2000-5164_3099.wav,VTTS_b-4_2000-5164_3099.wav,6228,5700,528
2811,b-3_501-930_532.wav,VTTS_b-3_501-930_532.wav,6860,7024,-164
2812,b-4_2000-5164_3563.wav,VTTS_b-4_2000-5164_3563.wav,3779,3878,-99
2813,b-2_611-712_644.wav,VTTS_b-2_611-712_644.wav,1100,1068,32
2814,b-1_4178-4213_4191.wav,VTTS_b-1_4178-4213_4191.wav,1910,1718,192
2815,b-4_2000-5164_2432.wav,VTTS_b-4_2000-5164_2432.wav,2580,2403,177
2816,b-3_4001-4103_4081.wav,VTTS_b-3_4001-4103_4081.wav,9560,10275,-715
2817,b-3_6301-6400_6373.wav,VTTS_b-3_6301-6400_6373.wav,3880,4017,-137
2818,b-2_713-814_735.wav,VTTS_b-2_713-814_735.wav,3380,2937,443
2819,b-3_5853-5956_5893.wav,VTTS_b-3_5853-5956_5893.wav,5070,4365,705
2820,b-3_2524-2854_2812.wav,VTTS_b-3_2524-2854_2812.wav,9170,8417,753
2821,b-4_2000-5164_2778.wav,VTTS_b-4_2000-5164_2778.wav,1220,1115,105
2822,b-4_2000-5164_3570.wav,VTTS_b-4_2000-5164_3570.wav,3981,3704,277
2823,b-1_1515-1615_1567.wav,VTTS_b-1_1515-1615_1567.wav,1510,1440,70
2824,b-3_2434-2523_2468.wav,VTTS_b-3_2434-2523_2468.wav,6540,11610,-5070
2825,b-1_1111-1211_1170.wav,VTTS_b-1_1111-1211_1170.wav,2930,2508,422
2826,b-3_3112-3197_3119.wav,VTTS_b-3_3112-3197_3119.wav,7170,6815,355
2827,b-4_151-300_206.wav,VTTS_b-4_151-300_206.wav,3380,3460,-80
2828,b-3_3279-3363_3280.wav,VTTS_b-3_3279-3363_3280.wav,11360,11610,-250
2829,b-1_2826-2926_2861.wav,VTTS_b-1_2826-2926_2861.wav,3000,2949,51
2830,b-4_1401-1505_1435.wav,VTTS_b-4_1401-1505_1435.wav,5810,5248,562
2831,b-3_5009-5427_5180.wav,VTTS_b-3_5009-5427_5180.wav,5340,5259,81
2832,b-3_5009-5427_5182.wav,VTTS_b-3_5009-5427_5182.wav,5840,5700,140
2833,b-2_1223-1324_1309.wav,VTTS_b-2_1223-1324_1309.wav,4750,5654,-904
2834,b-1_2725-2825_2742.wav,VTTS_b-1_2725-2825_2742.wav,1820,2125,-305
2835,b-3_5639-5744_5664.wav,VTTS_b-3_5639-5744_5664.wav,2770,2566,204
2836,b-3_6601-6700_6697.wav,VTTS_b-3_6601-6700_6697.wav,4030,3448,582
2837,b-2_917-1018_977.wav,VTTS_b-2_917-1018_977.wav,4290,5596,-1306
2838,b-4_2000-5164_2116.wav,VTTS_b-4_2000-5164_2116.wav,4640,5108,-468
2839,b-1_2422-2522_2427.wav,VTTS_b-1_2422-2522_2427.wav,2530,2473,57
2840,b-2_2311-2412_2407.wav,VTTS_b-2_2311-2412_2407.wav,3270,3158,112
2841,b-1_3632-3732_3690.wav,VTTS_b-1_3632-3732_3690.wav,8770,6838,1932
2842,b-4_501-1014_755.wav,VTTS_b-4_501-1014_755.wav,1580,1312,268
2843,b-4_401-500_482.wav,VTTS_b-4_401-500_482.wav,4150,3831,319
2844,b-4_2000-5164_2384.wav,VTTS_b-4_2000-5164_2384.wav,3410,3100,310
2845,b-4_2000-5164_4298.wav,VTTS_b-4_2000-5164_4298.wav,5084,4516,568
2846,b-1_2018-2118_2021.wav,VTTS_b-1_2018-2118_2021.wav,1870,1904,-34
2847,b-3_2267-2349_2341.wav,VTTS_b-3_2267-2349_2341.wav,3240,3088,152
2848,b-4_1401-1505_1431.wav,VTTS_b-4_1401-1505_1431.wav,5060,4493,567
2849,b-1_1414-1514_1436.wav,VTTS_b-1_1414-1514_1436.wav,1210,1115,95
2850,b-2_2194-2208_2202.wav,VTTS_b-2_2194-2208_2202.wav,1500,1486,14
2851,b-3_294-391_313.wav,VTTS_b-3_294-391_313.wav,6500,6049,451
2852,b-2_1427-1562_1511.wav,VTTS_b-2_1427-1562_1511.wav,5780,6745,-965
2853,b-1_1818-1918_1842.wav,VTTS_b-1_1818-1918_1842.wav,2360,2206,154
2854,b-3_392-500_440.wav,VTTS_b-3_392-500_440.wav,7340,7001,339
2855,b-4_1814-1900_1839.wav,VTTS_b-4_1814-1900_1839.wav,2610,2345,265
2856,b-2_1019-1120_1090.wav,VTTS_b-2_1019-1120_1090.wav,2090,2113,-23
2857,b-3_980-1077_995.wav,VTTS_b-3_980-1077_995.wav,4660,4423,237
2858,b-4_501-1014_524.wav,VTTS_b-4_501-1014_524.wav,4180,3704,476
2859,b-3_6016-6115_6050.wav,VTTS_b-3_6016-6115_6050.wav,1610,1567,43
2860,b-3_6501-6600_6577.wav,VTTS_b-3_6501-6600_6577.wav,2810,2844,-34
2861,b-1_2321-2421_2402.wav,VTTS_b-1_2321-2421_2402.wav,3390,3471,-81
2862,b-3_501-930_509.wav,VTTS_b-3_501-930_509.wav,11060,10391,669
2863,b-1_3026-3126_3059.wav,VTTS_b-1_3026-3126_3059.wav,4130,4621,-491
2864,b-1_3834-3934_3845.wav,VTTS_b-1_3834-3934_3845.wav,2720,2670,50
2865,b-4_1601-1706_1657.wav,VTTS_b-4_1601-1706_1657.wav,5820,5944,-124
2866,b-3_5853-5956_5902.wav,VTTS_b-3_5853-5956_5902.wav,4730,4923,-193
2867,b-3_6116-6215_6183.wav,VTTS_b-3_6116-6215_6183.wav,2160,2322,-162
2868,b-3_2089-2176_2110.wav,VTTS_b-3_2089-2176_2110.wav,6540,6269,271
2869,b-2_1223-1324_1268.wav,VTTS_b-2_1223-1324_1268.wav,2910,3146,-236
2870,b-3_3364-3453_3387.wav,VTTS_b-3_3364-3453_3387.wav,820,731,89
2871,b-2_1121-1222_1167.wav,VTTS_b-2_1121-1222_1167.wav,1870,1382,488
2872,b-2_203-304_250.wav,VTTS_b-2_203-304_250.wav,2050,2159,-109
2873,b-3_6501-6600_6559.wav,VTTS_b-3_6501-6600_6559.wav,1380,1440,-60
2874,b-4_1901-2000_1973.wav,VTTS_b-4_1901-2000_1973.wav,5710,7593,-1883
2875,b-1_1818-1918_1897.wav,VTTS_b-1_1818-1918_1897.wav,2030,1904,126
2876,b-1_2321-2421_2379.wav,VTTS_b-1_2321-2421_2379.wav,2000,2101,-101
2877,b-3_2524-2854_2690.wav,VTTS_b-3_2524-2854_2690.wav,4260,4203,57
2878,b-1_3531-3631_3565.wav,VTTS_b-1_3531-3631_3565.wav,3130,2752,378
2879,b-4_2000-5164_5118.wav,VTTS_b-4_2000-5164_5118.wav,8777,10089,-1312
2880,b-3_1079-1320_1173.wav,VTTS_b-3_1079-1320_1173.wav,3010,2926,84
2881,b-2_1597-1698_1694.wav,VTTS_b-2_1597-1698_1694.wav,5240,4470,770
2882,b-2_1903-2038_1986.wav,VTTS_b-2_1903-2038_1986.wav,3090,3042,48
2883,b-3_5009-5427_5389.wav,VTTS_b-3_5009-5427_5389.wav,1290,1277,13
2884,b-3_501-930_861.wav,VTTS_b-3_501-930_861.wav,2670,2798,-128
2885,b-4_2000-5164_2061.wav,VTTS_b-4_2000-5164_2061.wav,3165,3239,-74
2886,b-4_1401-1505_1426.wav,VTTS_b-4_1401-1505_1426.wav,4550,4598,-48
2887,b-3_392-500_453.wav,VTTS_b-3_392-500_453.wav,7450,8278,-828
2888,b-1_1111-1211_1175.wav,VTTS_b-1_1111-1211_1175.wav,1540,1335,205
2889,b-3_6801-6900_6832.wav,VTTS_b-3_6801-6900_6832.wav,2600,2508,92
2890,b-1_2927-3025_2935.wav,VTTS_b-1_2927-3025_2935.wav,4790,5573,-783
2891,b-2_713-814_808.wav,VTTS_b-2_713-814_808.wav,3890,3599,291
2892,b-4_2000-5164_5019.wav,VTTS_b-4_2000-5164_5019.wav,3804,3936,-132
2893,b-2_203-304_302.wav,VTTS_b-2_203-304_302.wav,1390,1335,55
2894,b-2_101-202_137.wav,VTTS_b-2_101-202_137.wav,2670,2450,220
2895,b-2_815-916_899.wav,VTTS_b-2_815-916_899.wav,3160,3007,153
2896,b-3_3112-3197_3122.wav,VTTS_b-3_3112-3197_3122.wav,4780,6467,-1687
2897,b-3_1960-2000_1979.wav,VTTS_b-3_1960-2000_1979.wav,7250,5991,1259
2898,b-2_407-508_457.wav,VTTS_b-2_407-508_457.wav,1580,1277,303
2899,b-3_3454-3537_3526.wav,VTTS_b-3_3454-3537_3526.wav,10030,8638,1392
2900,b-3_1321-1568_1380.wav,VTTS_b-3_1321-1568_1380.wav,1450,1567,-117
2901,b-3_6701-6800_6769.wav,VTTS_b-3_6701-6800_6769.wav,4070,4447,-377
2902,b-3_4607-5008_4738.wav,VTTS_b-3_4607-5008_4738.wav,4290,4040,250
2903,b-4_2000-5164_2750.wav,VTTS_b-4_2000-5164_2750.wav,8980,8696,284
2904,b-4_2000-5164_3684.wav,VTTS_b-4_2000-5164_3684.wav,5209,5724,-515
2905,b-3_6016-6115_6049.wav,VTTS_b-3_6016-6115_6049.wav,1740,1474,266
2906,b-3_2524-2854_2747.wav,VTTS_b-3_2524-2854_2747.wav,2710,2485,225
2907,b-4_2000-5164_3107.wav,VTTS_b-4_2000-5164_3107.wav,5344,4853,491
2908,b-3_1862-1959_1901.wav,VTTS_b-3_1862-1959_1901.wav,4950,3634,1316
2909,b-3_98-195_105.wav,VTTS_b-3_98-195_105.wav,5380,5492,-112
2910,b-1_2220-2320_2303.wav,VTTS_b-1_2220-2320_2303.wav,4900,6339,-1439
2911,b-1_74-174_119.wav,VTTS_b-1_74-174_119.wav,2260,2136,124
2912,b-1_2321-2421_2355.wav,VTTS_b-1_2321-2421_2355.wav,4020,3738,282
2913,b-1_2018-2118_2098.wav,VTTS_b-1_2018-2118_2098.wav,2130,2264,-134
2914,b-1_2826-2926_2856.wav,VTTS_b-1_2826-2926_2856.wav,4660,5909,-1249
2915,b-1_2523-2623_2545.wav,VTTS_b-1_2523-2623_2545.wav,3790,2705,1085
2916,b-4_2000-5164_4325.wav,VTTS_b-4_2000-5164_4325.wav,2919,4156,-1237
2917,b-1_276-376_301.wav,VTTS_b-1_276-376_301.wav,1010,1010,0
2918,b-1_2321-2421_2334.wav,VTTS_b-1_2321-2421_2334.wav,1400,1440,-40
2919,b-1_3228-3328_3234.wav,VTTS_b-1_3228-3328_3234.wav,1920,1904,16
2920,b-2_2107-2193_2153.wav,VTTS_b-2_2107-2193_2153.wav,1270,1254,16
2921,b-4_2000-5164_2596.wav,VTTS_b-4_2000-5164_2596.wav,3960,8568,-4608
2922,b-4_2000-5164_3975.wav,VTTS_b-4_2000-5164_3975.wav,6750,10194,-3444
2923,b-1_1212-1312_1260.wav,VTTS_b-1_1212-1312_1260.wav,4900,5004,-104
2924,b-3_2855-2942_2886.wav,VTTS_b-3_2855-2942_2886.wav,4920,4528,392
2925,b-3_3889-4000_3929.wav,VTTS_b-3_3889-4000_3929.wav,2860,2937,-77
2926,b-1_579-649_580.wav,VTTS_b-1_579-649_580.wav,2970,3460,-490
2927,b-2_1121-1222_1190.wav,VTTS_b-2_1121-1222_1190.wav,1120,1080,40
2928,b-4_2000-5164_3856.wav,VTTS_b-4_2000-5164_3856.wav,2561,2601,-40
2929,b-4_1901-2000_1980.wav,VTTS_b-4_1901-2000_1980.wav,7330,8046,-716
2930,b-3_196-293_251.wav,VTTS_b-3_196-293_251.wav,3420,2902,518
2931,b-3_5009-5427_5101.wav,VTTS_b-3_5009-5427_5101.wav,3660,4354,-694
2932,b-3_3538-3627_3628.wav,VTTS_b-3_3538-3627_3628.wav,8390,8127,263
2933,b-2_2209-2310_2226.wav,VTTS_b-2_2209-2310_2226.wav,1040,975,65
2934,b-4_2000-5164_2290.wav,VTTS_b-4_2000-5164_2290.wav,5920,5538,382
2935,b-3_1079-1320_1249.wav,VTTS_b-3_1079-1320_1249.wav,9290,9996,-706
2936,b-1_2927-3025_2999.wav,VTTS_b-1_2927-3025_2999.wav,2940,2891,49
2937,b-1_2119-2219_2180.wav,VTTS_b-1_2119-2219_2180.wav,1790,1591,199
2938,b-4_2000-5164_2733.wav,VTTS_b-4_2000-5164_2733.wav,6980,6606,374
2939,b-1_2018-2118_2052.wav,VTTS_b-1_2018-2118_2052.wav,1520,1591,-71
2940,b-4_2000-5164_4082.wav,VTTS_b-4_2000-5164_4082.wav,4961,4841,120
2941,b-2_101-202_199.wav,VTTS_b-2_101-202_199.wav,2050,2171,-121
2942,b-2_407-508_444.wav,VTTS_b-2_407-508_444.wav,2940,2752,188
2943,b-4_2000-5164_4437.wav,VTTS_b-4_2000-5164_4437.wav,2914,2879,35
2944,b-1_579-649_645.wav,VTTS_b-1_579-649_645.wav,1830,3390,-1560
2945,b-4_2000-5164_5068.wav,VTTS_b-4_2000-5164_5068.wav,2744,3866,-1122
2946,b-3_2943-3024_2966.wav,VTTS_b-3_2943-3024_2966.wav,10440,10507,-67
2947,b-1_3127-3227_3128.wav,VTTS_b-1_3127-3227_3128.wav,3530,3529,1
2948,b-1_794-1009_885.wav,VTTS_b-1_794-1009_885.wav,3570,3402,168
2949,b-4_1101-1220_1184.wav,VTTS_b-4_1101-1220_1184.wav,8900,8615,285
2950,b-4_2000-5164_2044.wav,VTTS_b-4_2000-5164_2044.wav,7560,10263,-2703
2951,b-1_4358-4393_4365.wav,VTTS_b-1_4358-4393_4365.wav,3870,3901,-31
2952,b-2_1019-1120_1020.wav,VTTS_b-2_1019-1120_1020.wav,4830,8057,-3227
2953,b-3_6217-6274_6270.wav,VTTS_b-3_6217-6274_6270.wav,2790,2566,224
2954,b-3_3803-3888_3862.wav,VTTS_b-3_3803-3888_3862.wav,8200,7872,328
2955,b-3_1960-2000_1995.wav,VTTS_b-3_1960-2000_1995.wav,4120,4052,68
2956,b-1_3430-3530_3528.wav,VTTS_b-1_3430-3530_3528.wav,2060,2067,-7
2957,b-3_1862-1959_1881.wav,VTTS_b-3_1862-1959_1881.wav,6290,5399,891
2958,b-4_1-52_10.wav,VTTS_b-4_1-52_10.wav,5690,5921,-231
2959,b-4_2000-5164_2858.wav,VTTS_b-4_2000-5164_2858.wav,5590,5457,133
2960,b-3_6601-6700_6685.wav,VTTS_b-3_6601-6700_6685.wav,1850,1730,120
2961,b-4_2000-5164_4097.wav,VTTS_b-4_2000-5164_4097.wav,3077,3019,58
2962,b-1_579-649_587.wav,VTTS_b-1_579-649_587.wav,1650,1672,-22
2963,b-1_794-1009_991.wav,VTTS_b-1_794-1009_991.wav,4470,3657,813
2964,b-3_4207-4314_4276.wav,VTTS_b-3_4207-4314_4276.wav,2900,2810,90
2965,b-3_980-1077_999.wav,VTTS_b-3_980-1077_999.wav,7100,6397,703
2966,b-1_175-275_219.wav,VTTS_b-1_175-275_219.wav,1660,2473,-813
2967,b-3_3454-3537_3530.wav,VTTS_b-3_3454-3537_3530.wav,8480,8104,376
2968,b-1_2826-2926_2872.wav,VTTS_b-1_2826-2926_2872.wav,1890,2426,-536
2969,b-4_1014-1100_1052.wav,VTTS_b-4_1014-1100_1052.wav,3610,4040,-430
2970,b-4_501-1014_901.wav,VTTS_b-4_501-1014_901.wav,4820,4516,304
2971,b-4_2000-5164_4104.wav,VTTS_b-4_2000-5164_4104.wav,5997,5550,447
2972,b-1_4286-4321_4307.wav,VTTS_b-1_4286-4321_4307.wav,4370,4098,272
2973,b-2_2107-2193_2109.wav,VTTS_b-2_2107-2193_2109.wav,1480,952,528
2974,b-2_407-508_503.wav,VTTS_b-2_407-508_503.wav,1900,1451,449
2975,b-1_3127-3227_3159.wav,VTTS_b-1_3127-3227_3159.wav,4230,4447,-217
2976,b-2_815-916_887.wav,VTTS_b-2_815-916_887.wav,3200,3193,7
2977,b-1_4430-4465_4448.wav,VTTS_b-1_4430-4465_4448.wav,5600,6060,-460
2978,b-3_6116-6215_6203.wav,VTTS_b-3_6116-6215_6203.wav,3140,3251,-111
2979,b-1_1414-1514_1491.wav,VTTS_b-1_1414-1514_1491.wav,2060,1707,353
2980,b-4_1707-1813_1753.wav,VTTS_b-4_1707-1813_1753.wav,4900,4748,152
2981,b-3_5009-5427_5035.wav,VTTS_b-3_5009-5427_5035.wav,7730,7349,381
2982,b-4_1901-2000_1963.wav,VTTS_b-4_1901-2000_1963.wav,6560,6444,116
2983,b-3_5009-5427_5122.wav,VTTS_b-3_5009-5427_5122.wav,5770,5817,-47
2984,b-3_501-930_690.wav,VTTS_b-3_501-930_690.wav,3080,2752,328
2985,b-3_196-293_228.wav,VTTS_b-3_196-293_228.wav,2310,2368,-58
2986,b-3_6016-6115_6046.wav,VTTS_b-3_6016-6115_6046.wav,13530,11610,1920
2987,b-4_2000-5164_2813.wav,VTTS_b-4_2000-5164_2813.wav,6810,7036,-226
2988,b-1_1212-1312_1303.wav,VTTS_b-1_1212-1312_1303.wav,4130,11610,-7480
2989,b-2_1801-1902_1899.wav,VTTS_b-2_1801-1902_1899.wav,1710,2264,-554
2990,b-4_1101-1220_1120.wav,VTTS_b-4_1101-1220_1120.wav,4270,5097,-827
2991,b-1_3834-3934_3835.wav,VTTS_b-1_3834-3934_3835.wav,1540,1556,-16
2992,b-4_401-500_418.wav,VTTS_b-4_401-500_418.wav,3110,2798,312
2993,b-3_501-930_666.wav,VTTS_b-3_501-930_666.wav,2650,2694,-44
2994,b-1_4214-4285_4286.wav,VTTS_b-1_4214-4285_4286.wav,4430,11610,-7180
2995,b-4_401-500_459.wav,VTTS_b-4_401-500_459.wav,5280,5445,-165
2996,b-1_3329-3429_3421.wav,VTTS_b-1_3329-3429_3421.wav,2380,2090,290
2997,b-1_4034-4069_4069.wav,VTTS_b-1_4034-4069_4069.wav,5810,7895,-2085
2998,b-4_2000-5164_2118.wav,VTTS_b-4_2000-5164_2118.wav,3580,3646,-66
2999,b-4_2000-5164_4030.wav,VTTS_b-4_2000-5164_4030.wav,6018,6153,-135
3000,b-1_3430-3530_3494.wav,VTTS_b-1_3430-3530_3494.wav,1310,1207,103
3001,b-3_5009-5427_5243.wav,VTTS_b-3_5009-5427_5243.wav,5000,4226,774
3002,b-3_5009-5427_5228.wav,VTTS_b-3_5009-5427_5228.wav,2040,2136,-96
3003,b-2_509-610_536.wav,VTTS_b-2_509-610_536.wav,2240,2299,-59
3004,b-2_1597-1698_1650.wav,VTTS_b-2_1597-1698_1650.wav,5730,5294,436
3005,b-2_1-100_99.wav,VTTS_b-2_1-100_99.wav,2110,1823,287
3006,b-3_6900-7016_7003.wav,VTTS_b-3_6900-7016_7003.wav,1340,1173,167
3007,b-2_1801-1902_1850.wav,VTTS_b-2_1801-1902_1850.wav,2790,3901,-1111
3008,b-1_175-275_217.wav,VTTS_b-1_175-275_217.wav,1970,2276,-306
3009,b-3_5009-5427_5014.wav,VTTS_b-3_5009-5427_5014.wav,3640,3855,-215
3010,b-4_2000-5164_3642.wav,VTTS_b-4_2000-5164_3642.wav,3002,2322,680
3011,b-3_5009-5427_5117.wav,VTTS_b-3_5009-5427_5117.wav,3250,3646,-396
3012,b-2_2209-2310_2210.wav,VTTS_b-2_2209-2310_2210.wav,1850,4992,-3142
3013,b-3_501-930_912.wav,VTTS_b-3_501-930_912.wav,4620,4598,22
3014,b-1_2220-2320_2230.wav,VTTS_b-1_2220-2320_2230.wav,1360,1358,2
3015,b-4_2000-5164_2397.wav,VTTS_b-4_2000-5164_2397.wav,8890,7988,902
3016,b-1_3026-3126_3026.wav,VTTS_b-1_3026-3126_3026.wav,2740,2496,244
3017,b-3_4207-4314_4287.wav,VTTS_b-3_4207-4314_4287.wav,760,743,17
3018,b-3_1321-1568_1523.wav,VTTS_b-3_1321-1568_1523.wav,4130,3994,136
3019,b-3_4425-4497_4445.wav,VTTS_b-3_4425-4497_4445.wav,3390,2798,592
3020,b-1_1414-1514_1467.wav,VTTS_b-1_1414-1514_1467.wav,2430,2891,-461
3021,b-1_2927-3025_3011.wav,VTTS_b-1_2927-3025_3011.wav,1070,1103,-33
3022,b-3_1321-1568_1462.wav,VTTS_b-3_1321-1568_1462.wav,8660,8522,138
3023,b-3_980-1077_989.wav,VTTS_b-3_980-1077_989.wav,7210,8649,-1439
3024,b-2_1223-1324_1264.wav,VTTS_b-2_1223-1324_1264.wav,1320,1463,-143
3025,b-3_2524-2854_2803.wav,VTTS_b-3_2524-2854_2803.wav,5670,5515,155
3026,b-1_1515-1615_1516.wav,VTTS_b-1_1515-1615_1516.wav,1600,1451,149
3027,b-1_579-649_646.wav,VTTS_b-1_579-649_646.wav,2260,2264,-4
3028,b-3_1-97_17.wav,VTTS_b-3_1-97_17.wav,1580,1591,-11
3029,b-4_2000-5164_3348.wav,VTTS_b-4_2000-5164_3348.wav,5197,5166,31
3030,b-2_1427-1562_1544.wav,VTTS_b-2_1427-1562_1544.wav,1670,1370,300
3031,b-3_3628-3714_3678.wav,VTTS_b-3_3628-3714_3678.wav,7300,6107,1193
3032,b-3_6301-6400_6374.wav,VTTS_b-3_6301-6400_6374.wav,7940,9172,-1232
3033,b-4_2000-5164_4286.wav,VTTS_b-4_2000-5164_4286.wav,1953,1939,14
3034,b-4_2000-5164_2811.wav,VTTS_b-4_2000-5164_2811.wav,6670,6374,296
3035,b-1_1313-1413_1374.wav,VTTS_b-1_1313-1413_1374.wav,1350,1498,-148
3036,b-4_1601-1706_1688.wav,VTTS_b-4_1601-1706_1688.wav,7660,7059,601
3037,b-3_3628-3714_3643.wav,VTTS_b-3_3628-3714_3643.wav,4880,4481,399
3038,b-3_6501-6600_6514.wav,VTTS_b-3_6501-6600_6514.wav,6320,4876,1444
3039,b-3_4607-5008_4611.wav,VTTS_b-3_4607-5008_4611.wav,3790,5062,-1272
3040,b-1_1717-1817_1815.wav,VTTS_b-1_1717-1817_1815.wav,2480,2403,77
3041,b-1_478-578_505.wav,VTTS_b-1_478-578_505.wav,2080,2392,-312
3042,b-1_4178-4213_4205.wav,VTTS_b-1_4178-4213_4205.wav,4200,4516,-316
3043,b-4_2000-5164_3568.wav,VTTS_b-4_2000-5164_3568.wav,2159,1730,429
3044,b-1_276-376_276.wav,VTTS_b-1_276-376_276.wav,1390,1428,-38
3045,b-4_53-150_117.wav,VTTS_b-4_53-150_117.wav,8700,8638,62
3046,b-1_2220-2320_2268.wav,VTTS_b-1_2220-2320_2268.wav,1540,1393,147
3047,b-4_2000-5164_3415.wav,VTTS_b-4_2000-5164_3415.wav,11102,11610,-508
3048,b-2_1903-2038_1939.wav,VTTS_b-2_1903-2038_1939.wav,3890,4795,-905
3049,b-3_2943-3024_2982.wav,VTTS_b-3_2943-3024_2982.wav,4640,5224,-584
3050,b-1_1818-1918_1902.wav,VTTS_b-1_1818-1918_1902.wav,3740,3669,71
3051,b-1_2422-2522_2431.wav,VTTS_b-1_2422-2522_2431.wav,2690,2717,-27
3052,b-4_2000-5164_4801.wav,VTTS_b-4_2000-5164_4801.wav,15988,11610,4378
3053,b-4_1707-1813_1761.wav,VTTS_b-4_1707-1813_1761.wav,3390,3251,139
3054,b-1_3228-3328_3297.wav,VTTS_b-1_3228-3328_3297.wav,1950,1672,278
3055,b-3_1960-2000_1992.wav,VTTS_b-3_1960-2000_1992.wav,4470,4261,209
3056,b-1_74-174_145.wav,VTTS_b-1_74-174_145.wav,1160,1382,-222
3057,b-2_2040-2072_2045.wav,VTTS_b-2_2040-2072_2045.wav,1230,1254,-24
3058,b-4_2000-5164_3693.wav,VTTS_b-4_2000-5164_3693.wav,2272,2078,194
3059,b-4_2000-5164_2348.wav,VTTS_b-4_2000-5164_2348.wav,6050,5317,733
3060,b-1_2119-2219_2202.wav,VTTS_b-1_2119-2219_2202.wav,2600,1974,626
3061,b-2_101-202_117.wav,VTTS_b-2_101-202_117.wav,1520,1916,-396
3062,b-3_6116-6215_6159.wav,VTTS_b-3_6116-6215_6159.wav,7210,6920,290
3063,b-3_6301-6400_6356.wav,VTTS_b-3_6301-6400_6356.wav,7450,7059,391
3064,b-3_1568-1665_1581.wav,VTTS_b-3_1568-1665_1581.wav,1470,1324,146
3065,b-4_2000-5164_3086.wav,VTTS_b-4_2000-5164_3086.wav,7263,7790,-527
3066,b-4_2000-5164_3657.wav,VTTS_b-4_2000-5164_3657.wav,1506,1045,461
3067,b-3_2524-2854_2574.wav,VTTS_b-3_2524-2854_2574.wav,7110,7593,-483
3068,b-3_4315-4424_4383.wav,VTTS_b-3_4315-4424_4383.wav,6250,5782,468
3069,b-3_2350-2433_2352.wav,VTTS_b-3_2350-2433_2352.wav,4440,3669,771
3070,b-3_6601-6700_6684.wav,VTTS_b-3_6601-6700_6684.wav,7340,8824,-1484
3071,b-3_501-930_797.wav,VTTS_b-3_501-930_797.wav,4050,4168,-118
3072,b-4_2000-5164_2012.wav,VTTS_b-4_2000-5164_2012.wav,5420,5538,-118
3073,b-1_3329-3429_3350.wav,VTTS_b-1_3329-3429_3350.wav,1270,1324,-54
3074,b-3_6501-6600_6593.wav,VTTS_b-3_6501-6600_6593.wav,3100,2612,488
3075,b-1_794-1009_905.wav,VTTS_b-1_794-1009_905.wav,2050,2032,18
3076,b-3_1666-1763_1670.wav,VTTS_b-3_1666-1763_1670.wav,4020,4040,-20
3077,b-1_175-275_255.wav,VTTS_b-1_175-275_255.wav,5050,6699,-1649
3078,b-1_2826-2926_2865.wav,VTTS_b-1_2826-2926_2865.wav,2200,2299,-99
3079,b-3_4607-5008_4981.wav,VTTS_b-3_4607-5008_4981.wav,5380,5422,-42
3080,b-4_401-500_410.wav,VTTS_b-4_401-500_410.wav,4400,4122,278
3081,b-4_2000-5164_4395.wav,VTTS_b-4_2000-5164_4395.wav,3375,3680,-305
3082,b-4_2000-5164_3185.wav,VTTS_b-4_2000-5164_3185.wav,3237,3181,56
3083,b-1_175-275_187.wav,VTTS_b-1_175-275_187.wav,4090,2949,1141
3084,b-3_294-391_345.wav,VTTS_b-3_294-391_345.wav,7050,6931,119
3085,b-3_1764-1861_1841.wav,VTTS_b-3_1764-1861_1841.wav,5940,6351,-411
3086,b-1_686-793_720.wav,VTTS_b-1_686-793_720.wav,1430,1405,25
3087,b-3_1321-1568_1354.wav,VTTS_b-3_1321-1568_1354.wav,5300,5410,-110
3088,b-3_1568-1665_1609.wav,VTTS_b-3_1568-1665_1609.wav,5950,5747,203
3089,b-3_2089-2176_2162.wav,VTTS_b-3_2089-2176_2162.wav,4590,4714,-124
3090,b-4_501-1014_807.wav,VTTS_b-4_501-1014_807.wav,7970,7454,516
3091,b-1_3834-3934_3896.wav,VTTS_b-1_3834-3934_3896.wav,2710,8336,-5626
3092,b-3_5639-5744_5731.wav,VTTS_b-3_5639-5744_5731.wav,2060,1753,307
3093,b-3_1666-1763_1764.wav,VTTS_b-3_1666-1763_1764.wav,4290,5828,-1538
3094,b-4_2000-5164_4080.wav,VTTS_b-4_2000-5164_4080.wav,4150,3715,435
3095,b-4_501-1014_590.wav,VTTS_b-4_501-1014_590.wav,3160,3065,95
3096,b-2_2073-2106_2079.wav,VTTS_b-2_2073-2106_2079.wav,1490,1416,74
3097,b-1_2321-2421_2390.wav,VTTS_b-1_2321-2421_2390.wav,1800,1730,70
3098,b-1_2927-3025_3002.wav,VTTS_b-1_2927-3025_3002.wav,2330,2183,147
3099,b-4_2000-5164_4166.wav,VTTS_b-4_2000-5164_4166.wav,4692,5480,-788
3100,b-1_2927-3025_2990.wav,VTTS_b-1_2927-3025_2990.wav,2820,2961,-141
3101,b-3_1079-1320_1113.wav,VTTS_b-3_1079-1320_1113.wav,7990,6653,1337
3102,b-3_5957-6015_6012.wav,VTTS_b-3_5957-6015_6012.wav,3630,3576,54
3103,b-3_6501-6600_6554.wav,VTTS_b-3_6501-6600_6554.wav,1100,1045,55
3104,b-3_4607-5008_4652.wav,VTTS_b-3_4607-5008_4652.wav,6530,5817,713
3105,b-3_4607-5008_4735.wav,VTTS_b-3_4607-5008_4735.wav,5360,5190,170
3106,b-3_5428-5533_5512.wav,VTTS_b-3_5428-5533_5512.wav,3770,3843,-73
3107,b-2_815-916_834.wav,VTTS_b-2_815-916_834.wav,1590,1579,11
3108,b-1_794-1009_926.wav,VTTS_b-1_794-1009_926.wav,1840,2078,-238
3109,b-1_4214-4285_4237.wav,VTTS_b-1_4214-4285_4237.wav,1640,1741,-101
3110,b-3_1568-1665_1664.wav,VTTS_b-3_1568-1665_1664.wav,4980,11610,-6630
3111,b-3_6601-6700_6694.wav,VTTS_b-3_6601-6700_6694.wav,4950,4644,306
3112,b-4_2000-5164_4071.wav,VTTS_b-4_2000-5164_4071.wav,6927,6606,321
3113,b-1_1313-1413_1407.wav,VTTS_b-1_1313-1413_1407.wav,2250,1579,671
3114,b-4_2000-5164_4743.wav,VTTS_b-4_2000-5164_4743.wav,2312,2310,2
3115,b-4_2000-5164_4656.wav,VTTS_b-4_2000-5164_4656.wav,8539,8847,-308
3116,b-3_4607-5008_4722.wav,VTTS_b-3_4607-5008_4722.wav,3180,3274,-94
3117,b-1_579-649_584.wav,VTTS_b-1_579-649_584.wav,6030,5422,608
3118,b-4_2000-5164_2318.wav,VTTS_b-4_2000-5164_2318.wav,6150,6409,-259
3119,b-2_1427-1562_1505.wav,VTTS_b-2_1427-1562_1505.wav,4270,4214,56
3120,b-1_3026-3126_3118.wav,VTTS_b-1_3026-3126_3118.wav,1980,2171,-191
3121,b-3_6701-6800_6736.wav,VTTS_b-3_6701-6800_6736.wav,4150,3286,864
3122,b-1_2624-2724_2719.wav,VTTS_b-1_2624-2724_2719.wav,2110,2020,90
3123,b-2_101-202_111.wav,VTTS_b-2_101-202_111.wav,2550,2740,-190
3124,b-2_815-916_840.wav,VTTS_b-2_815-916_840.wav,970,871,99
3125,b-1_2624-2724_2677.wav,VTTS_b-1_2624-2724_2677.wav,2500,2694,-194
3126,b-3_2524-2854_2706.wav,VTTS_b-3_2524-2854_2706.wav,5960,5770,190
3127,b-3_4315-4424_4421.wav,VTTS_b-3_4315-4424_4421.wav,4890,4365,525
3128,b-4_2000-5164_3371.wav,VTTS_b-4_2000-5164_3371.wav,6178,6385,-207
3129,b-2_2413-2500_2482.wav,VTTS_b-2_2413-2500_2482.wav,1460,1544,-84
3130,b-4_1901-2000_1921.wav,VTTS_b-4_1901-2000_1921.wav,1350,1358,-8
3131,b-4_2000-5164_4256.wav,VTTS_b-4_2000-5164_4256.wav,4130,4957,-827
3132,b-3_501-930_687.wav,VTTS_b-3_501-930_687.wav,3500,3495,5
3133,b-4_2000-5164_2728.wav,VTTS_b-4_2000-5164_2728.wav,4915,11610,-6695
3134,b-1_2220-2320_2247.wav,VTTS_b-1_2220-2320_2247.wav,1510,1428,82
3135,b-2_1121-1222_1156.wav,VTTS_b-2_1121-1222_1156.wav,1420,1347,73
3136,b-3_392-500_483.wav,VTTS_b-3_392-500_483.wav,4140,4063,77
3137,b-1_650-685_678.wav,VTTS_b-1_650-685_678.wav,1920,1846,74
3138,b-3_1321-1568_1369.wav,VTTS_b-3_1321-1568_1369.wav,4090,3982,108
3139,b-4_2000-5164_2072.wav,VTTS_b-4_2000-5164_2072.wav,6600,6502,98
3140,b-2_2107-2193_2185.wav,VTTS_b-2_2107-2193_2185.wav,1340,1265,75
3141,b-2_101-202_144.wav,VTTS_b-2_101-202_144.wav,1680,1892,-212
3142,b-3_3025-3111_3082.wav,VTTS_b-3_3025-3111_3082.wav,5120,5143,-23
3143,b-3_196-293_256.wav,VTTS_b-3_196-293_256.wav,4520,4795,-275
3144,b-4_501-1014_797.wav,VTTS_b-4_501-1014_797.wav,1610,1277,333
3145,b-3_3715-3802_3753.wav,VTTS_b-3_3715-3802_3753.wav,5390,5317,73
3146,b-3_1079-1320_1180.wav,VTTS_b-3_1079-1320_1180.wav,2910,2310,600
3147,b-1_3026-3126_3080.wav,VTTS_b-1_3026-3126_3080.wav,3220,2798,422
3148,b-4_53-150_149.wav,VTTS_b-4_53-150_149.wav,8030,7628,402
3149,b-4_1401-1505_1447.wav,VTTS_b-4_1401-1505_1447.wav,4440,4423,17
3150,b-4_301-400_313.wav,VTTS_b-4_301-400_313.wav,7000,6188,812
3151,b-1_1616-1716_1663.wav,VTTS_b-1_1616-1716_1663.wav,3610,3170,440
3152,b-1_478-578_552.wav,VTTS_b-1_478-578_552.wav,3210,5085,-1875
3153,b-1_794-1009_797.wav,VTTS_b-1_794-1009_797.wav,1750,1614,136
3154,b-3_5853-5956_5920.wav,VTTS_b-3_5853-5956_5920.wav,6490,7326,-836
3155,b-3_2524-2854_2571.wav,VTTS_b-3_2524-2854_2571.wav,4050,3750,300
3156,b-1_1313-1413_1323.wav,VTTS_b-1_1313-1413_1323.wav,2170,1985,185
3157,b-3_4207-4314_4223.wav,VTTS_b-3_4207-4314_4223.wav,4560,4923,-363
3158,b-3_6301-6400_6315.wav,VTTS_b-3_6301-6400_6315.wav,4900,4679,221
3159,b-4_1901-2000_1950.wav,VTTS_b-4_1901-2000_1950.wav,1870,1962,-92
3160,b-4_1301-1400_1305.wav,VTTS_b-4_1301-1400_1305.wav,7750,7721,29
3161,b-1_1010-1110_1059.wav,VTTS_b-1_1010-1110_1059.wav,3370,2949,421
3162,b-2_509-610_585.wav,VTTS_b-2_509-610_585.wav,3890,4528,-638
3163,b-1_2220-2320_2282.wav,VTTS_b-1_2220-2320_2282.wav,1730,1649,81
3164,b-4_2000-5164_2781.wav,VTTS_b-4_2000-5164_2781.wav,5325,5178,147
3165,b-4_2000-5164_4533.wav,VTTS_b-4_2000-5164_4533.wav,5560,5782,-222
3166,b-2_1-100_10.wav,VTTS_b-2_1-100_10.wav,2260,2705,-445
3167,b-4_2000-5164_2448.wav,VTTS_b-4_2000-5164_2448.wav,2190,2276,-86
3168,b-3_5009-5427_5254.wav,VTTS_b-3_5009-5427_5254.wav,4220,4145,75
3169,b-4_1401-1505_1429.wav,VTTS_b-4_1401-1505_1429.wav,7430,6397,1033
3170,b-4_2000-5164_4745.wav,VTTS_b-4_2000-5164_4745.wav,1534,1370,164
3171,b-4_1221-1300_1261.wav,VTTS_b-4_1221-1300_1261.wav,2250,2543,-293
3172,b-2_611-712_626.wav,VTTS_b-2_611-712_626.wav,1900,1858,42
3173,b-1_3733-3833_3778.wav,VTTS_b-1_3733-3833_3778.wav,3070,3355,-285
3174,b-4_2000-5164_3857.wav,VTTS_b-4_2000-5164_3857.wav,1217,1138,79
3175,b-3_294-391_383.wav,VTTS_b-3_294-391_383.wav,6090,5735,355
3176,b-3_4425-4497_4478.wav,VTTS_b-3_4425-4497_4478.wav,3460,3088,372
3177,b-3_501-930_719.wav,VTTS_b-3_501-930_719.wav,4700,6954,-2254
3178,b-3_4607-5008_4970.wav,VTTS_b-3_4607-5008_4970.wav,8490,9764,-1274
3179,b-2_917-1018_961.wav,VTTS_b-2_917-1018_961.wav,3470,4063,-593
3180,b-3_1666-1763_1736.wav,VTTS_b-3_1666-1763_1736.wav,6610,7605,-995
3181,b-3_3628-3714_3700.wav,VTTS_b-3_3628-3714_3700.wav,3610,3738,-128
3182,b-3_4607-5008_4860.wav,VTTS_b-3_4607-5008_4860.wav,3230,3785,-555
3183,b-4_2000-5164_4661.wav,VTTS_b-4_2000-5164_4661.wav,5096,5480,-384
3184,b-4_501-1014_749.wav,VTTS_b-4_501-1014_749.wav,6160,5422,738
3185,b-1_3935-4033_3974.wav,VTTS_b-1_3935-4033_3974.wav,3000,3100,-100
3186,b-3_4607-5008_4727.wav,VTTS_b-3_4607-5008_4727.wav,2010,2043,-33
3187,b-3_501-930_767.wav,VTTS_b-3_501-930_767.wav,5510,4992,518
3188,b-4_53-150_53.wav,VTTS_b-4_53-150_53.wav,9280,7361,1919
3189,b-3_3279-3363_3301.wav,VTTS_b-3_3279-3363_3301.wav,6790,6641,149
3190,b-3_392-500_452.wav,VTTS_b-3_392-500_452.wav,4200,4342,-142
3191,b-1_2119-2219_2190.wav,VTTS_b-1_2119-2219_2190.wav,2530,4284,-1754
3192,b-1_1212-1312_1259.wav,VTTS_b-1_1212-1312_1259.wav,2170,2171,-1
3193,b-3_196-293_285.wav,VTTS_b-3_196-293_285.wav,3830,3622,208
3194,b-1_2927-3025_2991.wav,VTTS_b-1_2927-3025_2991.wav,2460,2438,22
3195,b-4_2000-5164_4146.wav,VTTS_b-4_2000-5164_4146.wav,3144,2937,207
3196,b-4_2000-5164_3844.wav,VTTS_b-4_2000-5164_3844.wav,4736,5283,-547
3197,b-3_3364-3453_3433.wav,VTTS_b-3_3364-3453_3433.wav,3840,3692,148
3198,b-3_6301-6400_6349.wav,VTTS_b-3_6301-6400_6349.wav,1530,1440,90
3199,b-3_3025-3111_3030.wav,VTTS_b-3_3025-3111_3030.wav,2160,2496,-336
3200,b-4_2000-5164_2616.wav,VTTS_b-4_2000-5164_2616.wav,4805,4377,428
3201,b-2_1597-1698_1600.wav,VTTS_b-2_1597-1698_1600.wav,4940,4876,64
3202,b-2_1121-1222_1144.wav,VTTS_b-2_1121-1222_1144.wav,2430,4574,-2144
3203,b-4_2000-5164_4703.wav,VTTS_b-4_2000-5164_4703.wav,9743,11250,-1507
3204,b-1_3127-3227_3142.wav,VTTS_b-1_3127-3227_3142.wav,2040,1927,113
3205,b-4_2000-5164_5014.wav,VTTS_b-4_2000-5164_5014.wav,4930,4841,89
3206,b-1_2624-2724_2690.wav,VTTS_b-1_2624-2724_2690.wav,2700,3808,-1108
3207,b-4_2000-5164_4476.wav,VTTS_b-4_2000-5164_4476.wav,8960,10925,-1965
3208,b-2_1427-1562_1453.wav,VTTS_b-2_1427-1562_1453.wav,1050,998,52
3209,b-3_3364-3453_3435.wav,VTTS_b-3_3364-3453_3435.wav,4240,4110,130
3210,b-4_1601-1706_1684.wav,VTTS_b-4_1601-1706_1684.wav,1900,1985,-85
3211,b-4_2000-5164_3020.wav,VTTS_b-4_2000-5164_3020.wav,8402,7906,496
3212,b-3_4607-5008_4629.wav,VTTS_b-3_4607-5008_4629.wav,4780,4714,66
3213,b-4_2000-5164_2413.wav,VTTS_b-4_2000-5164_2413.wav,2440,11041,-8601
3214,b-4_2000-5164_4829.wav,VTTS_b-4_2000-5164_4829.wav,3463,3193,270
3215,b-1_2220-2320_2281.wav,VTTS_b-1_2220-2320_2281.wav,2560,2577,-17
3216,b-4_2000-5164_2272.wav,VTTS_b-4_2000-5164_2272.wav,15060,11610,3450
3217,b-3_4207-4314_4295.wav,VTTS_b-3_4207-4314_4295.wav,4610,4354,256
3218,b-3_1764-1861_1839.wav,VTTS_b-3_1764-1861_1839.wav,5110,4841,269
3219,b-3_6301-6400_6303.wav,VTTS_b-3_6301-6400_6303.wav,1110,1022,88
3220,b-3_2524-2854_2579.wav,VTTS_b-3_2524-2854_2579.wav,7380,7651,-271
3221,b-3_1321-1568_1385.wav,VTTS_b-3_1321-1568_1385.wav,6410,5921,489
3222,b-1_1717-1817_1729.wav,VTTS_b-1_1717-1817_1729.wav,1990,1858,132
3223,b-3_5745-5852_5810.wav,VTTS_b-3_5745-5852_5810.wav,4090,4122,-32
3224,b-1_1414-1514_1487.wav,VTTS_b-1_1414-1514_1487.wav,2040,1823,217
3225,b-3_980-1077_1019.wav,VTTS_b-3_980-1077_1019.wav,10680,10112,568
3226,b-3_1321-1568_1483.wav,VTTS_b-3_1321-1568_1483.wav,2620,3704,-1084
3227,b-1_1-73_8.wav,VTTS_b-1_1-73_8.wav,3380,3506,-126
3228,b-2_2194-2208_2207.wav,VTTS_b-2_2194-2208_2207.wav,1060,1370,-310
3229,b-1_3733-3833_3792.wav,VTTS_b-1_3733-3833_3792.wav,3960,4087,-127
3230,b-2_1903-2038_2009.wav,VTTS_b-2_1903-2038_2009.wav,1760,1683,77
3231,b-3_3538-3627_3562.wav,VTTS_b-3_3538-3627_3562.wav,3050,3599,-549
3232,b-3_931-979_979.wav,VTTS_b-3_931-979_979.wav,5710,5956,-246
3233,b-1_1212-1312_1283.wav,VTTS_b-1_1212-1312_1283.wav,6820,5515,1305
3234,b-2_1019-1120_1108.wav,VTTS_b-2_1019-1120_1108.wav,2890,3367,-477
3235,b-1_1111-1211_1133.wav,VTTS_b-1_1111-1211_1133.wav,2500,2345,155
3236,b-1_3127-3227_3212.wav,VTTS_b-1_3127-3227_3212.wav,2390,2276,114
3237,b-4_1401-1505_1461.wav,VTTS_b-4_1401-1505_1461.wav,3750,3611,139
3238,b-1_74-174_148.wav,VTTS_b-1_74-174_148.wav,1200,1242,-42
3239,b-3_1321-1568_1572.wav,VTTS_b-3_1321-1568_1572.wav,3260,3065,195
3240,b-4_2000-5164_2745.wav,VTTS_b-4_2000-5164_2745.wav,3060,2821,239
3241,b-4_1601-1706_1614.wav,VTTS_b-4_1601-1706_1614.wav,4410,5224,-814
3242,b-3_4607-5008_4621.wav,VTTS_b-3_4607-5008_4621.wav,3900,3762,138
3243,b-2_2107-2193_2132.wav,VTTS_b-2_2107-2193_2132.wav,1700,1741,-41
3244,b-1_3935-4033_4001.wav,VTTS_b-1_3935-4033_4001.wav,5010,5294,-284
3245,b-1_3430-3530_3434.wav,VTTS_b-1_3430-3530_3434.wav,1690,2171,-481
3246,b-3_501-930_552.wav,VTTS_b-3_501-930_552.wav,2840,2984,-144
3247,b-3_294-391_336.wav,VTTS_b-3_294-391_336.wav,4860,5712,-852
3248,b-4_2000-5164_3951.wav,VTTS_b-4_2000-5164_3951.wav,3414,3077,337
3249,b-1_1111-1211_1137.wav,VTTS_b-1_1111-1211_1137.wav,4050,3704,346
3250,b-1_1818-1918_1861.wav,VTTS_b-1_1818-1918_1861.wav,2390,2438,-48
3251,b-3_5428-5533_5517.wav,VTTS_b-3_5428-5533_5517.wav,3150,3170,-20
3252,b-2_2413-2500_2433.wav,VTTS_b-2_2413-2500_2433.wav,2250,2183,67
3253,b-1_1919-2017_1992.wav,VTTS_b-1_1919-2017_1992.wav,1620,1219,401
3254,b-3_4498-4605_4601.wav,VTTS_b-3_4498-4605_4601.wav,3710,3425,285
3255,b-3_6217-6274_6224.wav,VTTS_b-3_6217-6274_6224.wav,2530,2647,-117
3256,b-4_2000-5164_4137.wav,VTTS_b-4_2000-5164_4137.wav,5283,5178,105
3257,b-2_1597-1698_1654.wav,VTTS_b-2_1597-1698_1654.wav,3200,3913,-713
3258,b-4_2000-5164_3902.wav,VTTS_b-4_2000-5164_3902.wav,5046,5329,-283
3259,b-3_1079-1320_1084.wav,VTTS_b-3_1079-1320_1084.wav,7270,6838,432
3260,b-3_294-391_342.wav,VTTS_b-3_294-391_342.wav,5600,5294,306
3261,b-4_2000-5164_3328.wav,VTTS_b-4_2000-5164_3328.wav,4877,5863,-986
3262,b-3_4104-4206_4191.wav,VTTS_b-3_4104-4206_4191.wav,5420,5190,230
3263,b-1_1919-2017_1982.wav,VTTS_b-1_1919-2017_1982.wav,1040,1033,7
3264,b-4_2000-5164_4617.wav,VTTS_b-4_2000-5164_4617.wav,2516,2345,171
3265,b-4_1901-2000_1914.wav,VTTS_b-4_1901-2000_1914.wav,5490,4540,950
3266,b-1_4430-4465_4439.wav,VTTS_b-1_4430-4465_4439.wav,4190,4923,-733
3267,b-1_1515-1615_1615.wav,VTTS_b-1_1515-1615_1615.wav,2640,2566,74
3268,b-4_501-1014_976.wav,VTTS_b-4_501-1014_976.wav,1550,1614,-64
3269,b-4_1401-1505_1504.wav,VTTS_b-4_1401-1505_1504.wav,2800,2937,-137
3270,b-3_5009-5427_5172.wav,VTTS_b-3_5009-5427_5172.wav,6620,8301,-1681
3271,b-4_2000-5164_3195.wav,VTTS_b-4_2000-5164_3195.wav,8842,8081,761
3272,b-4_1601-1706_1698.wav,VTTS_b-4_1601-1706_1698.wav,6720,11610,-4890
3273,b-1_2725-2825_2821.wav,VTTS_b-1_2725-2825_2821.wav,1420,1486,-66
3274,b-1_74-174_135.wav,VTTS_b-1_74-174_135.wav,1330,1289,41
3275,b-1_74-174_149.wav,VTTS_b-1_74-174_149.wav,1270,871,399
3276,b-2_305-406_310.wav,VTTS_b-2_305-406_310.wav,2400,4354,-1954
3277,b-2_2107-2193_2167.wav,VTTS_b-2_2107-2193_2167.wav,1380,1254,126
3278,b-4_401-500_489.wav,VTTS_b-4_401-500_489.wav,4530,4133,397
3279,b-3_1960-2000_1990.wav,VTTS_b-3_1960-2000_1990.wav,6720,7221,-501
3280,b-3_5009-5427_5373.wav,VTTS_b-3_5009-5427_5373.wav,2960,2972,-12
3281,b-4_501-1014_975.wav,VTTS_b-4_501-1014_975.wav,3600,3506,94
3282,b-2_1699-1800_1758.wav,VTTS_b-2_1699-1800_1758.wav,4150,4528,-378
3283,b-1_3632-3732_3687.wav,VTTS_b-1_3632-3732_3687.wav,2320,2136,184
3284,b-1_2523-2623_2621.wav,VTTS_b-1_2523-2623_2621.wav,3920,3866,54
3285,b-4_2000-5164_4790.wav,VTTS_b-4_2000-5164_4790.wav,4597,4656,-59
3286,b-4_2000-5164_3352.wav,VTTS_b-4_2000-5164_3352.wav,5561,5608,-47
3287,b-1_3228-3328_3281.wav,VTTS_b-1_3228-3328_3281.wav,1610,1811,-201
3288,b-3_2524-2854_2526.wav,VTTS_b-3_2524-2854_2526.wav,1860,1962,-102
3289,b-3_4315-4424_4400.wav,VTTS_b-3_4315-4424_4400.wav,5180,5770,-590
3290,b-4_1-52_35.wav,VTTS_b-4_1-52_35.wav,6110,5178,932
3291,b-3_3198-3278_3272.wav,VTTS_b-3_3198-3278_3272.wav,7210,6687,523
3292,b-3_3803-3888_3816.wav,VTTS_b-3_3803-3888_3816.wav,5190,5050,140
3293,b-1_1212-1312_1231.wav,VTTS_b-1_1212-1312_1231.wav,1410,1254,156
3294,b-3_4315-4424_4414.wav,VTTS_b-3_4315-4424_4414.wav,3920,4052,-132
3295,b-3_4607-5008_4945.wav,VTTS_b-3_4607-5008_4945.wav,7610,8208,-598
3296,b-2_713-814_796.wav,VTTS_b-2_713-814_796.wav,1600,1625,-25
3297,b-4_2000-5164_2446.wav,VTTS_b-4_2000-5164_2446.wav,3970,4203,-233
3298,b-1_478-578_541.wav,VTTS_b-1_478-578_541.wav,4180,4238,-58
3299,b-4_2000-5164_3064.wav,VTTS_b-4_2000-5164_3064.wav,7904,7558,346
3300,b-3_5745-5852_5791.wav,VTTS_b-3_5745-5852_5791.wav,3900,3332,568
3301,b-1_3632-3732_3680.wav,VTTS_b-1_3632-3732_3680.wav,1550,1382,168
3302,b-1_794-1009_804.wav,VTTS_b-1_794-1009_804.wav,4410,4110,300
3303,b-3_2177-2266_2184.wav,VTTS_b-3_2177-2266_2184.wav,4810,4598,212
3304,b-1_3531-3631_3625.wav,VTTS_b-1_3531-3631_3625.wav,2980,2624,356
3305,b-3_2524-2854_2682.wav,VTTS_b-3_2524-2854_2682.wav,4880,4690,190
3306,b-3_6116-6215_6175.wav,VTTS_b-3_6116-6215_6175.wav,7230,10217,-2987
3307,b-1_1111-1211_1157.wav,VTTS_b-1_1111-1211_1157.wav,1620,1486,134
3308,b-1_1818-1918_1849.wav,VTTS_b-1_1818-1918_1849.wav,1870,1939,-69
3309,b-3_3715-3802_3781.wav,VTTS_b-3_3715-3802_3781.wav,5360,6931,-1571
3310,b-4_2000-5164_4897.wav,VTTS_b-4_2000-5164_4897.wav,3672,3553,119
3311,b-4_2000-5164_2178.wav,VTTS_b-4_2000-5164_2178.wav,4230,6699,-2469
3312,b-3_3279-3363_3308.wav,VTTS_b-3_3279-3363_3308.wav,1230,1149,81
3313,b-2_1121-1222_1141.wav,VTTS_b-2_1121-1222_1141.wav,1270,1254,16
3314,b-1_2422-2522_2482.wav,VTTS_b-1_2422-2522_2482.wav,3890,3936,-46
3315,b-3_980-1077_1051.wav,VTTS_b-3_980-1077_1051.wav,9600,11610,-2010
3316,b-3_98-195_144.wav,VTTS_b-3_98-195_144.wav,4210,3855,355
3317,b-1_794-1009_945.wav,VTTS_b-1_794-1009_945.wav,2370,2078,292
3318,b-2_407-508_428.wav,VTTS_b-2_407-508_428.wav,1300,1254,46
3319,b-2_1427-1562_1519.wav,VTTS_b-2_1427-1562_1519.wav,6430,7442,-1012
3320,b-3_4315-4424_4408.wav,VTTS_b-3_4315-4424_4408.wav,7620,6339,1281
3321,b-1_2927-3025_2984.wav,VTTS_b-1_2927-3025_2984.wav,1900,1939,-39
3322,b-4_2000-5164_2623.wav,VTTS_b-4_2000-5164_2623.wav,18915,11610,7305
3323,b-3_2524-2854_2796.wav,VTTS_b-3_2524-2854_2796.wav,4200,3924,276
3324,b-4_501-1014_684.wav,VTTS_b-4_501-1014_684.wav,5700,4969,731
3325,b-2_611-712_641.wav,VTTS_b-2_611-712_641.wav,1760,1800,-40
3326,b-3_5745-5852_5765.wav,VTTS_b-3_5745-5852_5765.wav,3810,5271,-1461
3327,b-4_2000-5164_4948.wav,VTTS_b-4_2000-5164_4948.wav,1218,1289,-71
3328,b-3_1764-1861_1767.wav,VTTS_b-3_1764-1861_1767.wav,4200,4040,160
3329,b-1_3329-3429_3418.wav,VTTS_b-1_3329-3429_3418.wav,3680,3576,104
3330,b-3_2434-2523_2481.wav,VTTS_b-3_2434-2523_2481.wav,4700,4516,184
3331,b-3_2177-2266_2183.wav,VTTS_b-3_2177-2266_2183.wav,7060,6896,164
3332,b-3_5009-5427_5414.wav,VTTS_b-3_5009-5427_5414.wav,5050,11610,-6560
3333,b-4_2000-5164_3026.wav,VTTS_b-4_2000-5164_3026.wav,7053,7338,-285
3334,b-1_1616-1716_1679.wav,VTTS_b-1_1616-1716_1679.wav,1710,2009,-299
3335,b-3_6016-6115_6090.wav,VTTS_b-3_6016-6115_6090.wav,6130,5840,290
3336,b-4_1901-2000_1929.wav,VTTS_b-4_1901-2000_1929.wav,4520,4307,213
3337,b-4_2000-5164_3035.wav,VTTS_b-4_2000-5164_3035.wav,2732,2682,50
3338,b-4_2000-5164_3113.wav,VTTS_b-4_2000-5164_3113.wav,4022,3460,562
3339,b-3_1321-1568_1549.wav,VTTS_b-3_1321-1568_1549.wav,7420,7709,-289
3340,b-3_3889-4000_3993.wav,VTTS_b-3_3889-4000_3993.wav,8420,8673,-253
3341,b-3_6900-7016_6998.wav,VTTS_b-3_6900-7016_6998.wav,16090,11610,4480
3342,b-2_203-304_285.wav,VTTS_b-2_203-304_285.wav,1600,1591,9
3343,b-3_4607-5008_4914.wav,VTTS_b-3_4607-5008_4914.wav,5930,6014,-84
3344,b-2_2413-2500_2464.wav,VTTS_b-2_2413-2500_2464.wav,1300,1324,-24
3345,b-3_4607-5008_4900.wav,VTTS_b-3_4607-5008_4900.wav,5250,4621,629
3346,b-4_2000-5164_4214.wav,VTTS_b-4_2000-5164_4214.wav,3738,3553,185
3347,b-1_3531-3631_3580.wav,VTTS_b-1_3531-3631_3580.wav,1850,1939,-89
3348,b-3_5745-5852_5782.wav,VTTS_b-3_5745-5852_5782.wav,6540,5143,1397
3349,b-4_1221-1300_1295.wav,VTTS_b-4_1221-1300_1295.wav,13300,11610,1690
3350,b-4_1601-1706_1649.wav,VTTS_b-4_1601-1706_1649.wav,4400,5689,-1289
3351,b-3_5745-5852_5840.wav,VTTS_b-3_5745-5852_5840.wav,4920,11610,-6690
3352,b-4_501-1014_818.wav,VTTS_b-4_501-1014_818.wav,6750,5712,1038
3353,b-1_579-649_594.wav,VTTS_b-1_579-649_594.wav,1880,1765,115
3354,b-4_2000-5164_5008.wav,VTTS_b-4_2000-5164_5008.wav,5865,4261,1604
3355,b-4_2000-5164_2149.wav,VTTS_b-4_2000-5164_2149.wav,4910,4690,220
3356,b-3_6274-6300_6290.wav,VTTS_b-3_6274-6300_6290.wav,5120,4841,279
3357,b-3_4607-5008_4994.wav,VTTS_b-3_4607-5008_4994.wav,5260,4435,825
3358,b-2_407-508_429.wav,VTTS_b-2_407-508_429.wav,1770,1660,110
3359,b-4_2000-5164_2379.wav,VTTS_b-4_2000-5164_2379.wav,1720,1556,164
3360,b-3_2177-2266_2194.wav,VTTS_b-3_2177-2266_2194.wav,8930,9183,-253
3361,b-4_501-1014_698.wav,VTTS_b-4_501-1014_698.wav,10950,10623,327
3362,b-3_1-97_60.wav,VTTS_b-3_1-97_60.wav,5950,4203,1747
3363,b-4_2000-5164_2739.wav,VTTS_b-4_2000-5164_2739.wav,5170,5178,-8
3364,b-1_3935-4033_3996.wav,VTTS_b-1_3935-4033_3996.wav,2960,3344,-384
3365,b-3_6701-6800_6767.wav,VTTS_b-3_6701-6800_6767.wav,7890,11610,-3720
3366,b-4_151-300_170.wav,VTTS_b-4_151-300_170.wav,8080,8243,-163
3367,b-3_2524-2854_2825.wav,VTTS_b-3_2524-2854_2825.wav,2730,2740,-10
3368,b-3_3803-3888_3823.wav,VTTS_b-3_3803-3888_3823.wav,7240,6838,402
3369,b-3_6701-6800_6716.wav,VTTS_b-3_6701-6800_6716.wav,5990,5166,824
3370,b-2_2311-2412_2311.wav,VTTS_b-2_2311-2412_2311.wav,1700,1370,330
3371,b-4_2000-5164_2260.wav,VTTS_b-4_2000-5164_2260.wav,3080,2705,375
3372,b-2_2209-2310_2253.wav,VTTS_b-2_2209-2310_2253.wav,1460,1985,-525
3373,b-1_1616-1716_1637.wav,VTTS_b-1_1616-1716_1637.wav,1210,1324,-114
3374,b-3_6701-6800_6744.wav,VTTS_b-3_6701-6800_6744.wav,5270,5259,11
3375,b-4_2000-5164_2900.wav,VTTS_b-4_2000-5164_2900.wav,6769,6536,233
3376,b-3_3715-3802_3782.wav,VTTS_b-3_3715-3802_3782.wav,4470,5074,-604
3377,b-4_1-52_11.wav,VTTS_b-4_1-52_11.wav,2180,2090,90
3378,b-3_2524-2854_2774.wav,VTTS_b-3_2524-2854_2774.wav,3350,3669,-319
3379,b-4_2000-5164_2424.wav,VTTS_b-4_2000-5164_2424.wav,5440,5503,-63
3380,b-3_5009-5427_5134.wav,VTTS_b-3_5009-5427_5134.wav,9080,8022,1058
3381,b-4_2000-5164_3146.wav,VTTS_b-4_2000-5164_3146.wav,3311,3309,2
3382,b-1_4034-4069_4042.wav,VTTS_b-1_4034-4069_4042.wav,2200,2554,-354
3383,b-1_1313-1413_1341.wav,VTTS_b-1_1313-1413_1341.wav,1740,1382,358
3384,b-3_5745-5852_5815.wav,VTTS_b-3_5745-5852_5815.wav,6280,7233,-953
3385,b-3_1321-1568_1472.wav,VTTS_b-3_1321-1568_1472.wav,5200,4470,730
3386,b-1_2927-3025_3017.wav,VTTS_b-1_2927-3025_3017.wav,1850,1556,294
3387,b-4_2000-5164_2939.wav,VTTS_b-4_2000-5164_2939.wav,4085,3773,312
3388,b-4_2000-5164_2395.wav,VTTS_b-4_2000-5164_2395.wav,7350,6966,384
3389,b-4_2000-5164_4485.wav,VTTS_b-4_2000-5164_4485.wav,3105,2786,319
3390,b-4_2000-5164_4343.wav,VTTS_b-4_2000-5164_4343.wav,5095,5956,-861
3391,b-2_2040-2072_2065.wav,VTTS_b-2_2040-2072_2065.wav,1230,1289,-59
3392,b-2_2413-2500_2432.wav,VTTS_b-2_2413-2500_2432.wav,3750,3135,615
3393,b-4_2000-5164_4039.wav,VTTS_b-4_2000-5164_4039.wav,4424,4342,82
3394,b-4_53-150_145.wav,VTTS_b-4_53-150_145.wav,6730,7779,-1049
3395,b-3_6900-7016_6991.wav,VTTS_b-3_6900-7016_6991.wav,7510,7860,-350
3396,b-4_2000-5164_3321.wav,VTTS_b-4_2000-5164_3321.wav,2199,2090,109
3397,b-3_3889-4000_3998.wav,VTTS_b-3_3889-4000_3998.wav,7320,6978,342
3398,b-4_2000-5164_2931.wav,VTTS_b-4_2000-5164_2931.wav,2996,2624,372
3399,b-1_4286-4321_4322.wav,VTTS_b-1_4286-4321_4322.wav,1420,1393,27
3400,b-4_2000-5164_4974.wav,VTTS_b-4_2000-5164_4974.wav,6648,6606,42
3401,b-4_2000-5164_3123.wav,VTTS_b-4_2000-5164_3123.wav,5018,4540,478
3402,b-3_3364-3453_3390.wav,VTTS_b-3_3364-3453_3390.wav,5530,4807,723
3403,b-3_6701-6800_6713.wav,VTTS_b-3_6701-6800_6713.wav,3270,2694,576
3404,b-3_5009-5427_5415.wav,VTTS_b-3_5009-5427_5415.wav,6050,5584,466
3405,b-1_4394-4429_4411.wav,VTTS_b-1_4394-4429_4411.wav,3300,3123,177
3406,b-3_5009-5427_5324.wav,VTTS_b-3_5009-5427_5324.wav,4200,4888,-688
3407,b-1_1717-1817_1796.wav,VTTS_b-1_1717-1817_1796.wav,1230,1231,-1
3408,b-4_2000-5164_3422.wav,VTTS_b-4_2000-5164_3422.wav,5128,5016,112
3409,b-4_2000-5164_4369.wav,VTTS_b-4_2000-5164_4369.wav,4126,4214,-88
3410,b-4_501-1014_665.wav,VTTS_b-4_501-1014_665.wav,8210,8231,-21
3411,b-3_6601-6700_6613.wav,VTTS_b-3_6601-6700_6613.wav,4950,4516,434
3412,b-4_1401-1505_1486.wav,VTTS_b-4_1401-1505_1486.wav,3570,3135,435
3413,b-3_4425-4497_4486.wav,VTTS_b-3_4425-4497_4486.wav,9460,11610,-2150
3414,b-1_794-1009_910.wav,VTTS_b-1_794-1009_910.wav,2620,2670,-50
3415,b-3_6301-6400_6314.wav,VTTS_b-3_6301-6400_6314.wav,2110,1858,252
3416,b-1_686-793_746.wav,VTTS_b-1_686-793_746.wav,960,1033,-73
3417,b-3_3889-4000_3984.wav,VTTS_b-3_3889-4000_3984.wav,3840,3564,276
3418,b-2_1019-1120_1035.wav,VTTS_b-2_1019-1120_1035.wav,1780,2670,-890
3419,b-3_3112-3197_3149.wav,VTTS_b-3_3112-3197_3149.wav,3960,3773,187
3420,b-3_3628-3714_3642.wav,VTTS_b-3_3628-3714_3642.wav,4610,4772,-162
3421,b-3_6801-6900_6864.wav,VTTS_b-3_6801-6900_6864.wav,3930,3947,-17
3422,b-3_2089-2176_2156.wav,VTTS_b-3_2089-2176_2156.wav,3520,3379,141
3423,b-1_3935-4033_3958.wav,VTTS_b-1_3935-4033_3958.wav,2400,2601,-201
3424,b-4_1401-1505_1440.wav,VTTS_b-4_1401-1505_1440.wav,2070,2078,-8
3425,b-1_1616-1716_1671.wav,VTTS_b-1_1616-1716_1671.wav,2900,3646,-746
3426,b-3_2089-2176_2143.wav,VTTS_b-3_2089-2176_2143.wav,4020,4389,-369
3427,b-3_2350-2433_2366.wav,VTTS_b-3_2350-2433_2366.wav,6720,7349,-629
3428,b-4_2000-5164_5088.wav,VTTS_b-4_2000-5164_5088.wav,1610,1707,-97
3429,b-3_3364-3453_3421.wav,VTTS_b-3_3364-3453_3421.wav,5550,4876,674
3430,b-4_1506-1600_1542.wav,VTTS_b-4_1506-1600_1542.wav,3730,3239,491
3431,b-3_2524-2854_2715.wav,VTTS_b-3_2524-2854_2715.wav,7180,6223,957
3432,b-2_815-916_904.wav,VTTS_b-2_815-916_904.wav,8330,10182,-1852
3433,b-4_2000-5164_4904.wav,VTTS_b-4_2000-5164_4904.wav,5426,5050,376
3434,b-1_2927-3025_2957.wav,VTTS_b-1_2927-3025_2957.wav,4210,4214,-4
3435,b-4_2000-5164_4643.wav,VTTS_b-4_2000-5164_4643.wav,5460,6060,-600
3436,b-3_6401-6500_6448.wav,VTTS_b-3_6401-6500_6448.wav,4490,4261,229
3437,b-1_2119-2219_2203.wav,VTTS_b-1_2119-2219_2203.wav,4110,3936,174
3438,b-4_1401-1505_1436.wav,VTTS_b-4_1401-1505_1436.wav,4590,4098,492
3439,b-4_2000-5164_4457.wav,VTTS_b-4_2000-5164_4457.wav,5630,6211,-581
3440,b-3_196-293_273.wav,VTTS_b-3_196-293_273.wav,4400,4017,383
3441,b-2_1903-2038_1983.wav,VTTS_b-2_1903-2038_1983.wav,2450,1556,894
3442,b-3_4207-4314_4268.wav,VTTS_b-3_4207-4314_4268.wav,5290,4923,367
3443,b-1_2321-2421_2367.wav,VTTS_b-1_2321-2421_2367.wav,2140,2020,120
3444,b-4_2000-5164_3477.wav,VTTS_b-4_2000-5164_3477.wav,2880,2659,221
3445,b-3_3628-3714_3636.wav,VTTS_b-3_3628-3714_3636.wav,3210,2984,226
3446,b-3_4315-4424_4407.wav,VTTS_b-3_4315-4424_4407.wav,4370,4621,-251
3447,b-3_1321-1568_1323.wav,VTTS_b-3_1321-1568_1323.wav,4010,3320,690
3448,b-4_2000-5164_3308.wav,VTTS_b-4_2000-5164_3308.wav,1606,2531,-925
3449,b-4_301-400_396.wav,VTTS_b-4_301-400_396.wav,1130,1091,39
3450,b-4_1301-1400_1332.wav,VTTS_b-4_1301-1400_1332.wav,6400,6745,-345
3451,b-3_5533-5638_5562.wav,VTTS_b-3_5533-5638_5562.wav,2290,1765,525
3452,b-3_3628-3714_3698.wav,VTTS_b-3_3628-3714_3698.wav,2670,2554,116
3453,b-4_1301-1400_1377.wav,VTTS_b-4_1301-1400_1377.wav,2620,2531,89
3454,b-2_917-1018_952.wav,VTTS_b-2_917-1018_952.wav,4220,4261,-41
3455,b-1_2119-2219_2193.wav,VTTS_b-1_2119-2219_2193.wav,1460,1265,195
3456,b-1_3228-3328_3249.wav,VTTS_b-1_3228-3328_3249.wav,2790,3959,-1169
3457,b-4_2000-5164_3970.wav,VTTS_b-4_2000-5164_3970.wav,2117,2229,-112
3458,b-2_1427-1562_1564.wav,VTTS_b-2_1427-1562_1564.wav,4300,4075,225
3459,b-4_2000-5164_3090.wav,VTTS_b-4_2000-5164_3090.wav,1664,1393,271
3460,b-4_2000-5164_3448.wav,VTTS_b-4_2000-5164_3448.wav,4801,4934,-133
3461,b-3_2177-2266_2215.wav,VTTS_b-3_2177-2266_2215.wav,2680,2310,370
3462,b-4_501-1014_1007.wav,VTTS_b-4_501-1014_1007.wav,3430,3262,168
3463,b-4_501-1014_792.wav,VTTS_b-4_501-1014_792.wav,5530,5213,317
3464,b-3_1764-1861_1857.wav,VTTS_b-3_1764-1861_1857.wav,4690,5016,-326
3465,b-1_276-376_324.wav,VTTS_b-1_276-376_324.wav,2520,3599,-1079
3466,b-4_1506-1600_1586.wav,VTTS_b-4_1506-1600_1586.wav,8210,7628,582
3467,b-2_203-304_211.wav,VTTS_b-2_203-304_211.wav,2100,1916,184
3468,b-3_2943-3024_2977.wav,VTTS_b-3_2943-3024_2977.wav,3770,4098,-328
3469,b-2_2107-2193_2112.wav,VTTS_b-2_2107-2193_2112.wav,1720,1579,141
3470,b-1_4430-4465_4446.wav,VTTS_b-1_4430-4465_4446.wav,1340,1370,-30
3471,b-1_4106-4141_4107.wav,VTTS_b-1_4106-4141_4107.wav,4680,5201,-521
3472,b-1_3632-3732_3709.wav,VTTS_b-1_3632-3732_3709.wav,1320,1207,113
3473,b-3_5533-5638_5601.wav,VTTS_b-3_5533-5638_5601.wav,10680,11053,-373
3474,b-1_74-174_171.wav,VTTS_b-1_74-174_171.wav,3090,2821,269
3475,b-4_2000-5164_3880.wav,VTTS_b-4_2000-5164_3880.wav,5179,6687,-1508
3476,b-4_2000-5164_2946.wav,VTTS_b-4_2000-5164_2946.wav,4980,4934,46
3477,b-4_2000-5164_2287.wav,VTTS_b-4_2000-5164_2287.wav,4060,3715,345
3478,b-4_2000-5164_4967.wav,VTTS_b-4_2000-5164_4967.wav,4173,3796,377
3479,b-3_2524-2854_2589.wav,VTTS_b-3_2524-2854_2589.wav,7400,6978,422
3480,b-1_1515-1615_1528.wav,VTTS_b-1_1515-1615_1528.wav,4350,4005,345
3481,b-4_2000-5164_4614.wav,VTTS_b-4_2000-5164_4614.wav,2325,2032,293
3482,b-4_1101-1220_1124.wav,VTTS_b-4_1101-1220_1124.wav,11780,11610,170
3483,b-2_1801-1902_1897.wav,VTTS_b-2_1801-1902_1897.wav,930,940,-10
3484,b-3_2177-2266_2207.wav,VTTS_b-3_2177-2266_2207.wav,6310,6293,17
3485,b-2_1-100_80.wav,VTTS_b-2_1-100_80.wav,1640,1451,189
3486,b-4_1506-1600_1577.wav,VTTS_b-4_1506-1600_1577.wav,6460,6397,63
3487,b-4_2000-5164_5094.wav,VTTS_b-4_2000-5164_5094.wav,4179,4145,34
3488,b-2_1325-1426_1343.wav,VTTS_b-2_1325-1426_1343.wav,4410,3889,521
3489,b-1_794-1009_913.wav,VTTS_b-1_794-1009_913.wav,3320,3460,-140
3490,b-1_2018-2118_2096.wav,VTTS_b-1_2018-2118_2096.wav,2940,2612,328
3491,b-1_2119-2219_2194.wav,VTTS_b-1_2119-2219_2194.wav,2420,3471,-1051
3492,b-2_1427-1562_1550.wav,VTTS_b-2_1427-1562_1550.wav,5540,6165,-625
3493,b-4_2000-5164_4881.wav,VTTS_b-4_2000-5164_4881.wav,1315,1265,50
3494,b-2_1563-1596_1581.wav,VTTS_b-2_1563-1596_1581.wav,3300,2310,990
3495,b-3_1321-1568_1446.wav,VTTS_b-3_1321-1568_1446.wav,3190,3077,113
3496,b-4_2000-5164_3499.wav,VTTS_b-4_2000-5164_3499.wav,8743,8452,291
3497,b-1_2725-2825_2813.wav,VTTS_b-1_2725-2825_2813.wav,2830,2543,287
3498,b-3_4104-4206_4140.wav,VTTS_b-3_4104-4206_4140.wav,5090,5155,-65
3499,b-4_2000-5164_2342.wav,VTTS_b-4_2000-5164_2342.wav,6530,6211,319
3500,b-3_6016-6115_6093.wav,VTTS_b-3_6016-6115_6093.wav,7720,7326,394
3501,b-3_6900-7016_6964.wav,VTTS_b-3_6900-7016_6964.wav,3450,3599,-149
3502,b-4_1601-1706_1679.wav,VTTS_b-4_1601-1706_1679.wav,5670,4795,875
3503,b-3_2434-2523_2443.wav,VTTS_b-3_2434-2523_2443.wav,3900,3994,-94
3504,b-1_794-1009_984.wav,VTTS_b-1_794-1009_984.wav,1780,1707,73
3505,b-3_5009-5427_5041.wav,VTTS_b-3_5009-5427_5041.wav,10170,9636,534
3506,b-3_2350-2433_2389.wav,VTTS_b-3_2350-2433_2389.wav,11450,11610,-160
3507,b-2_815-916_847.wav,VTTS_b-2_815-916_847.wav,3560,3564,-4
3508,b-4_2000-5164_2933.wav,VTTS_b-4_2000-5164_2933.wav,9523,9323,200
3509,b-1_3127-3227_3199.wav,VTTS_b-1_3127-3227_3199.wav,2630,2322,308
3510,b-1_4178-4213_4194.wav,VTTS_b-1_4178-4213_4194.wav,3800,3773,27
3511,b-2_1597-1698_1615.wav,VTTS_b-2_1597-1698_1615.wav,2950,2705,245
3512,b-3_5009-5427_5253.wav,VTTS_b-3_5009-5427_5253.wav,5260,5166,94
3513,b-1_2624-2724_2657.wav,VTTS_b-1_2624-2724_2657.wav,2800,5457,-2657
3514,b-1_3329-3429_3341.wav,VTTS_b-1_3329-3429_3341.wav,3240,3053,187
3515,b-2_1597-1698_1676.wav,VTTS_b-2_1597-1698_1676.wav,8800,11610,-2810
3516,b-3_294-391_384.wav,VTTS_b-3_294-391_384.wav,3220,3065,155
3517,b-2_1801-1902_1847.wav,VTTS_b-2_1801-1902_1847.wav,1850,1556,294
3518,b-3_1079-1320_1262.wav,VTTS_b-3_1079-1320_1262.wav,9350,8429,921
3519,b-1_650-685_680.wav,VTTS_b-1_650-685_680.wav,1910,1858,52
3520,b-4_501-1014_732.wav,VTTS_b-4_501-1014_732.wav,3870,3901,-31
3521,b-3_501-930_541.wav,VTTS_b-3_501-930_541.wav,6060,5573,487
3522,b-4_1901-2000_1957.wav,VTTS_b-4_1901-2000_1957.wav,5880,4981,899
3523,b-3_2524-2854_2788.wav,VTTS_b-3_2524-2854_2788.wav,9800,8835,965
3524,b-1_2220-2320_2320.wav,VTTS_b-1_2220-2320_2320.wav,3620,4180,-560
3525,b-3_5009-5427_5089.wav,VTTS_b-3_5009-5427_5089.wav,10560,9613,947
3526,b-2_713-814_772.wav,VTTS_b-2_713-814_772.wav,1840,2229,-389
3527,b-4_2000-5164_2753.wav,VTTS_b-4_2000-5164_2753.wav,1390,1358,32
3528,b-3_392-500_458.wav,VTTS_b-3_392-500_458.wav,8960,9358,-398
3529,b-3_4607-5008_4872.wav,VTTS_b-3_4607-5008_4872.wav,5630,5155,475
3530,b-4_1814-1900_1871.wav,VTTS_b-4_1814-1900_1871.wav,2620,2717,-97
3531,b-1_2725-2825_2787.wav,VTTS_b-1_2725-2825_2787.wav,3770,3576,194
3532,b-4_501-1014_835.wav,VTTS_b-4_501-1014_835.wav,5010,4528,482
3533,b-3_3715-3802_3730.wav,VTTS_b-3_3715-3802_3730.wav,3330,3193,137
3534,b-1_74-174_140.wav,VTTS_b-1_74-174_140.wav,4420,4644,-224
3535,b-4_2000-5164_4467.wav,VTTS_b-4_2000-5164_4467.wav,7343,7059,284
3536,b-3_4498-4605_4559.wav,VTTS_b-3_4498-4605_4559.wav,6290,6420,-130
3537,b-3_1321-1568_1440.wav,VTTS_b-3_1321-1568_1440.wav,4670,6037,-1367
3538,b-1_2220-2320_2259.wav,VTTS_b-1_2220-2320_2259.wav,1630,1649,-19
3539,b-3_2267-2349_2271.wav,VTTS_b-3_2267-2349_2271.wav,3310,3309,1
3540,b-3_3889-4000_3890.wav,VTTS_b-3_3889-4000_3890.wav,5140,5364,-224
3541,b-1_2826-2926_2848.wav,VTTS_b-1_2826-2926_2848.wav,1560,1544,16
3542,b-2_1223-1324_1324.wav,VTTS_b-2_1223-1324_1324.wav,7430,10275,-2845
3543,b-3_2524-2854_2707.wav,VTTS_b-3_2524-2854_2707.wav,4230,5863,-1633
3544,b-4_2000-5164_4632.wav,VTTS_b-4_2000-5164_4632.wav,3670,3553,117
3545,b-3_4207-4314_4227.wav,VTTS_b-3_4207-4314_4227.wav,6480,6002,478
3546,b-3_4001-4103_4041.wav,VTTS_b-3_4001-4103_4041.wav,5270,4760,510
3547,b-3_2267-2349_2274.wav,VTTS_b-3_2267-2349_2274.wav,3150,2844,306
3548,b-3_5009-5427_5312.wav,VTTS_b-3_5009-5427_5312.wav,5270,4737,533
3549,b-3_2350-2433_2430.wav,VTTS_b-3_2350-2433_2430.wav,5540,6165,-625
3550,b-3_196-293_236.wav,VTTS_b-3_196-293_236.wav,4820,4412,408
3551,b-4_2000-5164_4461.wav,VTTS_b-4_2000-5164_4461.wav,7486,7419,67
3552,b-4_2000-5164_3163.wav,VTTS_b-4_2000-5164_3163.wav,6196,7918,-1722
3553,b-2_1223-1324_1274.wav,VTTS_b-2_1223-1324_1274.wav,2860,2368,492
3554,b-1_3430-3530_3461.wav,VTTS_b-1_3430-3530_3461.wav,2220,2241,-21
3555,b-3_501-930_576.wav,VTTS_b-3_501-930_576.wav,5730,5143,587
3556,b-3_3715-3802_3750.wav,VTTS_b-3_3715-3802_3750.wav,5270,5631,-361
3557,b-4_2000-5164_4376.wav,VTTS_b-4_2000-5164_4376.wav,2094,1683,411
3558,b-4_2000-5164_4373.wav,VTTS_b-4_2000-5164_4373.wav,2658,2543,115
3559,b-3_6900-7016_6999.wav,VTTS_b-3_6900-7016_6999.wav,3020,3913,-893
3560,b-1_2826-2926_2889.wav,VTTS_b-1_2826-2926_2889.wav,1770,1823,-53
3561,b-4_1814-1900_1816.wav,VTTS_b-4_1814-1900_1816.wav,4590,4238,352
3562,b-1_3531-3631_3559.wav,VTTS_b-1_3531-3631_3559.wav,4430,4122,308
3563,b-2_2209-2310_2225.wav,VTTS_b-2_2209-2310_2225.wav,1550,1498,52
3564,b-3_3364-3453_3401.wav,VTTS_b-3_3364-3453_3401.wav,6380,5759,621
3565,b-2_611-712_710.wav,VTTS_b-2_611-712_710.wav,2190,1939,251
3566,b-3_1666-1763_1710.wav,VTTS_b-3_1666-1763_1710.wav,6160,5770,390
3567,b-3_5853-5956_5853.wav,VTTS_b-3_5853-5956_5853.wav,9590,9822,-232
3568,b-3_5009-5427_5351.wav,VTTS_b-3_5009-5427_5351.wav,6080,6142,-62
3569,b-4_501-1014_801.wav,VTTS_b-4_501-1014_801.wav,7970,9067,-1097
3570,b-1_1313-1413_1415.wav,VTTS_b-1_1313-1413_1415.wav,3670,3587,83
3571,b-1_2725-2825_2761.wav,VTTS_b-1_2725-2825_2761.wav,3270,3460,-190
3572,b-1_3632-3732_3660.wav,VTTS_b-1_3632-3732_3660.wav,1320,1416,-96
3573,b-3_5428-5533_5513.wav,VTTS_b-3_5428-5533_5513.wav,2130,2345,-215
3574,b-4_501-1014_915.wav,VTTS_b-4_501-1014_915.wav,6800,9079,-2279
3575,b-1_2119-2219_2121.wav,VTTS_b-1_2119-2219_2121.wav,2190,2241,-51
3576,b-1_3127-3227_3137.wav,VTTS_b-1_3127-3227_3137.wav,4280,4307,-27
3577,b-1_686-793_747.wav,VTTS_b-1_686-793_747.wav,3650,3657,-7
3578,b-2_1563-1596_1594.wav,VTTS_b-2_1563-1596_1594.wav,5310,3680,1630
3579,b-2_1-100_25.wav,VTTS_b-2_1-100_25.wav,2080,2752,-672
3580,b-3_501-930_843.wav,VTTS_b-3_501-930_843.wav,7160,6525,635
3581,b-3_3025-3111_3069.wav,VTTS_b-3_3025-3111_3069.wav,7080,7117,-37
3582,b-4_2000-5164_3566.wav,VTTS_b-4_2000-5164_3566.wav,6706,6536,170
3583,b-2_1427-1562_1526.wav,VTTS_b-2_1427-1562_1526.wav,5290,5538,-248
3584,b-3_98-195_178.wav,VTTS_b-3_98-195_178.wav,6180,5538,642
3585,b-3_3538-3627_3611.wav,VTTS_b-3_3538-3627_3611.wav,7150,6687,463
3586,b-1_3834-3934_3915.wav,VTTS_b-1_3834-3934_3915.wav,1250,1161,89
3587,b-3_3715-3802_3787.wav,VTTS_b-3_3715-3802_3787.wav,1980,1916,64
3588,b-3_2089-2176_2106.wav,VTTS_b-3_2089-2176_2106.wav,4530,3936,594
3589,b-4_1901-2000_1995.wav,VTTS_b-4_1901-2000_1995.wav,5120,4586,534
3590,b-1_794-1009_909.wav,VTTS_b-1_794-1009_909.wav,1200,1486,-286
3591,b-4_1901-2000_1971.wav,VTTS_b-4_1901-2000_1971.wav,6720,5735,985
3592,b-3_2350-2433_2357.wav,VTTS_b-3_2350-2433_2357.wav,3710,3332,378
3593,b-4_2000-5164_3819.wav,VTTS_b-4_2000-5164_3819.wav,1554,1440,114
3594,b-4_2000-5164_2173.wav,VTTS_b-4_2000-5164_2173.wav,4375,5271,-896
3595,b-3_6301-6400_6319.wav,VTTS_b-3_6301-6400_6319.wav,6340,5770,570
3596,b-4_501-1014_629.wav,VTTS_b-4_501-1014_629.wav,1270,1115,155
3597,b-4_2000-5164_5136.wav,VTTS_b-4_2000-5164_5136.wav,5388,5538,-150
3598,b-1_579-649_632.wav,VTTS_b-1_579-649_632.wav,1720,1672,48
3599,b-1_478-578_547.wav,VTTS_b-1_478-578_547.wav,1610,1858,-248
3600,b-3_1-97_23.wav,VTTS_b-3_1-97_23.wav,3400,2995,405
3601,b-3_4207-4314_4230.wav,VTTS_b-3_4207-4314_4230.wav,5480,5155,325
3602,b-1_686-793_744.wav,VTTS_b-1_686-793_744.wav,5130,4563,567
3603,b-2_203-304_218.wav,VTTS_b-2_203-304_218.wav,2160,2078,82
3604,b-3_1321-1568_1517.wav,VTTS_b-3_1321-1568_1517.wav,3760,4156,-396
3605,b-3_294-391_386.wav,VTTS_b-3_294-391_386.wav,6380,6200,180
3606,b-3_1862-1959_1928.wav,VTTS_b-3_1862-1959_1928.wav,8100,7628,472
3607,b-3_4607-5008_4903.wav,VTTS_b-3_4607-5008_4903.wav,1080,1080,0
3608,b-4_1601-1706_1701.wav,VTTS_b-4_1601-1706_1701.wav,3630,3471,159
3609,b-1_4178-4213_4187.wav,VTTS_b-1_4178-4213_4187.wav,1780,1962,-182
3610,b-4_2000-5164_2124.wav,VTTS_b-4_2000-5164_2124.wav,7520,7999,-479
3611,b-1_1111-1211_1145.wav,VTTS_b-1_1111-1211_1145.wav,2330,2020,310
3612,b-4_2000-5164_2437.wav,VTTS_b-4_2000-5164_2437.wav,3080,2949,131
3613,b-4_1221-1300_1272.wav,VTTS_b-4_1221-1300_1272.wav,3380,3262,118
3614,b-1_3733-3833_3818.wav,VTTS_b-1_3733-3833_3818.wav,1130,1080,50
3615,b-3_1764-1861_1849.wav,VTTS_b-3_1764-1861_1849.wav,6970,6664,306
3616,b-1_2927-3025_2941.wav,VTTS_b-1_2927-3025_2941.wav,4000,3843,157
3617,b-1_3228-3328_3269.wav,VTTS_b-1_3228-3328_3269.wav,1810,1834,-24
3618,b-3_2177-2266_2211.wav,VTTS_b-3_2177-2266_2211.wav,5590,6293,-703
3619,b-4_1707-1813_1738.wav,VTTS_b-4_1707-1813_1738.wav,1140,1115,25
3620,b-1_377-477_425.wav,VTTS_b-1_377-477_425.wav,3090,3448,-358
3621,b-3_1079-1320_1240.wav,VTTS_b-3_1079-1320_1240.wav,1760,1846,-86
3622,b-3_5009-5427_5081.wav,VTTS_b-3_5009-5427_5081.wav,8350,7477,873
3623,b-3_5853-5956_5881.wav,VTTS_b-3_5853-5956_5881.wav,5090,4957,133
3624,b-1_4034-4069_4044.wav,VTTS_b-1_4034-4069_4044.wav,5380,5364,16
3625,b-3_5428-5533_5479.wav,VTTS_b-3_5428-5533_5479.wav,4310,3715,595
3626,b-4_2000-5164_4464.wav,VTTS_b-4_2000-5164_4464.wav,5694,6409,-715
3627,b-3_3198-3278_3203.wav,VTTS_b-3_3198-3278_3203.wav,1790,1707,83
3628,b-4_2000-5164_5056.wav,VTTS_b-4_2000-5164_5056.wav,8310,8290,20
3629,b-3_5009-5427_5233.wav,VTTS_b-3_5009-5427_5233.wav,4310,5805,-1495
3630,b-3_4315-4424_4354.wav,VTTS_b-3_4315-4424_4354.wav,5490,6235,-745
3631,b-4_2000-5164_3822.wav,VTTS_b-4_2000-5164_3822.wav,5078,5190,-112
3632,b-4_2000-5164_2565.wav,VTTS_b-4_2000-5164_2565.wav,6440,6455,-15
3633,b-4_1401-1505_1465.wav,VTTS_b-4_1401-1505_1465.wav,9150,8824,326
3634,b-3_1-97_36.wav,VTTS_b-3_1-97_36.wav,2850,2694,156
3635,b-4_2000-5164_4440.wav,VTTS_b-4_2000-5164_4440.wav,1741,1660,81
3636,b-1_2826-2926_2904.wav,VTTS_b-1_2826-2926_2904.wav,4810,4540,270
3637,b-2_713-814_807.wav,VTTS_b-2_713-814_807.wav,1900,1730,170
3638,b-3_4315-4424_4396.wav,VTTS_b-3_4315-4424_4396.wav,6960,6513,447
3639,b-1_1-73_36.wav,VTTS_b-1_1-73_36.wav,1440,1405,35
3640,b-4_1901-2000_1936.wav,VTTS_b-4_1901-2000_1936.wav,3540,3425,115
3641,b-3_1568-1665_1573.wav,VTTS_b-3_1568-1665_1573.wav,5700,5329,371
3642,b-3_4607-5008_4677.wav,VTTS_b-3_4607-5008_4677.wav,5910,6142,-232
3643,b-4_2000-5164_2659.wav,VTTS_b-4_2000-5164_2659.wav,2450,2647,-197
3644,b-1_2523-2623_2561.wav,VTTS_b-1_2523-2623_2561.wav,1730,1858,-128
3645,b-3_3279-3363_3340.wav,VTTS_b-3_3279-3363_3340.wav,6790,6745,45
3646,b-1_276-376_361.wav,VTTS_b-1_276-376_361.wav,1480,1591,-111
3647,b-4_2000-5164_4064.wav,VTTS_b-4_2000-5164_4064.wav,4601,4505,96
3648,b-4_2000-5164_3794.wav,VTTS_b-4_2000-5164_3794.wav,2420,2218,202
3649,b-3_6801-6900_6807.wav,VTTS_b-3_6801-6900_6807.wav,11330,10670,660
3650,b-3_501-930_825.wav,VTTS_b-3_501-930_825.wav,12600,11505,1095
3651,b-3_2177-2266_2232.wav,VTTS_b-3_2177-2266_2232.wav,4210,4122,88
3652,b-2_1019-1120_1110.wav,VTTS_b-2_1019-1120_1110.wav,6940,6606,334
3653,b-2_1427-1562_1485.wav,VTTS_b-2_1427-1562_1485.wav,2750,2519,231
3654,b-4_2000-5164_3407.wav,VTTS_b-4_2000-5164_3407.wav,8176,8278,-102
3655,b-4_2000-5164_4810.wav,VTTS_b-4_2000-5164_4810.wav,3635,3611,24
3656,b-2_2311-2412_2313.wav,VTTS_b-2_2311-2412_2313.wav,4920,4307,613
3657,b-4_1601-1706_1694.wav,VTTS_b-4_1601-1706_1694.wav,5620,6734,-1114
3658,b-3_392-500_472.wav,VTTS_b-3_392-500_472.wav,10370,10437,-67
3659,b-4_53-150_128.wav,VTTS_b-4_53-150_128.wav,8020,8220,-200
3660,b-4_2000-5164_2758.wav,VTTS_b-4_2000-5164_2758.wav,4430,4331,99
3661,b-1_4430-4465_4453.wav,VTTS_b-1_4430-4465_4453.wav,1570,1533,37
3662,b-3_3715-3802_3748.wav,VTTS_b-3_3715-3802_3748.wav,6560,6908,-348
3663,b-1_2018-2118_2037.wav,VTTS_b-1_2018-2118_2037.wav,5260,6269,-1009
3664,b-1_1515-1615_1553.wav,VTTS_b-1_1515-1615_1553.wav,1170,1149,21
3665,b-4_501-1014_680.wav,VTTS_b-4_501-1014_680.wav,1360,1324,36
3666,b-3_3025-3111_3075.wav,VTTS_b-3_3025-3111_3075.wav,7410,7663,-253
3667,b-4_2000-5164_2937.wav,VTTS_b-4_2000-5164_2937.wav,11658,11076,582
3668,b-2_611-712_612.wav,VTTS_b-2_611-712_612.wav,1150,1115,35
3669,b-1_2927-3025_2953.wav,VTTS_b-1_2927-3025_2953.wav,3040,3611,-571
3670,b-3_5009-5427_5379.wav,VTTS_b-3_5009-5427_5379.wav,3240,2821,419
3671,b-1_2725-2825_2747.wav,VTTS_b-1_2725-2825_2747.wav,1850,2438,-588
3672,b-1_1717-1817_1782.wav,VTTS_b-1_1717-1817_1782.wav,2340,3750,-1410
3673,b-3_98-195_124.wav,VTTS_b-3_98-195_124.wav,6250,6432,-182
3674,b-1_276-376_326.wav,VTTS_b-1_276-376_326.wav,1660,1649,11
3675,b-1_2523-2623_2526.wav,VTTS_b-1_2523-2623_2526.wav,2760,3065,-305
3676,b-3_6601-6700_6636.wav,VTTS_b-3_6601-6700_6636.wav,2500,2334,166
3677,b-1_2927-3025_3019.wav,VTTS_b-1_2927-3025_3019.wav,1760,1800,-40
3678,b-1_3935-4033_3943.wav,VTTS_b-1_3935-4033_3943.wav,1590,1602,-12
3679,b-4_2000-5164_4988.wav,VTTS_b-4_2000-5164_4988.wav,3238,3599,-361
3680,b-1_2422-2522_2468.wav,VTTS_b-1_2422-2522_2468.wav,1590,1649,-59
3681,b-4_2000-5164_2965.wav,VTTS_b-4_2000-5164_2965.wav,6313,6072,241
3682,b-3_6401-6500_6425.wav,VTTS_b-3_6401-6500_6425.wav,2970,3077,-107
3683,b-4_2000-5164_4817.wav,VTTS_b-4_2000-5164_4817.wav,8908,7535,1373
3684,b-3_4104-4206_4157.wav,VTTS_b-3_4104-4206_4157.wav,6060,6002,58
3685,b-4_2000-5164_3475.wav,VTTS_b-4_2000-5164_3475.wav,4978,5248,-270
3686,b-3_6501-6600_6531.wav,VTTS_b-3_6501-6600_6531.wav,1620,1625,-5
3687,b-3_2524-2854_2709.wav,VTTS_b-3_2524-2854_2709.wav,5140,6142,-1002
3688,b-4_1707-1813_1750.wav,VTTS_b-4_1707-1813_1750.wav,7700,6873,827
3689,b-4_2000-5164_3200.wav,VTTS_b-4_2000-5164_3200.wav,3446,3762,-316
3690,b-3_3803-3888_3821.wav,VTTS_b-3_3803-3888_3821.wav,5590,5271,319
3691,b-1_377-477_458.wav,VTTS_b-1_377-477_458.wav,1700,2043,-343
3692,b-2_1801-1902_1861.wav,VTTS_b-2_1801-1902_1861.wav,2380,1950,430
3693,b-3_1321-1568_1452.wav,VTTS_b-3_1321-1568_1452.wav,4650,4389,261
3694,b-3_6116-6215_6209.wav,VTTS_b-3_6116-6215_6209.wav,4810,5550,-740
3695,b-3_1321-1568_1504.wav,VTTS_b-3_1321-1568_1504.wav,2000,2020,-20
3696,b-4_1901-2000_1930.wav,VTTS_b-4_1901-2000_1930.wav,6660,6072,588
3697,b-3_1079-1320_1254.wav,VTTS_b-3_1079-1320_1254.wav,6040,5027,1013
3698,b-3_294-391_356.wav,VTTS_b-3_294-391_356.wav,7890,7976,-86
3699,b-4_2000-5164_2619.wav,VTTS_b-4_2000-5164_2619.wav,8575,8429,146
3700,b-1_2927-3025_3003.wav,VTTS_b-1_2927-3025_3003.wav,1260,1335,-75
3701,b-3_2177-2266_2248.wav,VTTS_b-3_2177-2266_2248.wav,4960,4911,49
3702,b-1_2624-2724_2650.wav,VTTS_b-1_2624-2724_2650.wav,5000,5039,-39
3703,b-2_2073-2106_2089.wav,VTTS_b-2_2073-2106_2089.wav,1150,1161,-11
3704,b-1_1515-1615_1554.wav,VTTS_b-1_1515-1615_1554.wav,1480,1533,-53
3705,b-4_2000-5164_3346.wav,VTTS_b-4_2000-5164_3346.wav,7022,7303,-281
3706,b-4_1014-1100_1028.wav,VTTS_b-4_1014-1100_1028.wav,8230,11610,-3380
3707,b-2_203-304_281.wav,VTTS_b-2_203-304_281.wav,3100,2984,116
3708,b-1_3430-3530_3500.wav,VTTS_b-1_3430-3530_3500.wav,1810,2067,-257
3709,b-1_377-477_475.wav,VTTS_b-1_377-477_475.wav,2070,2357,-287
3710,b-1_2321-2421_2405.wav,VTTS_b-1_2321-2421_2405.wav,2740,2473,267
3711,b-4_2000-5164_2381.wav,VTTS_b-4_2000-5164_2381.wav,1540,1776,-236
3712,b-3_2000-2088_2081.wav,VTTS_b-3_2000-2088_2081.wav,8070,7709,361
3713,b-4_2000-5164_2747.wav,VTTS_b-4_2000-5164_2747.wav,2565,2531,34
3714,b-3_5745-5852_5786.wav,VTTS_b-3_5745-5852_5786.wav,6550,5875,675
3715,b-3_5009-5427_5207.wav,VTTS_b-3_5009-5427_5207.wav,3820,4040,-220
3716,b-1_1515-1615_1525.wav,VTTS_b-1_1515-1615_1525.wav,1610,2194,-584
3717,b-2_2311-2412_2350.wav,VTTS_b-2_2311-2412_2350.wav,1120,1022,98
3718,b-3_4607-5008_4695.wav,VTTS_b-3_4607-5008_4695.wav,4800,4632,168
3719,b-2_509-610_512.wav,VTTS_b-2_509-610_512.wav,1020,1068,-48
3720,b-3_501-930_642.wav,VTTS_b-3_501-930_642.wav,4880,4656,224
3721,b-3_931-979_978.wav,VTTS_b-3_931-979_978.wav,4020,4052,-32
3722,b-3_3112-3197_3167.wav,VTTS_b-3_3112-3197_3167.wav,5560,5608,-48
3723,b-4_2000-5164_3752.wav,VTTS_b-4_2000-5164_3752.wav,2560,2496,64
3724,b-4_2000-5164_2979.wav,VTTS_b-4_2000-5164_2979.wav,5155,5294,-139
3725,b-3_5639-5744_5675.wav,VTTS_b-3_5639-5744_5675.wav,5700,6327,-627
3726,b-3_1079-1320_1232.wav,VTTS_b-3_1079-1320_1232.wav,8430,8313,117
3727,b-1_478-578_533.wav,VTTS_b-1_478-578_533.wav,3270,4180,-910
3728,b-2_713-814_799.wav,VTTS_b-2_713-814_799.wav,2280,2380,-100
3729,b-3_1764-1861_1847.wav,VTTS_b-3_1764-1861_1847.wav,11500,11610,-110
3730,b-4_2000-5164_4330.wav,VTTS_b-4_2000-5164_4330.wav,4294,3994,300
3731,b-1_1111-1211_1165.wav,VTTS_b-1_1111-1211_1165.wav,1770,1718,52
3732,b-4_2000-5164_4272.wav,VTTS_b-4_2000-5164_4272.wav,3487,3599,-112
3733,b-3_4607-5008_4760.wav,VTTS_b-3_4607-5008_4760.wav,5210,5341,-131
3734,b-1_3430-3530_3479.wav,VTTS_b-1_3430-3530_3479.wav,1300,1393,-93
3735,b-2_203-304_215.wav,VTTS_b-2_203-304_215.wav,1940,3158,-1218
3736,b-3_5957-6015_5990.wav,VTTS_b-3_5957-6015_5990.wav,6380,6711,-331
3737,b-4_501-1014_754.wav,VTTS_b-4_501-1014_754.wav,2330,1962,368
3738,b-1_175-275_193.wav,VTTS_b-1_175-275_193.wav,1150,975,175
3739,b-1_2927-3025_3023.wav,VTTS_b-1_2927-3025_3023.wav,4690,4191,499
3740,b-3_3538-3627_3554.wav,VTTS_b-3_3538-3627_3554.wav,2640,2891,-251
3741,b-3_3198-3278_3205.wav,VTTS_b-3_3198-3278_3205.wav,2580,2566,14
3742,b-3_3538-3627_3599.wav,VTTS_b-3_3538-3627_3599.wav,4830,6223,-1393
3743,b-3_196-293_266.wav,VTTS_b-3_196-293_266.wav,6690,7140,-450
3744,b-3_2524-2854_2590.wav,VTTS_b-3_2524-2854_2590.wav,2770,2833,-63
3745,b-3_1079-1320_1114.wav,VTTS_b-3_1079-1320_1114.wav,7350,6362,988
3746,b-4_2000-5164_3304.wav,VTTS_b-4_2000-5164_3304.wav,2968,3471,-503
3747,b-4_2000-5164_5112.wav,VTTS_b-4_2000-5164_5112.wav,6783,11610,-4827
3748,b-3_1079-1320_1163.wav,VTTS_b-3_1079-1320_1163.wav,5320,5236,84
3749,b-3_2524-2854_2537.wav,VTTS_b-3_2524-2854_2537.wav,3760,3947,-187
3750,b-4_2000-5164_3264.wav,VTTS_b-4_2000-5164_3264.wav,11858,11610,248
3751,b-4_2000-5164_3127.wav,VTTS_b-4_2000-5164_3127.wav,13607,11610,1997
3752,b-4_2000-5164_2235.wav,VTTS_b-4_2000-5164_2235.wav,1820,1718,102
3753,b-4_1601-1706_1695.wav,VTTS_b-4_1601-1706_1695.wav,1890,1591,299
3754,b-4_2000-5164_2950.wav,VTTS_b-4_2000-5164_2950.wav,2051,1834,217
3755,b-1_175-275_258.wav,VTTS_b-1_175-275_258.wav,2940,2821,119
3756,b-1_2018-2118_2045.wav,VTTS_b-1_2018-2118_2045.wav,3380,3680,-300
3757,b-4_2000-5164_4727.wav,VTTS_b-4_2000-5164_4727.wav,1755,1498,257
3758,b-3_3803-3888_3873.wav,VTTS_b-3_3803-3888_3873.wav,8180,7338,842
3759,b-2_101-202_201.wav,VTTS_b-2_101-202_201.wav,1870,2694,-824
3760,b-4_2000-5164_2089.wav,VTTS_b-4_2000-5164_2089.wav,5630,6002,-372
3761,b-3_2855-2942_2870.wav,VTTS_b-3_2855-2942_2870.wav,4400,4540,-140
3762,b-3_3538-3627_3573.wav,VTTS_b-3_3538-3627_3573.wav,4430,4307,123
3763,b-1_3834-3934_3844.wav,VTTS_b-1_3834-3934_3844.wav,2400,2287,113
3764,b-1_2119-2219_2198.wav,VTTS_b-1_2119-2219_2198.wav,3280,2984,296
3765,b-1_276-376_374.wav,VTTS_b-1_276-376_374.wav,2840,3019,-179
3766,b-4_501-1014_618.wav,VTTS_b-4_501-1014_618.wav,6750,5050,1700
3767,b-2_1427-1562_1553.wav,VTTS_b-2_1427-1562_1553.wav,5350,5654,-304
3768,b-4_1506-1600_1575.wav,VTTS_b-4_1506-1600_1575.wav,5700,6269,-569
3769,b-1_3329-3429_3356.wav,VTTS_b-1_3329-3429_3356.wav,1840,1927,-87
3770,b-1_1313-1413_1372.wav,VTTS_b-1_1313-1413_1372.wav,1930,1695,235
3771,b-4_1101-1220_1190.wav,VTTS_b-4_1101-1220_1190.wav,5460,6188,-728
3772,b-4_2000-5164_4638.wav,VTTS_b-4_2000-5164_4638.wav,3831,3738,93
3773,b-1_3026-3126_3084.wav,VTTS_b-1_3026-3126_3084.wav,1480,1324,156
3774,b-3_5533-5638_5573.wav,VTTS_b-3_5533-5638_5573.wav,3770,3831,-61
3775,b-4_1707-1813_1796.wav,VTTS_b-4_1707-1813_1796.wav,3790,3878,-88
3776,b-3_6301-6400_6361.wav,VTTS_b-3_6301-6400_6361.wav,4770,4853,-83
3777,b-4_2000-5164_3853.wav,VTTS_b-4_2000-5164_3853.wav,1775,1567,208
3778,b-3_6116-6215_6134.wav,VTTS_b-3_6116-6215_6134.wav,4520,4284,236
3779,b-3_4315-4424_4384.wav,VTTS_b-3_4315-4424_4384.wav,7030,6513,517
3780,b-4_2000-5164_5163.wav,VTTS_b-4_2000-5164_5163.wav,2545,2194,351
3781,b-1_1818-1918_1850.wav,VTTS_b-1_1818-1918_1850.wav,3840,3704,136
3782,b-2_1121-1222_1185.wav,VTTS_b-2_1121-1222_1185.wav,5770,5468,302
3783,b-3_196-293_267.wav,VTTS_b-3_196-293_267.wav,2110,2218,-108
3784,b-3_6016-6115_6027.wav,VTTS_b-3_6016-6115_6027.wav,5390,5341,49
3785,b-3_6701-6800_6727.wav,VTTS_b-3_6701-6800_6727.wav,8870,8533,337
3786,b-2_203-304_294.wav,VTTS_b-2_203-304_294.wav,1400,1416,-16
3787,b-1_478-578_483.wav,VTTS_b-1_478-578_483.wav,2770,3936,-1166
3788,b-3_4607-5008_4748.wav,VTTS_b-3_4607-5008_4748.wav,1890,1823,67
3789,b-1_3329-3429_3393.wav,VTTS_b-1_3329-3429_3393.wav,1270,1184,86
3790,b-4_501-1014_552.wav,VTTS_b-4_501-1014_552.wav,5370,4946,424
3791,b-2_1-100_78.wav,VTTS_b-2_1-100_78.wav,2810,3820,-1010
3792,b-4_2000-5164_3217.wav,VTTS_b-4_2000-5164_3217.wav,5302,6142,-840
3793,b-2_1019-1120_1119.wav,VTTS_b-2_1019-1120_1119.wav,4800,3274,1526
3794,b-3_1568-1665_1633.wav,VTTS_b-3_1568-1665_1633.wav,4360,4226,134
3795,b-4_2000-5164_2976.wav,VTTS_b-4_2000-5164_2976.wav,2838,2554,284
3796,b-3_98-195_128.wav,VTTS_b-3_98-195_128.wav,8580,7477,1103
3797,b-4_2000-5164_3032.wav,VTTS_b-4_2000-5164_3032.wav,4938,5654,-716
3798,b-1_3733-3833_3834.wav,VTTS_b-1_3733-3833_3834.wav,6070,5840,230
3799,b-3_6900-7016_6986.wav,VTTS_b-3_6900-7016_6986.wav,2600,2159,441
3800,b-1_1414-1514_1432.wav,VTTS_b-1_1414-1514_1432.wav,4720,5039,-319
3801,b-3_501-930_744.wav,VTTS_b-3_501-930_744.wav,7830,8371,-541
3802,b-3_2524-2854_2821.wav,VTTS_b-3_2524-2854_2821.wav,4200,3773,427
3803,b-1_276-376_342.wav,VTTS_b-1_276-376_342.wav,1640,1591,49
3804,b-2_2209-2310_2285.wav,VTTS_b-2_2209-2310_2285.wav,1560,1660,-100
3805,b-1_2523-2623_2542.wav,VTTS_b-1_2523-2623_2542.wav,1610,1649,-39
3806,b-3_931-979_934.wav,VTTS_b-3_931-979_934.wav,4580,5027,-447
3807,b-4_2000-5164_4264.wav,VTTS_b-4_2000-5164_4264.wav,3308,3262,46
3808,b-3_6701-6800_6799.wav,VTTS_b-3_6701-6800_6799.wav,4930,5132,-202
3809,b-2_1121-1222_1130.wav,VTTS_b-2_1121-1222_1130.wav,2780,3390,-610
3810,b-4_1814-1900_1834.wav,VTTS_b-4_1814-1900_1834.wav,3100,3065,35
3811,b-1_2523-2623_2547.wav,VTTS_b-1_2523-2623_2547.wav,2270,2415,-145
3812,b-1_4430-4465_4443.wav,VTTS_b-1_4430-4465_4443.wav,1570,1556,14
3813,b-3_196-293_240.wav,VTTS_b-3_196-293_240.wav,5480,5793,-313
3814,b-4_2000-5164_4736.wav,VTTS_b-4_2000-5164_4736.wav,6866,8243,-1377
3815,b-1_4106-4141_4129.wav,VTTS_b-1_4106-4141_4129.wav,1700,1521,179
3816,b-3_6701-6800_6714.wav,VTTS_b-3_6701-6800_6714.wav,6740,7721,-981
3817,b-4_2000-5164_4601.wav,VTTS_b-4_2000-5164_4601.wav,4267,4226,41
3818,b-1_4358-4393_4379.wav,VTTS_b-1_4358-4393_4379.wav,2230,1916,314
3819,b-3_5957-6015_5978.wav,VTTS_b-3_5957-6015_5978.wav,7970,7697,273
3820,b-2_1597-1698_1667.wav,VTTS_b-2_1597-1698_1667.wav,3400,3808,-408
3821,b-2_1223-1324_1270.wav,VTTS_b-2_1223-1324_1270.wav,2740,4214,-1474
3822,b-3_6801-6900_6842.wav,VTTS_b-3_6801-6900_6842.wav,8890,6641,2249
3823,b-3_3198-3278_3231.wav,VTTS_b-3_3198-3278_3231.wav,4950,4830,120
3824,b-3_6217-6274_6239.wav,VTTS_b-3_6217-6274_6239.wav,1820,1695,125
3825,b-3_3628-3714_3703.wav,VTTS_b-3_3628-3714_3703.wav,3480,2589,891
3826,b-1_1919-2017_1936.wav,VTTS_b-1_1919-2017_1936.wav,4840,4296,544
3827,b-3_1079-1320_1200.wav,VTTS_b-3_1079-1320_1200.wav,8620,8382,238
3828,b-2_1325-1426_1412.wav,VTTS_b-2_1325-1426_1412.wav,1130,1173,-43
3829,b-3_2089-2176_2091.wav,VTTS_b-3_2089-2176_2091.wav,5620,5921,-301
3830,b-3_4425-4497_4460.wav,VTTS_b-3_4425-4497_4460.wav,4910,5155,-245
3831,b-1_2220-2320_2253.wav,VTTS_b-1_2220-2320_2253.wav,1710,1997,-287
3832,b-4_2000-5164_5120.wav,VTTS_b-4_2000-5164_5120.wav,4711,4540,171
3833,b-3_1321-1568_1457.wav,VTTS_b-3_1321-1568_1457.wav,3630,3286,344
3834,b-1_1-73_58.wav,VTTS_b-1_1-73_58.wav,1040,1103,-63
3835,b-4_1814-1900_1842.wav,VTTS_b-4_1814-1900_1842.wav,1780,1451,329
3836,b-1_650-685_663.wav,VTTS_b-1_650-685_663.wav,2080,2020,60
3837,b-2_1699-1800_1722.wav,VTTS_b-2_1699-1800_1722.wav,4060,4737,-677
3838,b-3_3538-3627_3540.wav,VTTS_b-3_3538-3627_3540.wav,5920,5480,440
3839,b-4_2000-5164_2462.wav,VTTS_b-4_2000-5164_2462.wav,2990,3065,-75
3840,b-3_1079-1320_1287.wav,VTTS_b-3_1079-1320_1287.wav,11650,9938,1712
3841,b-3_4607-5008_4610.wav,VTTS_b-3_4607-5008_4610.wav,7920,7477,443
3842,b-3_1321-1568_1443.wav,VTTS_b-3_1321-1568_1443.wav,7000,6815,185
3843,b-2_1903-2038_1950.wav,VTTS_b-2_1903-2038_1950.wav,1550,2043,-493
3844,b-2_611-712_649.wav,VTTS_b-2_611-712_649.wav,2090,2635,-545
3845,b-1_1818-1918_1838.wav,VTTS_b-1_1818-1918_1838.wav,3470,3646,-176
3846,b-1_1919-2017_1959.wav,VTTS_b-1_1919-2017_1959.wav,2320,2519,-199
3847,b-4_1401-1505_1463.wav,VTTS_b-4_1401-1505_1463.wav,7980,7593,387
3848,b-3_3364-3453_3405.wav,VTTS_b-3_3364-3453_3405.wav,3610,3889,-279
3849,b-1_2422-2522_2492.wav,VTTS_b-1_2422-2522_2492.wav,1560,1428,132
3850,b-4_501-1014_514.wav,VTTS_b-4_501-1014_514.wav,1080,1068,12
3851,b-3_1960-2000_1966.wav,VTTS_b-3_1960-2000_1966.wav,3710,4168,-458
3852,b-4_1101-1220_1121.wav,VTTS_b-4_1101-1220_1121.wav,3430,2949,481
3853,b-3_6116-6215_6193.wav,VTTS_b-3_6116-6215_6193.wav,1660,1591,69
3854,b-4_501-1014_638.wav,VTTS_b-4_501-1014_638.wav,5760,5422,338
3855,b-1_3531-3631_3536.wav,VTTS_b-1_3531-3631_3536.wav,1820,1800,20
3856,b-1_3935-4033_3942.wav,VTTS_b-1_3935-4033_3942.wav,1340,1382,-42
3857,b-4_2000-5164_3548.wav,VTTS_b-4_2000-5164_3548.wav,3046,3959,-913
3858,b-2_203-304_235.wav,VTTS_b-2_203-304_235.wav,1460,1474,-14
3859,b-2_101-202_165.wav,VTTS_b-2_101-202_165.wav,1570,1672,-102
3860,b-2_2209-2310_2241.wav,VTTS_b-2_2209-2310_2241.wav,1450,1382,68
3861,b-1_3026-3126_3048.wav,VTTS_b-1_3026-3126_3048.wav,3030,3077,-47
3862,b-4_1506-1600_1562.wav,VTTS_b-4_1506-1600_1562.wav,2230,2276,-46
3863,b-4_1814-1900_1841.wav,VTTS_b-4_1814-1900_1841.wav,2580,2473,107
3864,b-1_4358-4393_4381.wav,VTTS_b-1_4358-4393_4381.wav,2230,2218,12
3865,b-3_3279-3363_3283.wav,VTTS_b-3_3279-3363_3283.wav,6490,7500,-1010
3866,b-4_2000-5164_3138.wav,VTTS_b-4_2000-5164_3138.wav,4048,4284,-236
3867,b-3_2524-2854_2723.wav,VTTS_b-3_2524-2854_2723.wav,8050,8243,-193
3868,b-1_4394-4429_4406.wav,VTTS_b-1_4394-4429_4406.wav,2170,1939,231
3869,b-4_2000-5164_4579.wav,VTTS_b-4_2000-5164_4579.wav,5418,5770,-352
3870,b-4_2000-5164_3646.wav,VTTS_b-4_2000-5164_3646.wav,3697,3773,-76
3871,b-4_2000-5164_4304.wav,VTTS_b-4_2000-5164_4304.wav,4363,4365,-2
3872,b-4_1601-1706_1644.wav,VTTS_b-4_1601-1706_1644.wav,8680,8173,507
3873,b-3_6274-6300_6299.wav,VTTS_b-3_6274-6300_6299.wav,830,929,-99
3874,b-2_1801-1902_1813.wav,VTTS_b-2_1801-1902_1813.wav,2190,2438,-248
3875,b-2_2209-2310_2242.wav,VTTS_b-2_2209-2310_2242.wav,2620,2368,252
3876,b-2_1223-1324_1298.wav,VTTS_b-2_1223-1324_1298.wav,1320,1231,89
3877,b-3_4607-5008_4829.wav,VTTS_b-3_4607-5008_4829.wav,6930,7175,-245
3878,b-3_6301-6400_6379.wav,VTTS_b-3_6301-6400_6379.wav,4530,3831,699
3879,b-3_3628-3714_3710.wav,VTTS_b-3_3628-3714_3710.wav,4780,5364,-584
3880,b-3_2524-2854_2761.wav,VTTS_b-3_2524-2854_2761.wav,3140,3193,-53
3881,b-4_2000-5164_5140.wav,VTTS_b-4_2000-5164_5140.wav,4468,4644,-176
3882,b-3_1321-1568_1571.wav,VTTS_b-3_1321-1568_1571.wav,4230,5991,-1761
3883,b-1_74-174_74.wav,VTTS_b-1_74-174_74.wav,1940,2392,-452
3884,b-4_2000-5164_2735.wav,VTTS_b-4_2000-5164_2735.wav,3500,3297,203
3885,b-3_3889-4000_3969.wav,VTTS_b-3_3889-4000_3969.wav,3430,3135,295
3886,b-4_1401-1505_1418.wav,VTTS_b-4_1401-1505_1418.wav,3800,3379,421
3887,b-3_4498-4605_4507.wav,VTTS_b-3_4498-4605_4507.wav,8200,8742,-542
3888,b-1_1313-1413_1333.wav,VTTS_b-1_1313-1413_1333.wav,5750,6618,-868
3889,b-4_501-1014_553.wav,VTTS_b-4_501-1014_553.wav,4070,3773,297
3890,b-3_2524-2854_2834.wav,VTTS_b-3_2524-2854_2834.wav,8360,8487,-127
3891,b-3_392-500_415.wav,VTTS_b-3_392-500_415.wav,7670,8127,-457
3892,b-4_2000-5164_4637.wav,VTTS_b-4_2000-5164_4637.wav,3825,4296,-471
3893,b-1_2321-2421_2350.wav,VTTS_b-1_2321-2421_2350.wav,1700,1683,17
3894,b-4_2000-5164_3953.wav,VTTS_b-4_2000-5164_3953.wav,3394,3193,201
3895,b-1_3733-3833_3756.wav,VTTS_b-1_3733-3833_3756.wav,1290,1335,-45
3896,b-4_2000-5164_2699.wav,VTTS_b-4_2000-5164_2699.wav,3640,3576,64
3897,b-1_3127-3227_3182.wav,VTTS_b-1_3127-3227_3182.wav,5500,6316,-816
3898,b-4_2000-5164_4015.wav,VTTS_b-4_2000-5164_4015.wav,5623,5747,-124
3899,b-1_1717-1817_1787.wav,VTTS_b-1_1717-1817_1787.wav,1970,1869,101
3900,b-3_2267-2349_2347.wav,VTTS_b-3_2267-2349_2347.wav,6540,6246,294
3901,b-1_1212-1312_1273.wav,VTTS_b-1_1212-1312_1273.wav,3560,3425,135
3902,b-3_980-1077_1037.wav,VTTS_b-3_980-1077_1037.wav,5500,5480,20
3903,b-1_2422-2522_2483.wav,VTTS_b-1_2422-2522_2483.wav,3350,2844,506
3904,b-3_1764-1861_1827.wav,VTTS_b-3_1764-1861_1827.wav,5640,5178,462
3905,b-3_980-1077_1067.wav,VTTS_b-3_980-1077_1067.wav,7610,8243,-633
3906,b-4_151-300_181.wav,VTTS_b-4_151-300_181.wav,1780,1800,-20
3907,b-2_2311-2412_2332.wav,VTTS_b-2_2311-2412_2332.wav,3850,4180,-330
3908,b-3_1079-1320_1233.wav,VTTS_b-3_1079-1320_1233.wav,10030,11610,-1580
3909,b-4_501-1014_963.wav,VTTS_b-4_501-1014_963.wav,2890,2937,-47
3910,b-4_2000-5164_2069.wav,VTTS_b-4_2000-5164_2069.wav,4260,4772,-512
3911,b-2_2413-2500_2442.wav,VTTS_b-2_2413-2500_2442.wav,1370,1277,93
3912,b-3_1321-1568_1453.wav,VTTS_b-3_1321-1568_1453.wav,3750,3332,418
3913,b-4_2000-5164_2901.wav,VTTS_b-4_2000-5164_2901.wav,4054,4075,-21
3914,b-1_794-1009_812.wav,VTTS_b-1_794-1009_812.wav,3630,3773,-143
3915,b-2_407-508_452.wav,VTTS_b-2_407-508_452.wav,2050,2473,-423
3916,b-1_3935-4033_4026.wav,VTTS_b-1_3935-4033_4026.wav,4930,5700,-770
3917,b-4_2000-5164_2631.wav,VTTS_b-4_2000-5164_2631.wav,5050,5097,-47
3918,b-3_2089-2176_2160.wav,VTTS_b-3_2089-2176_2160.wav,2460,2577,-117
3919,b-4_2000-5164_2366.wav,VTTS_b-4_2000-5164_2366.wav,6530,7303,-773
3920,b-3_6301-6400_6335.wav,VTTS_b-3_6301-6400_6335.wav,1500,1509,-9
3921,b-3_4607-5008_4633.wav,VTTS_b-3_4607-5008_4633.wav,5160,5654,-494
3922,b-4_2000-5164_4123.wav,VTTS_b-4_2000-5164_4123.wav,4440,4563,-123
3923,b-4_1707-1813_1767.wav,VTTS_b-4_1707-1813_1767.wav,9030,8649,381
3924,b-3_2524-2854_2823.wav,VTTS_b-3_2524-2854_2823.wav,3880,3379,501
3925,b-3_2524-2854_2768.wav,VTTS_b-3_2524-2854_2768.wav,5380,4760,620
3926,b-1_4322-4357_4343.wav,VTTS_b-1_4322-4357_4343.wav,1800,2159,-359
3927,b-3_501-930_560.wav,VTTS_b-3_501-930_560.wav,3150,3030,120
3928,b-3_5533-5638_5630.wav,VTTS_b-3_5533-5638_5630.wav,3860,3913,-53
3929,b-3_2943-3024_2992.wav,VTTS_b-3_2943-3024_2992.wav,4860,5259,-399
3930,b-1_2220-2320_2265.wav,VTTS_b-1_2220-2320_2265.wav,960,1010,-50
3931,b-3_2524-2854_2801.wav,VTTS_b-3_2524-2854_2801.wav,3760,3773,-13
3932,b-3_5009-5427_5016.wav,VTTS_b-3_5009-5427_5016.wav,6010,5805,205
3933,b-1_2523-2623_2606.wav,VTTS_b-1_2523-2623_2606.wav,1850,2183,-333
3934,b-3_1568-1665_1586.wav,VTTS_b-3_1568-1665_1586.wav,6410,5875,535
3935,b-3_3538-3627_3563.wav,VTTS_b-3_3538-3627_3563.wav,4300,5201,-901
3936,b-2_2413-2500_2481.wav,VTTS_b-2_2413-2500_2481.wav,1620,1544,76
3937,b-4_2000-5164_4675.wav,VTTS_b-4_2000-5164_4675.wav,5918,6304,-386
3938,b-1_686-793_774.wav,VTTS_b-1_686-793_774.wav,2140,3529,-1389
3939,b-3_6401-6500_6416.wav,VTTS_b-3_6401-6500_6416.wav,3740,3402,338
3940,b-4_1707-1813_1764.wav,VTTS_b-4_1707-1813_1764.wav,3260,4272,-1012
3941,b-2_407-508_489.wav,VTTS_b-2_407-508_489.wav,2010,1741,269
3942,b-4_2000-5164_2948.wav,VTTS_b-4_2000-5164_2948.wav,5942,5968,-26
3943,b-3_3454-3537_3516.wav,VTTS_b-3_3454-3537_3516.wav,3180,3088,92
3944,b-3_3025-3111_3084.wav,VTTS_b-3_3025-3111_3084.wav,3530,3564,-34
3945,b-4_2000-5164_2013.wav,VTTS_b-4_2000-5164_2013.wav,3215,3529,-314
3946,b-3_501-930_760.wav,VTTS_b-3_501-930_760.wav,1180,929,251
3947,b-3_2000-2088_2069.wav,VTTS_b-3_2000-2088_2069.wav,3100,3518,-418
3948,b-4_2000-5164_4564.wav,VTTS_b-4_2000-5164_4564.wav,1417,1324,93
3949,b-4_1401-1505_1454.wav,VTTS_b-4_1401-1505_1454.wav,6780,6316,464
3950,b-3_1321-1568_1466.wav,VTTS_b-3_1321-1568_1466.wav,4620,4005,615
3951,b-3_4207-4314_4254.wav,VTTS_b-3_4207-4314_4254.wav,7210,6316,894
3952,b-1_276-376_304.wav,VTTS_b-1_276-376_304.wav,1770,1509,261
3953,b-3_4607-5008_4728.wav,VTTS_b-3_4607-5008_4728.wav,2500,2392,108
3954,b-1_3531-3631_3616.wav,VTTS_b-1_3531-3631_3616.wav,2530,3007,-477
3955,b-3_2434-2523_2440.wav,VTTS_b-3_2434-2523_2440.wav,2740,2821,-81
3956,b-2_2209-2310_2297.wav,VTTS_b-2_2209-2310_2297.wav,4190,4725,-535
3957,b-1_3531-3631_3619.wav,VTTS_b-1_3531-3631_3619.wav,2860,2902,-42
3958,b-2_713-814_761.wav,VTTS_b-2_713-814_761.wav,1030,882,148
3959,b-1_2927-3025_2968.wav,VTTS_b-1_2927-3025_2968.wav,1180,1091,89
3960,b-3_4607-5008_4930.wav,VTTS_b-3_4607-5008_4930.wav,7940,7465,475
3961,b-2_2209-2310_2219.wav,VTTS_b-2_2209-2310_2219.wav,1450,1370,80
3962,b-2_1427-1562_1491.wav,VTTS_b-2_1427-1562_1491.wav,5290,5016,274
3963,b-1_4394-4429_4427.wav,VTTS_b-1_4394-4429_4427.wav,2140,1788,352
3964,b-2_2311-2412_2370.wav,VTTS_b-2_2311-2412_2370.wav,2120,2229,-109
3965,b-1_4070-4105_4089.wav,VTTS_b-1_4070-4105_4089.wav,2700,3100,-400
3966,b-1_1616-1716_1652.wav,VTTS_b-1_1616-1716_1652.wav,1020,1010,10
3967,b-3_5009-5427_5078.wav,VTTS_b-3_5009-5427_5078.wav,3550,3390,160
3968,b-1_3127-3227_3155.wav,VTTS_b-1_3127-3227_3155.wav,2350,3344,-994
3969,b-3_501-930_707.wav,VTTS_b-3_501-930_707.wav,3580,3564,16
3970,b-3_1862-1959_1936.wav,VTTS_b-3_1862-1959_1936.wav,7290,6757,533
3971,b-3_4607-5008_4863.wav,VTTS_b-3_4607-5008_4863.wav,3520,4423,-903
3972,b-2_2311-2412_2316.wav,VTTS_b-2_2311-2412_2316.wav,1210,1057,153
3973,b-1_2725-2825_2740.wav,VTTS_b-1_2725-2825_2740.wav,1380,1242,138
3974,b-1_1414-1514_1482.wav,VTTS_b-1_1414-1514_1482.wav,2620,3506,-886
3975,b-1_276-376_293.wav,VTTS_b-1_276-376_293.wav,1370,1184,186
3976,b-4_2000-5164_2555.wav,VTTS_b-4_2000-5164_2555.wav,7690,7175,515
3977,b-4_151-300_164.wav,VTTS_b-4_151-300_164.wav,4060,1161,2899
3978,b-1_3834-3934_3914.wav,VTTS_b-1_3834-3934_3914.wav,4800,5468,-668
3979,b-3_2434-2523_2505.wav,VTTS_b-3_2434-2523_2505.wav,6710,7140,-430
3980,b-3_4607-5008_4742.wav,VTTS_b-3_4607-5008_4742.wav,3030,2775,255
3981,b-3_1321-1568_1404.wav,VTTS_b-3_1321-1568_1404.wav,4330,4423,-93
3982,b-3_5639-5744_5738.wav,VTTS_b-3_5639-5744_5738.wav,3010,3262,-252
3983,b-1_1111-1211_1190.wav,VTTS_b-1_1111-1211_1190.wav,2260,2067,193
3984,b-2_2311-2412_2393.wav,VTTS_b-2_2311-2412_2393.wav,4150,3692,458
3985,b-3_5745-5852_5747.wav,VTTS_b-3_5745-5852_5747.wav,4480,4563,-83
3986,b-2_611-712_650.wav,VTTS_b-2_611-712_650.wav,2670,3193,-523
3987,b-3_501-930_933.wav,VTTS_b-3_501-930_933.wav,7310,7163,147
3988,b-1_1414-1514_1507.wav,VTTS_b-1_1414-1514_1507.wav,2400,2995,-595
3989,b-3_294-391_347.wav,VTTS_b-3_294-391_347.wav,6070,5712,358
3990,b-3_3025-3111_3111.wav,VTTS_b-3_3025-3111_3111.wav,6350,5886,464
3991,b-3_3628-3714_3639.wav,VTTS_b-3_3628-3714_3639.wav,4390,4284,106
3992,b-3_5533-5638_5616.wav,VTTS_b-3_5533-5638_5616.wav,7970,8452,-482
3993,b-3_4607-5008_4747.wav,VTTS_b-3_4607-5008_4747.wav,4550,4389,161
3994,b-3_2267-2349_2284.wav,VTTS_b-3_2267-2349_2284.wav,6090,9323,-3233
3995,b-2_1427-1562_1449.wav,VTTS_b-2_1427-1562_1449.wav,6250,11610,-5360
3996,b-4_2000-5164_4197.wav,VTTS_b-4_2000-5164_4197.wav,5329,5503,-174
3997,b-1_3228-3328_3261.wav,VTTS_b-1_3228-3328_3261.wav,1310,1614,-304
3998,b-1_1515-1615_1599.wav,VTTS_b-1_1515-1615_1599.wav,2520,2125,395
3999,b-1_3935-4033_3948.wav,VTTS_b-1_3935-4033_3948.wav,1610,1556,54
4000,b-3_1079-1320_1247.wav,VTTS_b-3_1079-1320_1247.wav,9920,8963,957
4001,b-3_2434-2523_2454.wav,VTTS_b-3_2434-2523_2454.wav,6340,6269,71
4002,b-1_794-1009_824.wav,VTTS_b-1_794-1009_824.wav,2420,2345,75
4003,b-1_2119-2219_2134.wav,VTTS_b-1_2119-2219_2134.wav,2980,2937,43
4004,b-3_501-930_549.wav,VTTS_b-3_501-930_549.wav,6100,6060,40
4005,b-1_2422-2522_2497.wav,VTTS_b-1_2422-2522_2497.wav,2380,2403,-23
4006,b-4_1014-1100_1095.wav,VTTS_b-4_1014-1100_1095.wav,1990,2136,-146
4007,b-3_1-97_79.wav,VTTS_b-3_1-97_79.wav,4840,7233,-2393
4008,b-3_4607-5008_4984.wav,VTTS_b-3_4607-5008_4984.wav,6870,6571,299
4009,b-4_2000-5164_2081.wav,VTTS_b-4_2000-5164_2081.wav,8060,8731,-671
4010,b-3_3112-3197_3124.wav,VTTS_b-3_3112-3197_3124.wav,1970,1765,205
4011,b-4_2000-5164_2258.wav,VTTS_b-4_2000-5164_2258.wav,4700,4470,230
4012,b-4_2000-5164_2909.wav,VTTS_b-4_2000-5164_2909.wav,5108,4690,418
4013,b-4_53-150_130.wav,VTTS_b-4_53-150_130.wav,8640,8371,269
4014,b-1_1414-1514_1479.wav,VTTS_b-1_1414-1514_1479.wav,1540,1393,147
4015,b-4_2000-5164_4659.wav,VTTS_b-4_2000-5164_4659.wav,4598,4690,-92
4016,b-3_1764-1861_1772.wav,VTTS_b-3_1764-1861_1772.wav,3880,3587,293
4017,b-1_1111-1211_1208.wav,VTTS_b-1_1111-1211_1208.wav,4520,4238,282
4018,b-3_6301-6400_6325.wav,VTTS_b-3_6301-6400_6325.wav,7400,7036,364
4019,b-1_794-1009_866.wav,VTTS_b-1_794-1009_866.wav,2550,3483,-933
4020,b-3_2350-2433_2369.wav,VTTS_b-3_2350-2433_2369.wav,6550,4981,1569
4021,b-4_151-300_289.wav,VTTS_b-4_151-300_289.wav,4920,4191,729
4022,b-2_1427-1562_1444.wav,VTTS_b-2_1427-1562_1444.wav,3040,3007,33
4023,b-1_2725-2825_2759.wav,VTTS_b-1_2725-2825_2759.wav,2590,3820,-1230
4024,b-2_1427-1562_1525.wav,VTTS_b-2_1427-1562_1525.wav,3240,3634,-394
4025,b-1_3026-3126_3064.wav,VTTS_b-1_3026-3126_3064.wav,1260,1184,76
4026,b-3_501-930_572.wav,VTTS_b-3_501-930_572.wav,8830,8429,401
4027,b-3_1666-1763_1709.wav,VTTS_b-3_1666-1763_1709.wav,4960,5074,-114
4028,b-4_2000-5164_2686.wav,VTTS_b-4_2000-5164_2686.wav,2950,3170,-220
4029,b-3_6274-6300_6291.wav,VTTS_b-3_6274-6300_6291.wav,9180,8742,438
4030,b-3_1-97_64.wav,VTTS_b-3_1-97_64.wav,3170,3680,-510
4031,b-3_6116-6215_6146.wav,VTTS_b-3_6116-6215_6146.wav,1990,2101,-111
4032,b-3_4207-4314_4220.wav,VTTS_b-3_4207-4314_4220.wav,6310,6293,17
4033,b-3_6116-6215_6167.wav,VTTS_b-3_6116-6215_6167.wav,4910,4876,34
4034,b-2_815-916_858.wav,VTTS_b-2_815-916_858.wav,2260,2322,-62
4035,b-1_3430-3530_3476.wav,VTTS_b-1_3430-3530_3476.wav,2570,3274,-704
4036,b-2_2209-2310_2274.wav,VTTS_b-2_2209-2310_2274.wav,1200,1254,-54
4037,b-1_1616-1716_1618.wav,VTTS_b-1_1616-1716_1618.wav,1900,2287,-387
4038,b-4_2000-5164_3274.wav,VTTS_b-4_2000-5164_3274.wav,8273,8638,-365
4039,b-2_407-508_500.wav,VTTS_b-2_407-508_500.wav,1470,1474,-4
4040,b-1_1111-1211_1134.wav,VTTS_b-1_1111-1211_1134.wav,3690,4493,-803
4041,b-4_301-400_318.wav,VTTS_b-4_301-400_318.wav,6680,7546,-866
4042,b-2_1801-1902_1801.wav,VTTS_b-2_1801-1902_1801.wav,6330,9044,-2714
4043,b-4_2000-5164_5099.wav,VTTS_b-4_2000-5164_5099.wav,18832,11610,7222
4044,b-4_2000-5164_4955.wav,VTTS_b-4_2000-5164_4955.wav,3415,4470,-1055
4045,b-4_2000-5164_4939.wav,VTTS_b-4_2000-5164_4939.wav,6390,6676,-286
4046,b-3_392-500_431.wav,VTTS_b-3_392-500_431.wav,9660,10182,-522
4047,b-2_917-1018_990.wav,VTTS_b-2_917-1018_990.wav,2510,1579,931
4048,b-3_5639-5744_5732.wav,VTTS_b-3_5639-5744_5732.wav,3980,3762,218
4049,b-2_203-304_271.wav,VTTS_b-2_203-304_271.wav,1560,2055,-495
4050,b-1_4286-4321_4313.wav,VTTS_b-1_4286-4321_4313.wav,2460,2496,-36
4051,b-1_3632-3732_3649.wav,VTTS_b-1_3632-3732_3649.wav,2440,2508,-68
4052,b-2_1-100_87.wav,VTTS_b-2_1-100_87.wav,4090,3680,410
4053,b-3_3364-3453_3422.wav,VTTS_b-3_3364-3453_3422.wav,3670,5840,-2170
4054,b-3_1862-1959_1915.wav,VTTS_b-3_1862-1959_1915.wav,4180,4191,-11
4055,b-4_401-500_477.wav,VTTS_b-4_401-500_477.wav,2970,2902,68
4056,b-4_2000-5164_3427.wav,VTTS_b-4_2000-5164_3427.wav,1758,1707,51
4057,b-1_4394-4429_4414.wav,VTTS_b-1_4394-4429_4414.wav,1760,1811,-51
4058,b-4_2000-5164_3367.wav,VTTS_b-4_2000-5164_3367.wav,3136,3146,-10
4059,b-3_4607-5008_4976.wav,VTTS_b-3_4607-5008_4976.wav,5350,5364,-14
4060,b-4_2000-5164_4935.wav,VTTS_b-4_2000-5164_4935.wav,3612,3785,-173
4061,b-2_101-202_131.wav,VTTS_b-2_101-202_131.wav,2770,2450,320
4062,b-1_3430-3530_3440.wav,VTTS_b-1_3430-3530_3440.wav,2520,11610,-9090
4063,b-4_1101-1220_1136.wav,VTTS_b-4_1101-1220_1136.wav,3800,3553,247
4064,b-1_2119-2219_2213.wav,VTTS_b-1_2119-2219_2213.wav,2170,2009,161
4065,b-1_175-275_186.wav,VTTS_b-1_175-275_186.wav,780,813,-33
4066,b-4_301-400_382.wav,VTTS_b-4_301-400_382.wav,6420,5991,429
4067,b-3_2943-3024_2947.wav,VTTS_b-3_2943-3024_2947.wav,4040,3866,174
4068,b-4_2000-5164_2675.wav,VTTS_b-4_2000-5164_2675.wav,3135,3320,-185
4069,b-3_2524-2854_2816.wav,VTTS_b-3_2524-2854_2816.wav,6540,6397,143
4070,b-1_3127-3227_3134.wav,VTTS_b-1_3127-3227_3134.wav,1610,1556,54
4071,b-3_3628-3714_3645.wav,VTTS_b-3_3628-3714_3645.wav,3620,4342,-722
4072,b-3_6016-6115_6060.wav,VTTS_b-3_6016-6115_6060.wav,2790,2763,27
4073,b-1_3531-3631_3537.wav,VTTS_b-1_3531-3631_3537.wav,1720,1660,60
4074,b-2_611-712_640.wav,VTTS_b-2_611-712_640.wav,1840,1985,-145
4075,b-3_1079-1320_1134.wav,VTTS_b-3_1079-1320_1134.wav,9410,8882,528
4076,b-4_2000-5164_2814.wav,VTTS_b-4_2000-5164_2814.wav,4640,5178,-538
4077,b-1_1717-1817_1767.wav,VTTS_b-1_1717-1817_1767.wav,1590,1567,23
4078,b-1_579-649_633.wav,VTTS_b-1_579-649_633.wav,1620,3680,-2060
4079,b-1_2624-2724_2698.wav,VTTS_b-1_2624-2724_2698.wav,1680,1486,194
4080,b-2_407-508_431.wav,VTTS_b-2_407-508_431.wav,2430,2276,154
4081,b-3_2000-2088_2066.wav,VTTS_b-3_2000-2088_2066.wav,4970,5294,-324
4082,b-2_2107-2193_2191.wav,VTTS_b-2_2107-2193_2191.wav,1760,1800,-40
4083,b-3_1321-1568_1461.wav,VTTS_b-3_1321-1568_1461.wav,3820,3855,-35
4084,b-1_2119-2219_2212.wav,VTTS_b-1_2119-2219_2212.wav,3220,4934,-1714
4085,b-4_501-1014_868.wav,VTTS_b-4_501-1014_868.wav,6340,6269,71
4086,b-4_2000-5164_4734.wav,VTTS_b-4_2000-5164_4734.wav,2266,2264,2
4087,b-3_2434-2523_2483.wav,VTTS_b-3_2434-2523_2483.wav,6360,6246,114
4088,b-1_3834-3934_3870.wav,VTTS_b-1_3834-3934_3870.wav,1850,2009,-159
4089,b-2_2040-2072_2067.wav,VTTS_b-2_2040-2072_2067.wav,3260,3947,-687
4090,b-1_650-685_657.wav,VTTS_b-1_650-685_657.wav,3090,3042,48
4091,b-1_478-578_496.wav,VTTS_b-1_478-578_496.wav,2170,1985,185
4092,b-3_3112-3197_3141.wav,VTTS_b-3_3112-3197_3141.wav,4130,4307,-177
4093,b-3_5009-5427_5330.wav,VTTS_b-3_5009-5427_5330.wav,4580,4772,-192
4094,b-4_2000-5164_3214.wav,VTTS_b-4_2000-5164_3214.wav,4123,3738,385
4095,b-3_3628-3714_3629.wav,VTTS_b-3_3628-3714_3629.wav,6650,6455,195
4096,b-3_6801-6900_6828.wav,VTTS_b-3_6801-6900_6828.wav,4660,4040,620
4097,b-4_2000-5164_4109.wav,VTTS_b-4_2000-5164_4109.wav,5760,5956,-196
4098,b-1_686-793_741.wav,VTTS_b-1_686-793_741.wav,1750,1707,43
4099,b-4_501-1014_923.wav,VTTS_b-4_501-1014_923.wav,6920,6304,616
4100,b-3_4207-4314_4212.wav,VTTS_b-3_4207-4314_4212.wav,2530,2368,162
4101,b-1_3026-3126_3090.wav,VTTS_b-1_3026-3126_3090.wav,1620,1834,-214
4102,b-1_1111-1211_1154.wav,VTTS_b-1_1111-1211_1154.wav,1440,1335,105
4103,b-3_6016-6115_6094.wav,VTTS_b-3_6016-6115_6094.wav,7700,8417,-717
4104,b-3_2000-2088_2046.wav,VTTS_b-3_2000-2088_2046.wav,7830,8731,-901
4105,b-3_1321-1568_1441.wav,VTTS_b-3_1321-1568_1441.wav,2040,1916,124
4106,b-4_53-150_82.wav,VTTS_b-4_53-150_82.wav,9830,9485,345
4107,b-2_1325-1426_1335.wav,VTTS_b-2_1325-1426_1335.wav,1700,1718,-18
4108,b-3_1321-1568_1352.wav,VTTS_b-3_1321-1568_1352.wav,4220,4795,-575
4109,b-3_6501-6600_6532.wav,VTTS_b-3_6501-6600_6532.wav,2000,1858,142
4110,b-3_6900-7016_7013.wav,VTTS_b-3_6900-7016_7013.wav,2680,2589,91
4111,b-2_2413-2500_2451.wav,VTTS_b-2_2413-2500_2451.wav,1150,1045,105
4112,b-3_6900-7016_7001.wav,VTTS_b-3_6900-7016_7001.wav,5040,4981,59
4113,b-1_3430-3530_3433.wav,VTTS_b-1_3430-3530_3433.wav,1490,1416,74
4114,b-3_2177-2266_2253.wav,VTTS_b-3_2177-2266_2253.wav,3300,4516,-1216
4115,b-1_1010-1110_1072.wav,VTTS_b-1_1010-1110_1072.wav,830,813,17
4116,b-2_815-916_877.wav,VTTS_b-2_815-916_877.wav,1360,1428,-68
4117,b-2_2413-2500_2496.wav,VTTS_b-2_2413-2500_2496.wav,5100,4807,293
4118,b-3_2350-2433_2412.wav,VTTS_b-3_2350-2433_2412.wav,7100,7848,-748
4119,b-4_2000-5164_3501.wav,VTTS_b-4_2000-5164_3501.wav,13005,11610,1395
4120,b-2_1427-1562_1548.wav,VTTS_b-2_1427-1562_1548.wav,3000,3135,-135
4121,b-4_2000-5164_3984.wav,VTTS_b-4_2000-5164_3984.wav,3413,3727,-314
4122,b-1_3531-3631_3593.wav,VTTS_b-1_3531-3631_3593.wav,4780,5410,-630
4123,b-3_3364-3453_3412.wav,VTTS_b-3_3364-3453_3412.wav,4390,4934,-544
4124,b-4_2000-5164_3425.wav,VTTS_b-4_2000-5164_3425.wav,4743,5178,-435
4125,b-3_2177-2266_2208.wav,VTTS_b-3_2177-2266_2208.wav,5060,4493,567
4126,b-1_1919-2017_1957.wav,VTTS_b-1_1919-2017_1957.wav,4190,3518,672
4127,b-4_501-1014_999.wav,VTTS_b-4_501-1014_999.wav,7560,7964,-404
4128,b-2_1019-1120_1056.wav,VTTS_b-2_1019-1120_1056.wav,1210,917,293
4129,b-1_1515-1615_1596.wav,VTTS_b-1_1515-1615_1596.wav,990,1057,-67
4130,b-1_579-649_611.wav,VTTS_b-1_579-649_611.wav,3830,4899,-1069
4131,b-1_2321-2421_2324.wav,VTTS_b-1_2321-2421_2324.wav,1650,1649,1
4132,b-3_1666-1763_1697.wav,VTTS_b-3_1666-1763_1697.wav,10970,9868,1102
4133,b-4_2000-5164_2906.wav,VTTS_b-4_2000-5164_2906.wav,3053,2833,220
4134,b-3_6900-7016_6940.wav,VTTS_b-3_6900-7016_6940.wav,6810,5991,819
4135,b-1_1414-1514_1448.wav,VTTS_b-1_1414-1514_1448.wav,2100,2043,57
4136,b-1_2220-2320_2295.wav,VTTS_b-1_2220-2320_2295.wav,2090,2067,23
4137,b-1_686-793_787.wav,VTTS_b-1_686-793_787.wav,4630,4807,-177
4138,b-1_4394-4429_4402.wav,VTTS_b-1_4394-4429_4402.wav,3070,3181,-111
4139,b-1_1-73_29.wav,VTTS_b-1_1-73_29.wav,2220,2345,-125
4140,b-4_2000-5164_2807.wav,VTTS_b-4_2000-5164_2807.wav,8140,11076,-2936
4141,b-4_151-300_269.wav,VTTS_b-4_151-300_269.wav,7710,7558,152
4142,b-3_3715-3802_3791.wav,VTTS_b-3_3715-3802_3791.wav,7680,7953,-273
4143,b-4_2000-5164_4943.wav,VTTS_b-4_2000-5164_4943.wav,7858,8928,-1070
4144,b-2_611-712_717.wav,VTTS_b-2_611-712_717.wav,1400,1382,18
4145,b-1_2624-2724_2686.wav,VTTS_b-1_2624-2724_2686.wav,5350,11610,-6260
4146,b-1_579-649_640.wav,VTTS_b-1_579-649_640.wav,1450,1509,-59
4147,b-4_151-300_248.wav,VTTS_b-4_151-300_248.wav,4140,4481,-341
4148,b-3_5639-5744_5684.wav,VTTS_b-3_5639-5744_5684.wav,4590,4180,410
4149,b-3_2434-2523_2465.wav,VTTS_b-3_2434-2523_2465.wav,3970,3286,684
4150,b-3_3803-3888_3840.wav,VTTS_b-3_3803-3888_3840.wav,7510,6838,672
4151,b-1_686-793_776.wav,VTTS_b-1_686-793_776.wav,1220,1161,59
4152,b-3_1568-1665_1631.wav,VTTS_b-3_1568-1665_1631.wav,6320,8324,-2004
4153,b-4_2000-5164_4599.wav,VTTS_b-4_2000-5164_4599.wav,3674,4087,-413
4154,b-1_478-578_501.wav,VTTS_b-1_478-578_501.wav,1890,1834,56
4155,b-3_6701-6800_6707.wav,VTTS_b-3_6701-6800_6707.wav,7240,9125,-1885
4156,b-4_1301-1400_1375.wav,VTTS_b-4_1301-1400_1375.wav,3680,3762,-82
4157,b-3_4607-5008_4630.wav,VTTS_b-3_4607-5008_4630.wav,7610,8127,-517
4158,b-3_3025-3111_3065.wav,VTTS_b-3_3025-3111_3065.wav,6700,6049,651
4159,b-3_3803-3888_3807.wav,VTTS_b-3_3803-3888_3807.wav,5110,4714,396
4160,b-1_2119-2219_2197.wav,VTTS_b-1_2119-2219_2197.wav,4020,3959,61
4161,b-3_2177-2266_2191.wav,VTTS_b-3_2177-2266_2191.wav,3780,3680,100
4162,b-1_3733-3833_3771.wav,VTTS_b-1_3733-3833_3771.wav,1800,1695,105
4163,b-1_579-649_610.wav,VTTS_b-1_579-649_610.wav,4620,4226,394
4164,b-4_1901-2000_1942.wav,VTTS_b-4_1901-2000_1942.wav,3290,2961,329
4165,b-3_2267-2349_2270.wav,VTTS_b-3_2267-2349_2270.wav,4450,5108,-658
4166,b-3_501-930_695.wav,VTTS_b-3_501-930_695.wav,1540,1451,89
4167,b-3_501-930_593.wav,VTTS_b-3_501-930_593.wav,10000,9741,259
4168,b-3_4607-5008_4833.wav,VTTS_b-3_4607-5008_4833.wav,7140,6699,441
4169,b-4_2000-5164_2812.wav,VTTS_b-4_2000-5164_2812.wav,9960,9648,312
4170,b-4_2000-5164_3409.wav,VTTS_b-4_2000-5164_3409.wav,5259,5120,139
4171,b-1_3127-3227_3218.wav,VTTS_b-1_3127-3227_3218.wav,1500,1695,-195
4172,b-3_6801-6900_6888.wav,VTTS_b-3_6801-6900_6888.wav,2520,2949,-429
4173,b-1_276-376_364.wav,VTTS_b-1_276-376_364.wav,1110,894,216
4174,b-3_1568-1665_1618.wav,VTTS_b-3_1568-1665_1618.wav,4620,4249,371
4175,b-1_1313-1413_1391.wav,VTTS_b-1_1313-1413_1391.wav,5270,8742,-3472
4176,b-2_1325-1426_1426.wav,VTTS_b-2_1325-1426_1426.wav,2960,2775,185
4177,b-1_1212-1312_1248.wav,VTTS_b-1_1212-1312_1248.wav,4970,4191,779
4178,b-4_2000-5164_2551.wav,VTTS_b-4_2000-5164_2551.wav,2305,2508,-203
4179,b-3_4425-4497_4431.wav,VTTS_b-3_4425-4497_4431.wav,4730,4748,-18
4180,b-3_4425-4497_4425.wav,VTTS_b-3_4425-4497_4425.wav,11770,11610,160
4181,b-1_3531-3631_3558.wav,VTTS_b-1_3531-3631_3558.wav,1930,2113,-183
4182,b-3_5009-5427_5348.wav,VTTS_b-3_5009-5427_5348.wav,5420,5503,-83
4183,b-1_1919-2017_1934.wav,VTTS_b-1_1919-2017_1934.wav,4150,4992,-842
4184,b-4_2000-5164_4470.wav,VTTS_b-4_2000-5164_4470.wav,10626,10101,525
4185,b-1_1010-1110_1078.wav,VTTS_b-1_1010-1110_1078.wav,1610,1474,136
4186,b-1_4286-4321_4308.wav,VTTS_b-1_4286-4321_4308.wav,1180,1846,-666
4187,b-3_392-500_449.wav,VTTS_b-3_392-500_449.wav,7110,8324,-1214
4188,b-3_2089-2176_2152.wav,VTTS_b-3_2089-2176_2152.wav,4340,4423,-83
4189,b-3_4607-5008_4934.wav,VTTS_b-3_4607-5008_4934.wav,3800,4412,-612
4190,b-2_713-814_791.wav,VTTS_b-2_713-814_791.wav,3150,4296,-1146
4191,b-4_2000-5164_4905.wav,VTTS_b-4_2000-5164_4905.wav,4280,4331,-51
4192,b-3_501-930_878.wav,VTTS_b-3_501-930_878.wav,7510,7140,370
4193,b-2_101-202_116.wav,VTTS_b-2_101-202_116.wav,1380,1080,300
4194,b-4_401-500_468.wav,VTTS_b-4_401-500_468.wav,5210,5700,-490
4195,b-3_3364-3453_3369.wav,VTTS_b-3_3364-3453_3369.wav,3150,3367,-217
4196,b-3_1079-1320_1318.wav,VTTS_b-3_1079-1320_1318.wav,6410,5909,501
4197,b-3_5009-5427_5225.wav,VTTS_b-3_5009-5427_5225.wav,4300,3936,364
4198,b-3_1862-1959_1907.wav,VTTS_b-3_1862-1959_1907.wav,6640,6165,475
4199,b-1_3228-3328_3320.wav,VTTS_b-1_3228-3328_3320.wav,1630,1846,-216
4200,b-2_2311-2412_2353.wav,VTTS_b-2_2311-2412_2353.wav,1260,1254,6
4201,b-2_407-508_456.wav,VTTS_b-2_407-508_456.wav,2410,1904,506
4202,b-3_5009-5427_5025.wav,VTTS_b-3_5009-5427_5025.wav,9110,8603,507
4203,b-4_2000-5164_2390.wav,VTTS_b-4_2000-5164_2390.wav,4570,4899,-329
4204,b-1_686-793_734.wav,VTTS_b-1_686-793_734.wav,3600,4261,-661
4205,b-4_2000-5164_2212.wav,VTTS_b-4_2000-5164_2212.wav,2180,2194,-14
4206,b-4_2000-5164_4949.wav,VTTS_b-4_2000-5164_4949.wav,5922,6177,-255
4207,b-1_686-793_788.wav,VTTS_b-1_686-793_788.wav,3500,3437,63
4208,b-1_4394-4429_4401.wav,VTTS_b-1_4394-4429_4401.wav,2420,2531,-111
4209,b-2_1019-1120_1092.wav,VTTS_b-2_1019-1120_1092.wav,1140,1103,37
4210,b-4_2000-5164_3817.wav,VTTS_b-4_2000-5164_3817.wav,3354,4423,-1069
4211,b-4_1814-1900_1832.wav,VTTS_b-4_1814-1900_1832.wav,4820,4656,164
4212,b-1_2523-2623_2594.wav,VTTS_b-1_2523-2623_2594.wav,2890,2844,46
4213,b-4_151-300_209.wav,VTTS_b-4_151-300_209.wav,2260,2287,-27
4214,b-3_3538-3627_3617.wav,VTTS_b-3_3538-3627_3617.wav,3450,3332,118
4215,b-1_3228-3328_3319.wav,VTTS_b-1_3228-3328_3319.wav,1480,1486,-6
4216,b-1_276-376_288.wav,VTTS_b-1_276-376_288.wav,1690,1776,-86
4217,b-2_407-508_435.wav,VTTS_b-2_407-508_435.wav,1320,1265,55
4218,b-3_3889-4000_3935.wav,VTTS_b-3_3889-4000_3935.wav,2620,2496,124
4219,b-1_2018-2118_2035.wav,VTTS_b-1_2018-2118_2035.wav,1850,1695,155
4220,b-1_3329-3429_3331.wav,VTTS_b-1_3329-3429_3331.wav,2200,2101,99
4221,b-4_1014-1100_1047.wav,VTTS_b-4_1014-1100_1047.wav,3330,3274,56
4222,b-4_2000-5164_2063.wav,VTTS_b-4_2000-5164_2063.wav,4800,4609,191
4223,b-3_3803-3888_3839.wav,VTTS_b-3_3803-3888_3839.wav,7710,6583,1127
4224,b-3_1960-2000_1993.wav,VTTS_b-3_1960-2000_1993.wav,8000,7697,303
4225,b-3_931-979_957.wav,VTTS_b-3_931-979_957.wav,6900,7105,-205
4226,b-3_4425-4497_4472.wav,VTTS_b-3_4425-4497_4472.wav,5270,5155,115
4227,b-1_2523-2623_2553.wav,VTTS_b-1_2523-2623_2553.wav,1320,1300,20
4228,b-4_1707-1813_1715.wav,VTTS_b-4_1707-1813_1715.wav,2990,2647,343
4229,b-4_2000-5164_2722.wav,VTTS_b-4_2000-5164_2722.wav,4015,3924,91
4230,b-1_4322-4357_4322.wav,VTTS_b-1_4322-4357_4322.wav,1980,2078,-98
4231,b-4_2000-5164_4821.wav,VTTS_b-4_2000-5164_4821.wav,9012,8789,223
4232,b-1_650-685_655.wav,VTTS_b-1_650-685_655.wav,1480,1393,87
4233,b-2_1427-1562_1467.wav,VTTS_b-2_1427-1562_1467.wav,2880,2682,198
4234,b-3_1079-1320_1104.wav,VTTS_b-3_1079-1320_1104.wav,4350,4075,275
4235,b-3_980-1077_1023.wav,VTTS_b-3_980-1077_1023.wav,5240,5294,-54
4236,b-2_611-712_611.wav,VTTS_b-2_611-712_611.wav,1880,1846,34
4237,b-4_501-1014_557.wav,VTTS_b-4_501-1014_557.wav,2200,2020,180
4238,b-3_5639-5744_5683.wav,VTTS_b-3_5639-5744_5683.wav,2520,2798,-278
4239,b-1_2018-2118_2023.wav,VTTS_b-1_2018-2118_2023.wav,2750,2519,231
4240,b-3_5533-5638_5539.wav,VTTS_b-3_5533-5638_5539.wav,4190,4946,-756
4241,b-3_1079-1320_1130.wav,VTTS_b-3_1079-1320_1130.wav,4090,11610,-7520
4242,b-1_4358-4393_4378.wav,VTTS_b-1_4358-4393_4378.wav,2380,3204,-824
4243,b-3_5009-5427_5212.wav,VTTS_b-3_5009-5427_5212.wav,1710,1219,491
4244,b-3_2267-2349_2325.wav,VTTS_b-3_2267-2349_2325.wav,5870,6861,-991
4245,b-2_815-916_824.wav,VTTS_b-2_815-916_824.wav,2710,2868,-158
4246,b-1_1616-1716_1655.wav,VTTS_b-1_1616-1716_1655.wav,4360,4737,-377
4247,b-3_3538-3627_3565.wav,VTTS_b-3_3538-3627_3565.wav,2910,2392,518
4248,b-4_2000-5164_3898.wav,VTTS_b-4_2000-5164_3898.wav,3757,3901,-144
4249,b-3_6701-6800_6762.wav,VTTS_b-3_6701-6800_6762.wav,6520,6107,413
4250,b-3_5009-5427_5224.wav,VTTS_b-3_5009-5427_5224.wav,3040,2949,91
4251,b-3_1-97_84.wav,VTTS_b-3_1-97_84.wav,4080,3796,284
4252,b-1_1010-1110_1020.wav,VTTS_b-1_1010-1110_1020.wav,1740,1567,173
4253,b-1_1818-1918_1825.wav,VTTS_b-1_1818-1918_1825.wav,3830,4122,-292
4254,b-1_3531-3631_3599.wav,VTTS_b-1_3531-3631_3599.wav,2070,1753,317
4255,b-2_1597-1698_1641.wav,VTTS_b-2_1597-1698_1641.wav,3330,2078,1252
4256,b-2_101-202_138.wav,VTTS_b-2_101-202_138.wav,2690,3738,-1048
4257,b-4_2000-5164_2742.wav,VTTS_b-4_2000-5164_2742.wav,2260,2252,8
4258,b-1_3632-3732_3638.wav,VTTS_b-1_3632-3732_3638.wav,2400,2276,124
4259,b-3_6274-6300_6285.wav,VTTS_b-3_6274-6300_6285.wav,4010,4354,-344
4260,b-2_2209-2310_2272.wav,VTTS_b-2_2209-2310_2272.wav,3990,3100,890
4261,b-3_3025-3111_3025.wav,VTTS_b-3_3025-3111_3025.wav,1930,1927,3
4262,b-1_4214-4285_4270.wav,VTTS_b-1_4214-4285_4270.wav,2000,2368,-368
4263,b-3_6274-6300_6284.wav,VTTS_b-3_6274-6300_6284.wav,4780,4087,693
4264,b-3_5428-5533_5496.wav,VTTS_b-3_5428-5533_5496.wav,5170,4818,352
4265,b-3_2000-2088_2001.wav,VTTS_b-3_2000-2088_2001.wav,5660,5190,470
4266,b-3_4001-4103_4014.wav,VTTS_b-3_4001-4103_4014.wav,10210,10635,-425
4267,b-2_1019-1120_1066.wav,VTTS_b-2_1019-1120_1066.wav,3270,4005,-735
4268,b-4_151-300_266.wav,VTTS_b-4_151-300_266.wav,11290,11610,-320
4269,b-4_2000-5164_3318.wav,VTTS_b-4_2000-5164_3318.wav,2157,1985,172
4270,b-1_74-174_113.wav,VTTS_b-1_74-174_113.wav,1200,1300,-100
4271,b-2_1427-1562_1437.wav,VTTS_b-2_1427-1562_1437.wav,4010,4389,-379
4272,b-4_2000-5164_4504.wav,VTTS_b-4_2000-5164_4504.wav,3279,3390,-111
4273,b-3_1079-1320_1209.wav,VTTS_b-3_1079-1320_1209.wav,5800,5027,773
4274,b-4_2000-5164_3003.wav,VTTS_b-4_2000-5164_3003.wav,3754,3866,-112
4275,b-4_2000-5164_4653.wav,VTTS_b-4_2000-5164_4653.wav,1840,1567,273
4276,b-1_3531-3631_3563.wav,VTTS_b-1_3531-3631_3563.wav,2210,2287,-77
4277,b-1_579-649_589.wav,VTTS_b-1_579-649_589.wav,2670,2392,278
4278,b-2_815-916_909.wav,VTTS_b-2_815-916_909.wav,1700,1660,40
4279,b-4_2000-5164_3981.wav,VTTS_b-4_2000-5164_3981.wav,3682,3611,71
4280,b-3_1666-1763_1742.wav,VTTS_b-3_1666-1763_1742.wav,3820,3762,58
4281,b-3_2524-2854_2679.wav,VTTS_b-3_2524-2854_2679.wav,4130,4191,-61
4282,b-4_2000-5164_4191.wav,VTTS_b-4_2000-5164_4191.wav,2430,2357,73
4283,b-3_5428-5533_5514.wav,VTTS_b-3_5428-5533_5514.wav,8900,9242,-342
4284,b-2_101-202_183.wav,VTTS_b-2_101-202_183.wav,2240,2276,-36
4285,b-3_4207-4314_4306.wav,VTTS_b-3_4207-4314_4306.wav,9030,8766,264
4286,b-3_6016-6115_6062.wav,VTTS_b-3_6016-6115_6062.wav,1530,1823,-293
4287,b-3_5428-5533_5489.wav,VTTS_b-3_5428-5533_5489.wav,3760,3947,-187
4288,b-3_1321-1568_1564.wav,VTTS_b-3_1321-1568_1564.wav,2850,2740,110
4289,b-1_3329-3429_3384.wav,VTTS_b-1_3329-3429_3384.wav,2440,2508,-68
4290,b-3_501-930_908.wav,VTTS_b-3_501-930_908.wav,3680,4098,-418
4291,b-3_4607-5008_4987.wav,VTTS_b-3_4607-5008_4987.wav,5550,5631,-81
4292,b-4_2000-5164_2489.wav,VTTS_b-4_2000-5164_2489.wav,3860,3657,203
4293,b-4_2000-5164_3015.wav,VTTS_b-4_2000-5164_3015.wav,5963,5875,88
4294,b-4_2000-5164_3133.wav,VTTS_b-4_2000-5164_3133.wav,6405,11610,-5205
4295,b-3_6601-6700_6692.wav,VTTS_b-3_6601-6700_6692.wav,2750,3077,-327
4296,b-2_1597-1698_1639.wav,VTTS_b-2_1597-1698_1639.wav,5030,8173,-3143
4297,b-3_2524-2854_2759.wav,VTTS_b-3_2524-2854_2759.wav,2640,2554,86
4298,b-1_3531-3631_3610.wav,VTTS_b-1_3531-3631_3610.wav,1930,2055,-125
4299,b-4_2000-5164_3895.wav,VTTS_b-4_2000-5164_3895.wav,4047,3971,76
4300,b-3_5009-5427_5341.wav,VTTS_b-3_5009-5427_5341.wav,3970,3599,371
4301,b-4_2000-5164_3359.wav,VTTS_b-4_2000-5164_3359.wav,5040,5132,-92
4302,b-4_53-150_69.wav,VTTS_b-4_53-150_69.wav,6670,6548,122
4303,b-3_1960-2000_1997.wav,VTTS_b-3_1960-2000_1997.wav,5980,5561,419
4304,b-3_2524-2854_2576.wav,VTTS_b-3_2524-2854_2576.wav,5280,5375,-95
4305,b-1_2321-2421_2386.wav,VTTS_b-1_2321-2421_2386.wav,2280,2276,4
4306,b-3_501-930_916.wav,VTTS_b-3_501-930_916.wav,6240,7129,-889
4307,b-3_98-195_106.wav,VTTS_b-3_98-195_106.wav,3050,3007,43
4308,b-4_2000-5164_4308.wav,VTTS_b-4_2000-5164_4308.wav,2249,2241,8
4309,b-3_2434-2523_2489.wav,VTTS_b-3_2434-2523_2489.wav,3110,2752,358
4310,b-4_1814-1900_1883.wav,VTTS_b-4_1814-1900_1883.wav,2070,1788,282
4311,b-4_2000-5164_2607.wav,VTTS_b-4_2000-5164_2607.wav,5550,5329,221
4312,b-3_5745-5852_5842.wav,VTTS_b-3_5745-5852_5842.wav,6430,6641,-211
4313,b-1_2018-2118_2034.wav,VTTS_b-1_2018-2118_2034.wav,3880,4180,-300
4314,b-3_6401-6500_6443.wav,VTTS_b-3_6401-6500_6443.wav,6360,6060,300
4315,b-2_1427-1562_1523.wav,VTTS_b-2_1427-1562_1523.wav,4640,4354,286
4316,b-1_1313-1413_1351.wav,VTTS_b-1_1313-1413_1351.wav,1110,1103,7
4317,b-3_1568-1665_1608.wav,VTTS_b-3_1568-1665_1608.wav,4940,4551,389
4318,b-3_4607-5008_4632.wav,VTTS_b-3_4607-5008_4632.wav,8630,8812,-182
4319,b-3_4425-4497_4441.wav,VTTS_b-3_4425-4497_4441.wav,6560,6235,325
4320,b-1_3632-3732_3703.wav,VTTS_b-1_3632-3732_3703.wav,7660,6455,1205
4321,b-1_2927-3025_2959.wav,VTTS_b-1_2927-3025_2959.wav,3940,3913,27
4322,b-4_2000-5164_3502.wav,VTTS_b-4_2000-5164_3502.wav,1277,1010,267
4323,b-2_1121-1222_1142.wav,VTTS_b-2_1121-1222_1142.wav,1570,1544,26
4324,b-4_301-400_369.wav,VTTS_b-4_301-400_369.wav,5870,5584,286
4325,b-4_2000-5164_3721.wav,VTTS_b-4_2000-5164_3721.wav,3665,4412,-747
4326,b-3_4607-5008_4933.wav,VTTS_b-3_4607-5008_4933.wav,5820,5108,712
4327,b-4_501-1014_959.wav,VTTS_b-4_501-1014_959.wav,3530,3518,12
4328,b-3_2524-2854_2708.wav,VTTS_b-3_2524-2854_2708.wav,6780,6629,151
4329,b-3_6900-7016_6937.wav,VTTS_b-3_6900-7016_6937.wav,9920,10275,-355
4330,b-3_1666-1763_1735.wav,VTTS_b-3_1666-1763_1735.wav,5560,5074,486
4331,b-4_1221-1300_1243.wav,VTTS_b-4_1221-1300_1243.wav,1960,1800,160
4332,b-1_478-578_545.wav,VTTS_b-1_478-578_545.wav,1050,1080,-30
4333,b-3_3889-4000_3971.wav,VTTS_b-3_3889-4000_3971.wav,11520,11610,-90
4334,b-4_2000-5164_3506.wav,VTTS_b-4_2000-5164_3506.wav,4939,4505,434
4335,b-4_2000-5164_3749.wav,VTTS_b-4_2000-5164_3749.wav,7120,6780,340
4336,b-4_401-500_488.wav,VTTS_b-4_401-500_488.wav,5220,5271,-51
4337,b-4_2000-5164_4880.wav,VTTS_b-4_2000-5164_4880.wav,6771,8046,-1275
4338,b-1_650-685_654.wav,VTTS_b-1_650-685_654.wav,6270,11610,-5340
4339,b-4_2000-5164_2612.wav,VTTS_b-4_2000-5164_2612.wav,8950,9114,-164
4340,b-1_74-174_77.wav,VTTS_b-1_74-174_77.wav,1830,1974,-144
4341,b-4_2000-5164_3878.wav,VTTS_b-4_2000-5164_3878.wav,3647,3646,1
4342,b-3_4104-4206_4180.wav,VTTS_b-3_4104-4206_4180.wav,5350,4818,532
4343,b-1_2321-2421_2340.wav,VTTS_b-1_2321-2421_2340.wav,1870,1869,1
4344,b-4_2000-5164_4724.wav,VTTS_b-4_2000-5164_4724.wav,4397,4505,-108
4345,b-2_1427-1562_1486.wav,VTTS_b-2_1427-1562_1486.wav,4570,3553,1017
4346,b-1_794-1009_881.wav,VTTS_b-1_794-1009_881.wav,2760,3042,-282
4347,b-4_2000-5164_3307.wav,VTTS_b-4_2000-5164_3307.wav,7629,7314,315
4348,b-3_6301-6400_6354.wav,VTTS_b-3_6301-6400_6354.wav,7140,9137,-1997
4349,b-1_276-376_310.wav,VTTS_b-1_276-376_310.wav,1520,1486,34
4350,b-3_5428-5533_5461.wav,VTTS_b-3_5428-5533_5461.wav,4020,4249,-229
4351,b-1_1919-2017_1920.wav,VTTS_b-1_1919-2017_1920.wav,3000,3320,-320
4352,b-3_4607-5008_4815.wav,VTTS_b-3_4607-5008_4815.wav,4590,4063,527
4353,b-4_2000-5164_3096.wav,VTTS_b-4_2000-5164_3096.wav,2807,2612,195
4354,b-4_2000-5164_3027.wav,VTTS_b-4_2000-5164_3027.wav,5091,5480,-389
4355,b-1_2321-2421_2381.wav,VTTS_b-1_2321-2421_2381.wav,2020,2276,-256
4356,b-3_1862-1959_1862.wav,VTTS_b-3_1862-1959_1862.wav,2540,1927,613
4357,b-3_6274-6300_6277.wav,VTTS_b-3_6274-6300_6277.wav,10430,8649,1781
4358,b-3_294-391_377.wav,VTTS_b-3_294-391_377.wav,3980,3796,184
4359,b-4_501-1014_593.wav,VTTS_b-4_501-1014_593.wav,6600,5631,969
4360,b-1_3228-3328_3256.wav,VTTS_b-1_3228-3328_3256.wav,800,766,34
4361,b-4_2000-5164_5126.wav,VTTS_b-4_2000-5164_5126.wav,5756,4981,775
4362,b-4_501-1014_595.wav,VTTS_b-4_501-1014_595.wav,3680,3727,-47
4363,b-1_2220-2320_2221.wav,VTTS_b-1_2220-2320_2221.wav,1740,1730,10
4364,b-4_2000-5164_3931.wav,VTTS_b-4_2000-5164_3931.wav,4422,4342,80
4365,b-3_5009-5427_5013.wav,VTTS_b-3_5009-5427_5013.wav,2940,5724,-2784
4366,b-3_2000-2088_2058.wav,VTTS_b-3_2000-2088_2058.wav,3600,3193,407
4367,b-3_2000-2088_2065.wav,VTTS_b-3_2000-2088_2065.wav,5120,5166,-46
4368,b-2_1699-1800_1752.wav,VTTS_b-2_1699-1800_1752.wav,3420,3111,309
4369,b-1_4070-4105_4097.wav,VTTS_b-1_4070-4105_4097.wav,3610,5515,-1905
4370,b-2_713-814_751.wav,VTTS_b-2_713-814_751.wav,2110,2148,-38
4371,b-1_3026-3126_3121.wav,VTTS_b-1_3026-3126_3121.wav,3660,3634,26
4372,b-3_5639-5744_5649.wav,VTTS_b-3_5639-5744_5649.wav,3090,2775,315
4373,b-3_2524-2854_2547.wav,VTTS_b-3_2524-2854_2547.wav,4110,3483,627
4374,b-1_3531-3631_3609.wav,VTTS_b-1_3531-3631_3609.wav,1820,1846,-26
4375,b-3_3025-3111_3029.wav,VTTS_b-3_3025-3111_3029.wav,3160,3878,-718
4376,b-1_3935-4033_3949.wav,VTTS_b-1_3935-4033_3949.wav,3600,3796,-196
4377,b-3_2350-2433_2408.wav,VTTS_b-3_2350-2433_2408.wav,7640,7024,616
4378,b-1_3632-3732_3724.wav,VTTS_b-1_3632-3732_3724.wav,1180,1091,89
4379,b-2_2311-2412_2360.wav,VTTS_b-2_2311-2412_2360.wav,2260,2032,228
4380,b-4_501-1014_814.wav,VTTS_b-4_501-1014_814.wav,17120,11610,5510
4381,b-2_305-406_306.wav,VTTS_b-2_305-406_306.wav,1640,1544,96
4382,b-3_4607-5008_4820.wav,VTTS_b-3_4607-5008_4820.wav,7680,8011,-331
4383,b-4_2000-5164_3248.wav,VTTS_b-4_2000-5164_3248.wav,1685,2020,-335
4384,b-1_2927-3025_2994.wav,VTTS_b-1_2927-3025_2994.wav,2210,1927,283
4385,b-4_53-150_151.wav,VTTS_b-4_53-150_151.wav,7630,7303,327
4386,b-4_2000-5164_2563.wav,VTTS_b-4_2000-5164_2563.wav,6955,6954,1
4387,b-3_4207-4314_4263.wav,VTTS_b-3_4207-4314_4263.wav,5510,5039,471
4388,b-3_5009-5427_5105.wav,VTTS_b-3_5009-5427_5105.wav,4820,4331,489
4389,b-4_151-300_276.wav,VTTS_b-4_151-300_276.wav,2470,2461,9
4390,b-3_4425-4497_4428.wav,VTTS_b-3_4425-4497_4428.wav,7660,7140,520
4391,b-4_2000-5164_3923.wav,VTTS_b-4_2000-5164_3923.wav,8999,9288,-289
4392,b-4_301-400_349.wav,VTTS_b-4_301-400_349.wav,5860,6002,-142
4393,b-4_2000-5164_3319.wav,VTTS_b-4_2000-5164_3319.wav,1433,1347,86
4394,b-4_2000-5164_2457.wav,VTTS_b-4_2000-5164_2457.wav,2200,2159,41
4395,b-3_5533-5638_5557.wav,VTTS_b-3_5533-5638_5557.wav,4560,4748,-188
4396,b-4_2000-5164_2996.wav,VTTS_b-4_2000-5164_2996.wav,3372,2810,562
4397,b-1_2422-2522_2480.wav,VTTS_b-1_2422-2522_2480.wav,1050,639,411
4398,b-4_1814-1900_1829.wav,VTTS_b-4_1814-1900_1829.wav,5140,5236,-96
4399,b-3_501-930_720.wav,VTTS_b-3_501-930_720.wav,5890,5759,131
4400,b-1_1-73_51.wav,VTTS_b-1_1-73_51.wav,2730,2786,-56
4401,b-4_2000-5164_4719.wav,VTTS_b-4_2000-5164_4719.wav,3447,3587,-140
4402,b-2_1427-1562_1527.wav,VTTS_b-2_1427-1562_1527.wav,7610,8069,-459
4403,b-3_2267-2349_2311.wav,VTTS_b-3_2267-2349_2311.wav,3160,3228,-68
4404,b-3_3198-3278_3264.wav,VTTS_b-3_3198-3278_3264.wav,3820,3413,407
4405,b-2_509-610_600.wav,VTTS_b-2_509-610_600.wav,1450,1533,-83
4406,b-2_1121-1222_1135.wav,VTTS_b-2_1121-1222_1135.wav,1490,1846,-356
4407,b-4_2000-5164_4927.wav,VTTS_b-4_2000-5164_4927.wav,1726,1591,135
4408,b-1_2826-2926_2888.wav,VTTS_b-1_2826-2926_2888.wav,2110,2101,9
4409,b-4_1221-1300_1238.wav,VTTS_b-4_1221-1300_1238.wav,3390,3228,162
4410,b-3_3889-4000_3917.wav,VTTS_b-3_3889-4000_3917.wav,6160,5550,610
4411,b-4_2000-5164_4763.wav,VTTS_b-4_2000-5164_4763.wav,8069,8905,-836
4412,b-3_6900-7016_6970.wav,VTTS_b-3_6900-7016_6970.wav,6570,7732,-1162
4413,b-4_1-52_15.wav,VTTS_b-4_1-52_15.wav,5760,5619,141
4414,b-3_392-500_402.wav,VTTS_b-3_392-500_402.wav,3530,3529,1
4415,b-1_2119-2219_2123.wav,VTTS_b-1_2119-2219_2123.wav,1040,685,355
4416,b-4_301-400_351.wav,VTTS_b-4_301-400_351.wav,6060,6246,-186
4417,b-1_1414-1514_1510.wav,VTTS_b-1_1414-1514_1510.wav,4070,4052,18
4418,b-3_2177-2266_2200.wav,VTTS_b-3_2177-2266_2200.wav,4650,4540,110
4419,b-2_611-712_706.wav,VTTS_b-2_611-712_706.wav,1800,1683,117
4420,b-3_501-930_716.wav,VTTS_b-3_501-930_716.wav,4430,11610,-7180
4421,b-4_2000-5164_3813.wav,VTTS_b-4_2000-5164_3813.wav,6485,5956,529
4422,b-4_1601-1706_1705.wav,VTTS_b-4_1601-1706_1705.wav,14530,11610,2920
4423,b-3_3454-3537_3531.wav,VTTS_b-3_3454-3537_3531.wav,8470,7744,726
4424,b-2_1903-2038_1915.wav,VTTS_b-2_1903-2038_1915.wav,1870,1718,152
4425,b-3_3454-3537_3469.wav,VTTS_b-3_3454-3537_3469.wav,5400,4818,582
4426,b-3_980-1077_1052.wav,VTTS_b-3_980-1077_1052.wav,4380,5062,-682
4427,b-1_2523-2623_2536.wav,VTTS_b-1_2523-2623_2536.wav,2480,2380,100
4428,b-1_3228-3328_3260.wav,VTTS_b-1_3228-3328_3260.wav,2030,1904,126
4429,b-3_4001-4103_4003.wav,VTTS_b-3_4001-4103_4003.wav,1720,1393,327
4430,b-1_1717-1817_1733.wav,VTTS_b-1_1717-1817_1733.wav,2290,1974,316
4431,b-4_2000-5164_4556.wav,VTTS_b-4_2000-5164_4556.wav,1999,2334,-335
4432,b-3_3715-3802_3720.wav,VTTS_b-3_3715-3802_3720.wav,1970,2067,-97
4433,b-3_4001-4103_4015.wav,VTTS_b-3_4001-4103_4015.wav,6930,6920,10
4434,b-2_1699-1800_1768.wav,VTTS_b-2_1699-1800_1768.wav,5620,5248,372
4435,b-3_3628-3714_3655.wav,VTTS_b-3_3628-3714_3655.wav,5120,4748,372
4436,b-3_4607-5008_4692.wav,VTTS_b-3_4607-5008_4692.wav,6570,6931,-361
4437,b-2_101-202_179.wav,VTTS_b-2_101-202_179.wav,2110,2810,-700
4438,b-4_1506-1600_1596.wav,VTTS_b-4_1506-1600_1596.wav,1360,1312,48
4439,b-3_4607-5008_4961.wav,VTTS_b-3_4607-5008_4961.wav,7170,6978,192
4440,b-1_3935-4033_4015.wav,VTTS_b-1_3935-4033_4015.wav,1810,1718,92
4441,b-4_2000-5164_3082.wav,VTTS_b-4_2000-5164_3082.wav,3806,3843,-37
4442,b-3_3889-4000_3986.wav,VTTS_b-3_3889-4000_3986.wav,3200,3193,7
4443,b-2_1019-1120_1096.wav,VTTS_b-2_1019-1120_1096.wav,4680,4969,-289
4444,b-1_1414-1514_1455.wav,VTTS_b-1_1414-1514_1455.wav,2290,2276,14
4445,b-4_1301-1400_1326.wav,VTTS_b-4_1301-1400_1326.wav,1580,1556,24
4446,b-2_2209-2310_2252.wav,VTTS_b-2_2209-2310_2252.wav,3090,3541,-451
4447,b-3_3803-3888_3805.wav,VTTS_b-3_3803-3888_3805.wav,9010,8394,616
4448,b-2_305-406_342.wav,VTTS_b-2_305-406_342.wav,2160,2276,-116
4449,b-1_794-1009_962.wav,VTTS_b-1_794-1009_962.wav,3190,5016,-1826
4450,b-2_509-610_542.wav,VTTS_b-2_509-610_542.wav,2070,1741,329
4451,b-3_501-930_511.wav,VTTS_b-3_501-930_511.wav,7030,6432,598
4452,b-1_686-793_727.wav,VTTS_b-1_686-793_727.wav,1490,1509,-19
4453,b-2_2107-2193_2146.wav,VTTS_b-2_2107-2193_2146.wav,2260,2694,-434
4454,b-1_794-1009_856.wav,VTTS_b-1_794-1009_856.wav,3770,3564,206
4455,b-1_3430-3530_3458.wav,VTTS_b-1_3430-3530_3458.wav,2410,2508,-98
4456,b-4_53-150_126.wav,VTTS_b-4_53-150_126.wav,7710,8231,-521
4457,b-2_713-814_777.wav,VTTS_b-2_713-814_777.wav,5250,5503,-253
4458,b-3_6301-6400_6388.wav,VTTS_b-3_6301-6400_6388.wav,1400,1335,65
4459,b-3_1568-1665_1656.wav,VTTS_b-3_1568-1665_1656.wav,6200,6026,174
4460,b-3_1079-1320_1255.wav,VTTS_b-3_1079-1320_1255.wav,2880,2833,47
4461,b-3_3112-3197_3160.wav,VTTS_b-3_3112-3197_3160.wav,850,813,37
4462,b-1_1-73_32.wav,VTTS_b-1_1-73_32.wav,3290,4365,-1075
4463,b-3_2350-2433_2424.wav,VTTS_b-3_2350-2433_2424.wav,6940,7140,-200
4464,b-2_203-304_219.wav,VTTS_b-2_203-304_219.wav,2890,3657,-767
4465,b-3_2524-2854_2767.wav,VTTS_b-3_2524-2854_2767.wav,4330,4632,-302
4466,b-2_1427-1562_1552.wav,VTTS_b-2_1427-1562_1552.wav,2310,2798,-488
4467,b-2_2209-2310_2238.wav,VTTS_b-2_2209-2310_2238.wav,1990,1823,167
4468,b-2_101-202_104.wav,VTTS_b-2_101-202_104.wav,2000,1823,177
4469,b-3_1079-1320_1145.wav,VTTS_b-3_1079-1320_1145.wav,5560,5190,370
4470,b-1_276-376_370.wav,VTTS_b-1_276-376_370.wav,2510,2682,-172
4471,b-1_3531-3631_3611.wav,VTTS_b-1_3531-3631_3611.wav,6050,8092,-2042
4472,b-1_1313-1413_1413.wav,VTTS_b-1_1313-1413_1413.wav,1120,1161,-41
4473,b-1_2624-2724_2648.wav,VTTS_b-1_2624-2724_2648.wav,4640,4598,42
4474,b-4_501-1014_511.wav,VTTS_b-4_501-1014_511.wav,3940,3901,39
4475,b-4_501-1014_546.wav,VTTS_b-4_501-1014_546.wav,6460,6084,376
4476,b-3_6301-6400_6340.wav,VTTS_b-3_6301-6400_6340.wav,10740,9903,837
4477,b-4_2000-5164_3209.wav,VTTS_b-4_2000-5164_3209.wav,1543,1451,92
4478,b-3_6217-6274_6256.wav,VTTS_b-3_6217-6274_6256.wav,4840,5317,-477
4479,b-3_1321-1568_1328.wav,VTTS_b-3_1321-1568_1328.wav,4450,3994,456
4480,b-3_1079-1320_1221.wav,VTTS_b-3_1079-1320_1221.wav,11120,11610,-490
4481,b-2_815-916_880.wav,VTTS_b-2_815-916_880.wav,1290,1207,83
4482,b-1_276-376_316.wav,VTTS_b-1_276-376_316.wav,1530,1416,114
4483,b-1_3531-3631_3598.wav,VTTS_b-1_3531-3631_3598.wav,3000,2937,63
4484,b-3_6900-7016_6955.wav,VTTS_b-3_6900-7016_6955.wav,5630,6095,-465
4485,b-4_2000-5164_3594.wav,VTTS_b-4_2000-5164_3594.wav,3936,3576,360
4486,b-1_1616-1716_1713.wav,VTTS_b-1_1616-1716_1713.wav,1030,1033,-3
4487,b-3_6900-7016_6949.wav,VTTS_b-3_6900-7016_6949.wav,11050,11610,-560
4488,b-4_2000-5164_4508.wav,VTTS_b-4_2000-5164_4508.wav,2798,2740,58
4489,b-1_2725-2825_2803.wav,VTTS_b-1_2725-2825_2803.wav,3360,4156,-796
4490,b-3_1321-1568_1448.wav,VTTS_b-3_1321-1568_1448.wav,4890,5201,-311
4491,b-1_1-73_33.wav,VTTS_b-1_1-73_33.wav,1600,1939,-339
4492,b-4_2000-5164_3309.wav,VTTS_b-4_2000-5164_3309.wav,6909,7082,-173
4493,b-2_1-100_3.wav,VTTS_b-2_1-100_3.wav,1980,3367,-1387
4494,b-4_501-1014_510.wav,VTTS_b-4_501-1014_510.wav,5370,5271,99
4495,b-1_2220-2320_2305.wav,VTTS_b-1_2220-2320_2305.wav,2020,1892,128
4496,b-4_301-400_328.wav,VTTS_b-4_301-400_328.wav,2630,2543,87
4497,b-1_686-793_721.wav,VTTS_b-1_686-793_721.wav,1920,1904,16
4498,b-3_3198-3278_3271.wav,VTTS_b-3_3198-3278_3271.wav,8580,11088,-2508
4499,b-1_74-174_157.wav,VTTS_b-1_74-174_157.wav,1480,2299,-819
4500,b-3_2524-2854_2532.wav,VTTS_b-3_2524-2854_2532.wav,8440,8092,348
4501,b-4_501-1014_864.wav,VTTS_b-4_501-1014_864.wav,3240,3228,12
4502,b-2_101-202_148.wav,VTTS_b-2_101-202_148.wav,1080,987,93
4503,b-1_1111-1211_1122.wav,VTTS_b-1_1111-1211_1122.wav,1620,1904,-284
4504,b-3_501-930_805.wav,VTTS_b-3_501-930_805.wav,6020,6014,6
4505,b-4_2000-5164_3959.wav,VTTS_b-4_2000-5164_3959.wav,3206,2914,292
4506,b-4_2000-5164_2667.wav,VTTS_b-4_2000-5164_2667.wav,2270,2717,-447
4507,b-3_6601-6700_6614.wav,VTTS_b-3_6601-6700_6614.wav,2880,2659,221
4508,b-1_3026-3126_3052.wav,VTTS_b-1_3026-3126_3052.wav,3740,3959,-219
4509,b-3_4607-5008_4883.wav,VTTS_b-3_4607-5008_4883.wav,6790,6873,-83
4510,b-1_3329-3429_3364.wav,VTTS_b-1_3329-3429_3364.wav,3310,11610,-8300
4511,b-1_3733-3833_3757.wav,VTTS_b-1_3733-3833_3757.wav,3330,3936,-606
4512,b-1_2018-2118_2090.wav,VTTS_b-1_2018-2118_2090.wav,3150,3425,-275
4513,b-4_1601-1706_1651.wav,VTTS_b-4_1601-1706_1651.wav,6620,8255,-1635
4514,b-4_501-1014_641.wav,VTTS_b-4_501-1014_641.wav,3860,3704,156
4515,b-1_2018-2118_2066.wav,VTTS_b-1_2018-2118_2066.wav,4660,5283,-623
4516,b-4_2000-5164_2644.wav,VTTS_b-4_2000-5164_2644.wav,6320,6246,74
4517,b-4_2000-5164_4852.wav,VTTS_b-4_2000-5164_4852.wav,8810,8173,637
4518,b-1_2422-2522_2487.wav,VTTS_b-1_2422-2522_2487.wav,5090,5375,-285
4519,b-1_2927-3025_2988.wav,VTTS_b-1_2927-3025_2988.wav,2360,2090,270
4520,b-2_815-916_890.wav,VTTS_b-2_815-916_890.wav,2540,1985,555
4521,b-3_501-930_568.wav,VTTS_b-3_501-930_568.wav,1460,1068,392
4522,b-3_98-195_109.wav,VTTS_b-3_98-195_109.wav,5820,5840,-20
4523,b-4_501-1014_769.wav,VTTS_b-4_501-1014_769.wav,4940,5573,-633
4524,b-1_3935-4033_3962.wav,VTTS_b-1_3935-4033_3962.wav,1600,1567,33
4525,b-1_1313-1413_1389.wav,VTTS_b-1_1313-1413_1389.wav,3730,3889,-159
4526,b-4_2000-5164_2415.wav,VTTS_b-4_2000-5164_2415.wav,2800,2798,2
4527,b-1_2826-2926_2863.wav,VTTS_b-1_2826-2926_2863.wav,4930,4377,553
4528,b-4_2000-5164_4380.wav,VTTS_b-4_2000-5164_4380.wav,1241,1010,231
4529,b-3_2855-2942_2935.wav,VTTS_b-3_2855-2942_2935.wav,2890,2647,243
4530,b-1_4214-4285_4247.wav,VTTS_b-1_4214-4285_4247.wav,1810,2148,-338
4531,b-1_3632-3732_3656.wav,VTTS_b-1_3632-3732_3656.wav,1210,1161,49
4532,b-3_6601-6700_6682.wav,VTTS_b-3_6601-6700_6682.wav,5880,5700,180
4533,b-3_5745-5852_5821.wav,VTTS_b-3_5745-5852_5821.wav,3090,2577,513
4534,b-1_1111-1211_1200.wav,VTTS_b-1_1111-1211_1200.wav,1330,1184,146
4535,b-3_2350-2433_2432.wav,VTTS_b-3_2350-2433_2432.wav,5550,5097,453
4536,b-3_5009-5427_5259.wav,VTTS_b-3_5009-5427_5259.wav,2530,2496,34
4537,b-3_2524-2854_2656.wav,VTTS_b-3_2524-2854_2656.wav,9350,8429,921
4538,b-3_2177-2266_2190.wav,VTTS_b-3_2177-2266_2190.wav,4630,4911,-281
4539,b-4_501-1014_888.wav,VTTS_b-4_501-1014_888.wav,1860,1846,14
4540,b-4_2000-5164_2159.wav,VTTS_b-4_2000-5164_2159.wav,9380,10298,-918
4541,b-1_74-174_156.wav,VTTS_b-1_74-174_156.wav,2130,1997,133
4542,b-3_3628-3714_3701.wav,VTTS_b-3_3628-3714_3701.wav,6820,6153,667
4543,b-2_2040-2072_2058.wav,VTTS_b-2_2040-2072_2058.wav,4010,3773,237
4544,b-3_6501-6600_6509.wav,VTTS_b-3_6501-6600_6509.wav,3170,3019,151
4545,b-1_1414-1514_1485.wav,VTTS_b-1_1414-1514_1485.wav,4700,4249,451
4546,b-4_53-150_140.wav,VTTS_b-4_53-150_140.wav,9040,8371,669
4547,b-4_1601-1706_1704.wav,VTTS_b-4_1601-1706_1704.wav,5200,5108,92
4548,b-1_3127-3227_3225.wav,VTTS_b-1_3127-3227_3225.wav,1220,1196,24
4549,b-4_2000-5164_4962.wav,VTTS_b-4_2000-5164_4962.wav,5966,5666,300
4550,b-1_2321-2421_2362.wav,VTTS_b-1_2321-2421_2362.wav,1430,1277,153
4551,b-3_6601-6700_6607.wav,VTTS_b-3_6601-6700_6607.wav,4170,5480,-1310
4552,b-3_4607-5008_4911.wav,VTTS_b-3_4607-5008_4911.wav,1950,1904,46
4553,b-4_1301-1400_1386.wav,VTTS_b-4_1301-1400_1386.wav,2230,2043,187
4554,b-3_3803-3888_3832.wav,VTTS_b-3_3803-3888_3832.wav,4980,4923,57
4555,b-3_501-930_780.wav,VTTS_b-3_501-930_780.wav,1790,3437,-1647
4556,b-4_401-500_462.wav,VTTS_b-4_401-500_462.wav,5720,4644,1076
4557,b-4_301-400_355.wav,VTTS_b-4_301-400_355.wav,7820,9381,-1561
4558,b-4_501-1014_857.wav,VTTS_b-4_501-1014_857.wav,3130,3204,-74
4559,b-3_1862-1959_1952.wav,VTTS_b-3_1862-1959_1952.wav,4080,3611,469
4560,b-3_4001-4103_4070.wav,VTTS_b-3_4001-4103_4070.wav,5120,6130,-1010
4561,b-2_203-304_246.wav,VTTS_b-2_203-304_246.wav,1160,1242,-82
4562,b-4_2000-5164_5053.wav,VTTS_b-4_2000-5164_5053.wav,6298,6258,40
4563,b-1_3026-3126_3038.wav,VTTS_b-1_3026-3126_3038.wav,4560,3007,1553
4564,b-2_2311-2412_2325.wav,VTTS_b-2_2311-2412_2325.wav,1050,1126,-76
4565,b-3_1-97_69.wav,VTTS_b-3_1-97_69.wav,3350,3471,-121
4566,b-1_1717-1817_1802.wav,VTTS_b-1_1717-1817_1802.wav,5130,5584,-454
4567,b-3_5745-5852_5754.wav,VTTS_b-3_5745-5852_5754.wav,3780,3727,53
4568,b-4_2000-5164_3121.wav,VTTS_b-4_2000-5164_3121.wav,10884,11610,-726
4569,b-3_5957-6015_5959.wav,VTTS_b-3_5957-6015_5959.wav,4330,4191,139
4570,b-1_579-649_590.wav,VTTS_b-1_579-649_590.wav,2110,2392,-282
4571,b-3_501-930_649.wav,VTTS_b-3_501-930_649.wav,8590,8197,393
4572,b-4_2000-5164_2523.wav,VTTS_b-4_2000-5164_2523.wav,4050,4087,-37
4573,b-2_509-610_580.wav,VTTS_b-2_509-610_580.wav,3660,3657,3
4574,b-3_4607-5008_4855.wav,VTTS_b-3_4607-5008_4855.wav,4000,3785,215
4575,b-4_501-1014_779.wav,VTTS_b-4_501-1014_779.wav,1380,1393,-13
4576,b-3_3454-3537_3532.wav,VTTS_b-3_3454-3537_3532.wav,5860,5840,20
4577,b-4_2000-5164_2033.wav,VTTS_b-4_2000-5164_2033.wav,630,615,15
4578,b-4_2000-5164_3539.wav,VTTS_b-4_2000-5164_3539.wav,4981,5375,-394
4579,b-3_5745-5852_5806.wav,VTTS_b-3_5745-5852_5806.wav,6450,5968,482
4580,b-3_5957-6015_6008.wav,VTTS_b-3_5957-6015_6008.wav,3030,4052,-1022
4581,b-1_1515-1615_1579.wav,VTTS_b-1_1515-1615_1579.wav,1090,1045,45
4582,b-2_1801-1902_1833.wav,VTTS_b-2_1801-1902_1833.wav,3340,2752,588
4583,b-4_2000-5164_2401.wav,VTTS_b-4_2000-5164_2401.wav,16460,11610,4850
4584,b-4_2000-5164_2852.wav,VTTS_b-4_2000-5164_2852.wav,2165,1869,296
4585,b-4_2000-5164_5089.wav,VTTS_b-4_2000-5164_5089.wav,3299,3239,60
4586,b-3_1960-2000_1977.wav,VTTS_b-3_1960-2000_1977.wav,4830,4296,534
4587,b-2_1121-1222_1147.wav,VTTS_b-2_1121-1222_1147.wav,2230,2543,-313
4588,b-1_4106-4141_4108.wav,VTTS_b-1_4106-4141_4108.wav,4440,4702,-262
4589,b-3_2524-2854_2595.wav,VTTS_b-3_2524-2854_2595.wav,5370,5201,169
4590,b-4_53-150_101.wav,VTTS_b-4_53-150_101.wav,8560,7755,805
4591,b-4_2000-5164_2941.wav,VTTS_b-4_2000-5164_2941.wav,4476,3808,668
4592,b-3_501-930_872.wav,VTTS_b-3_501-930_872.wav,4490,4040,450
4593,b-3_6701-6800_6780.wav,VTTS_b-3_6701-6800_6780.wav,6060,6072,-12
4594,b-4_2000-5164_2748.wav,VTTS_b-4_2000-5164_2748.wav,2900,3228,-328
4595,b-3_5957-6015_5980.wav,VTTS_b-3_5957-6015_5980.wav,7120,10368,-3248
4596,b-3_3025-3111_3063.wav,VTTS_b-3_3025-3111_3063.wav,2910,3135,-225
4597,b-1_2422-2522_2433.wav,VTTS_b-1_2422-2522_2433.wav,1750,1672,78
4598,b-3_1-97_6.wav,VTTS_b-3_1-97_6.wav,7880,9660,-1780
4599,b-4_151-300_157.wav,VTTS_b-4_151-300_157.wav,4170,4040,130
4600,b-3_2524-2854_2792.wav,VTTS_b-3_2524-2854_2792.wav,12050,11424,626
4601,b-3_4607-5008_4851.wav,VTTS_b-3_4607-5008_4851.wav,3040,3704,-664
4602,b-4_1506-1600_1515.wav,VTTS_b-4_1506-1600_1515.wav,7390,7175,215
4603,b-3_501-930_745.wav,VTTS_b-3_501-930_745.wav,3040,2763,277
4604,b-3_4207-4314_4300.wav,VTTS_b-3_4207-4314_4300.wav,2670,2136,534
4605,b-2_1223-1324_1273.wav,VTTS_b-2_1223-1324_1273.wav,8240,8684,-444
4606,b-3_1-97_4.wav,VTTS_b-3_1-97_4.wav,6770,6780,-10
4607,b-1_1313-1413_1386.wav,VTTS_b-1_1313-1413_1386.wav,1780,1916,-136
4608,b-3_5009-5427_5277.wav,VTTS_b-3_5009-5427_5277.wav,3110,11610,-8500
4609,b-1_4466-4498_4475.wav,VTTS_b-1_4466-4498_4475.wav,4720,5375,-655
4610,b-4_1601-1706_1690.wav,VTTS_b-4_1601-1706_1690.wav,8210,7465,745
4611,b-3_980-1077_1062.wav,VTTS_b-3_980-1077_1062.wav,5490,5898,-408
4612,b-2_1427-1562_1459.wav,VTTS_b-2_1427-1562_1459.wav,2030,1939,91
4613,b-3_5009-5427_5281.wav,VTTS_b-3_5009-5427_5281.wav,5500,5677,-177
4614,b-4_2000-5164_2071.wav,VTTS_b-4_2000-5164_2071.wav,6865,11610,-4745
4615,b-1_4178-4213_4192.wav,VTTS_b-1_4178-4213_4192.wav,3260,3936,-676
4616,b-4_2000-5164_3877.wav,VTTS_b-4_2000-5164_3877.wav,3256,3437,-181
4617,b-3_5853-5956_5929.wav,VTTS_b-3_5853-5956_5929.wav,2840,2670,170
4618,b-1_3127-3227_3206.wav,VTTS_b-1_3127-3227_3206.wav,3060,3239,-179
4619,b-3_980-1077_1000.wav,VTTS_b-3_980-1077_1000.wav,1900,1927,-27
4620,b-3_6801-6900_6803.wav,VTTS_b-3_6801-6900_6803.wav,3760,3785,-25
4621,b-1_3430-3530_3513.wav,VTTS_b-1_3430-3530_3513.wav,3340,4760,-1420
4622,b-1_3430-3530_3515.wav,VTTS_b-1_3430-3530_3515.wav,1380,1265,115
4623,b-4_2000-5164_4527.wav,VTTS_b-4_2000-5164_4527.wav,5218,5666,-448
4624,b-1_3834-3934_3876.wav,VTTS_b-1_3834-3934_3876.wav,2750,3471,-721
4625,b-3_5639-5744_5655.wav,VTTS_b-3_5639-5744_5655.wav,3080,3042,38
4626,b-4_2000-5164_4627.wav,VTTS_b-4_2000-5164_4627.wav,4185,4203,-18
4627,b-3_4607-5008_4706.wav,VTTS_b-3_4607-5008_4706.wav,4300,3762,538
4628,b-1_3531-3631_3617.wav,VTTS_b-1_3531-3631_3617.wav,2710,2763,-53
4629,b-2_1699-1800_1762.wav,VTTS_b-2_1699-1800_1762.wav,1430,1219,211
4630,b-4_2000-5164_3473.wav,VTTS_b-4_2000-5164_3473.wav,5299,6525,-1226
4631,b-3_5009-5427_5275.wav,VTTS_b-3_5009-5427_5275.wav,3560,3239,321
4632,b-3_2267-2349_2346.wav,VTTS_b-3_2267-2349_2346.wav,3950,3680,270
4633,b-3_4607-5008_4965.wav,VTTS_b-3_4607-5008_4965.wav,5510,5178,332
4634,b-3_3364-3453_3377.wav,VTTS_b-3_3364-3453_3377.wav,4750,4853,-103
4635,b-3_5639-5744_5689.wav,VTTS_b-3_5639-5744_5689.wav,4650,4319,331
4636,b-4_1601-1706_1680.wav,VTTS_b-4_1601-1706_1680.wav,2390,2125,265
4637,b-4_2000-5164_3296.wav,VTTS_b-4_2000-5164_3296.wav,8381,8406,-25
4638,b-4_2000-5164_2285.wav,VTTS_b-4_2000-5164_2285.wav,2880,3228,-348
4639,b-2_1121-1222_1155.wav,VTTS_b-2_1121-1222_1155.wav,4270,3704,566
4640,b-4_2000-5164_4120.wav,VTTS_b-4_2000-5164_4120.wav,3307,1149,2158
4641,b-3_4207-4314_4214.wav,VTTS_b-3_4207-4314_4214.wav,7780,7140,640
4642,b-3_1862-1959_1911.wav,VTTS_b-3_1862-1959_1911.wav,4480,5770,-1290
4643,b-3_5009-5427_5030.wav,VTTS_b-3_5009-5427_5030.wav,6310,5468,842
4644,b-2_611-712_628.wav,VTTS_b-2_611-712_628.wav,3700,4075,-375
4645,b-4_1014-1100_1059.wav,VTTS_b-4_1014-1100_1059.wav,4260,4377,-117
4646,b-4_2000-5164_4132.wav,VTTS_b-4_2000-5164_4132.wav,4422,5492,-1070
4647,b-1_2826-2926_2916.wav,VTTS_b-1_2826-2926_2916.wav,2950,3077,-127
4648,b-3_294-391_343.wav,VTTS_b-3_294-391_343.wav,6350,5654,696
4649,b-3_3538-3627_3556.wav,VTTS_b-3_3538-3627_3556.wav,4050,3518,532
4650,b-4_2000-5164_5038.wav,VTTS_b-4_2000-5164_5038.wav,2016,2009,7
4651,b-4_2000-5164_4886.wav,VTTS_b-4_2000-5164_4886.wav,5212,5642,-430
4652,b-4_2000-5164_2585.wav,VTTS_b-4_2000-5164_2585.wav,2660,2345,315
4653,b-1_1616-1716_1626.wav,VTTS_b-1_1616-1716_1626.wav,1530,1556,-26
4654,b-4_1601-1706_1676.wav,VTTS_b-4_1601-1706_1676.wav,5010,4632,378
4655,b-1_1313-1413_1338.wav,VTTS_b-1_1313-1413_1338.wav,1130,1219,-89
4656,b-4_301-400_352.wav,VTTS_b-4_301-400_352.wav,6670,8034,-1364
4657,b-1_794-1009_795.wav,VTTS_b-1_794-1009_795.wav,2880,2601,279
4658,b-3_5853-5956_5938.wav,VTTS_b-3_5853-5956_5938.wav,4510,6687,-2177
4659,b-3_2434-2523_2473.wav,VTTS_b-3_2434-2523_2473.wav,3440,3204,236
4660,b-4_2000-5164_3142.wav,VTTS_b-4_2000-5164_3142.wav,5903,5410,493
4661,b-4_1221-1300_1245.wav,VTTS_b-4_1221-1300_1245.wav,4840,5004,-164
4662,b-2_101-202_197.wav,VTTS_b-2_101-202_197.wav,1550,1579,-29
4663,b-4_2000-5164_3990.wav,VTTS_b-4_2000-5164_3990.wav,2021,2067,-46
4664,b-3_6116-6215_6166.wav,VTTS_b-3_6116-6215_6166.wav,3270,3297,-27
4665,b-3_5009-5427_5143.wav,VTTS_b-3_5009-5427_5143.wav,1340,1161,179
4666,b-2_1019-1120_1091.wav,VTTS_b-2_1019-1120_1091.wav,1460,1567,-107
4667,b-1_4430-4465_4447.wav,VTTS_b-1_4430-4465_4447.wav,2040,2403,-363
4668,b-4_2000-5164_3240.wav,VTTS_b-4_2000-5164_3240.wav,1333,1254,79
4669,b-4_2000-5164_4148.wav,VTTS_b-4_2000-5164_4148.wav,5294,4923,371
4670,b-3_1079-1320_1179.wav,VTTS_b-3_1079-1320_1179.wav,7060,6803,257
4671,b-2_2107-2193_2129.wav,VTTS_b-2_2107-2193_2129.wav,2780,2635,145
4672,b-1_2018-2118_2079.wav,VTTS_b-1_2018-2118_2079.wav,2080,2125,-45
4673,b-4_2000-5164_4251.wav,VTTS_b-4_2000-5164_4251.wav,5036,5851,-815
4674,b-3_5745-5852_5848.wav,VTTS_b-3_5745-5852_5848.wav,3440,3518,-78
4675,b-2_1903-2038_1974.wav,VTTS_b-2_1903-2038_1974.wav,2800,2531,269
4676,b-2_713-814_767.wav,VTTS_b-2_713-814_767.wav,1790,1707,83
4677,b-4_501-1014_588.wav,VTTS_b-4_501-1014_588.wav,3030,4110,-1080
4678,b-1_3834-3934_3872.wav,VTTS_b-1_3834-3934_3872.wav,2740,2868,-128
4679,b-3_5009-5427_5175.wav,VTTS_b-3_5009-5427_5175.wav,3580,4110,-530
4680,b-3_4104-4206_4192.wav,VTTS_b-3_4104-4206_4192.wav,4290,4087,203
4681,b-3_2177-2266_2187.wav,VTTS_b-3_2177-2266_2187.wav,3750,2740,1010
4682,b-3_6801-6900_6833.wav,VTTS_b-3_6801-6900_6833.wav,6720,5468,1252
4683,b-4_401-500_457.wav,VTTS_b-4_401-500_457.wav,940,789,151
4684,b-1_1-73_14.wav,VTTS_b-1_1-73_14.wav,1780,2101,-321
4685,b-1_4070-4105_4093.wav,VTTS_b-1_4070-4105_4093.wav,6440,8290,-1850
4686,b-3_1079-1320_1199.wav,VTTS_b-3_1079-1320_1199.wav,6280,6211,69
4687,b-1_3430-3530_3475.wav,VTTS_b-1_3430-3530_3475.wav,1750,2717,-967
4688,b-3_6217-6274_6255.wav,VTTS_b-3_6217-6274_6255.wav,11000,11610,-610
4689,b-3_98-195_174.wav,VTTS_b-3_98-195_174.wav,3010,2705,305
4690,b-3_2524-2854_2699.wav,VTTS_b-3_2524-2854_2699.wav,5260,6316,-1056
4691,b-3_2267-2349_2321.wav,VTTS_b-3_2267-2349_2321.wav,5350,5108,242
4692,b-3_6217-6274_6257.wav,VTTS_b-3_6217-6274_6257.wav,9940,10437,-497
4693,b-4_2000-5164_2113.wav,VTTS_b-4_2000-5164_2113.wav,1080,1184,-104
4694,b-3_5009-5427_5400.wav,VTTS_b-3_5009-5427_5400.wav,3140,3077,63
4695,b-4_1901-2000_1960.wav,VTTS_b-4_1901-2000_1960.wav,3830,3495,335
4696,b-4_301-400_339.wav,VTTS_b-4_301-400_339.wav,1110,1115,-5
4697,b-3_6501-6600_6519.wav,VTTS_b-3_6501-6600_6519.wav,5430,5283,147
4698,b-1_1010-1110_1037.wav,VTTS_b-1_1010-1110_1037.wav,2370,2101,269
4699,b-3_6401-6500_6487.wav,VTTS_b-3_6401-6500_6487.wav,9730,11041,-1311
4700,b-4_2000-5164_3385.wav,VTTS_b-4_2000-5164_3385.wav,3035,3123,-88
4701,b-1_4214-4285_4214.wav,VTTS_b-1_4214-4285_4214.wav,1010,1033,-23
4702,b-2_2209-2310_2232.wav,VTTS_b-2_2209-2310_2232.wav,1480,1358,122
4703,b-3_2000-2088_2061.wav,VTTS_b-3_2000-2088_2061.wav,4690,4272,418
4704,b-1_2119-2219_2214.wav,VTTS_b-1_2119-2219_2214.wav,2180,2380,-200
4705,b-3_1862-1959_1945.wav,VTTS_b-3_1862-1959_1945.wav,6410,5956,454
4706,b-2_509-610_559.wav,VTTS_b-2_509-610_559.wav,4250,4609,-359
4707,b-3_5009-5427_5360.wav,VTTS_b-3_5009-5427_5360.wav,3390,3320,70
4708,b-4_2000-5164_4407.wav,VTTS_b-4_2000-5164_4407.wav,3215,3344,-129
4709,b-2_611-712_661.wav,VTTS_b-2_611-712_661.wav,2470,2531,-61
4710,b-4_2000-5164_2570.wav,VTTS_b-4_2000-5164_2570.wav,5290,5364,-74
4711,b-1_3834-3934_3897.wav,VTTS_b-1_3834-3934_3897.wav,1270,1382,-112
4712,b-4_2000-5164_3112.wav,VTTS_b-4_2000-5164_3112.wav,4771,4667,104
4713,b-1_2422-2522_2485.wav,VTTS_b-1_2422-2522_2485.wav,3160,3344,-184
4714,b-3_5009-5427_5403.wav,VTTS_b-3_5009-5427_5403.wav,6350,7454,-1104
4715,b-2_1325-1426_1360.wav,VTTS_b-2_1325-1426_1360.wav,1530,1393,137
4716,b-4_2000-5164_3114.wav,VTTS_b-4_2000-5164_3114.wav,8312,8835,-523
4717,b-4_2000-5164_2298.wav,VTTS_b-4_2000-5164_2298.wav,9980,9752,228
4718,b-3_501-930_795.wav,VTTS_b-3_501-930_795.wav,3270,3495,-225
4719,b-1_1010-1110_1102.wav,VTTS_b-1_1010-1110_1102.wav,1840,3111,-1271
4720,b-3_2943-3024_3021.wav,VTTS_b-3_2943-3024_3021.wav,1130,1138,-8
4721,b-4_2000-5164_2306.wav,VTTS_b-4_2000-5164_2306.wav,5790,11610,-5820
4722,b-4_1-52_5.wav,VTTS_b-4_1-52_5.wav,5180,4748,432
4723,b-3_4607-5008_4696.wav,VTTS_b-3_4607-5008_4696.wav,4710,5294,-584
4724,b-4_501-1014_832.wav,VTTS_b-4_501-1014_832.wav,5130,5201,-71
4725,b-3_6501-6600_6590.wav,VTTS_b-3_6501-6600_6590.wav,4160,2287,1873
4726,b-2_1223-1324_1317.wav,VTTS_b-2_1223-1324_1317.wav,1650,1811,-161
4727,b-1_74-174_108.wav,VTTS_b-1_74-174_108.wav,4380,4319,61
4728,b-4_1707-1813_1770.wav,VTTS_b-4_1707-1813_1770.wav,3200,4528,-1328
4729,b-4_501-1014_916.wav,VTTS_b-4_501-1014_916.wav,12430,11610,820
4730,b-3_1862-1959_1910.wav,VTTS_b-3_1862-1959_1910.wav,3630,3274,356
4731,b-3_1079-1320_1168.wav,VTTS_b-3_1079-1320_1168.wav,4780,4679,101
4732,b-1_3026-3126_3027.wav,VTTS_b-1_3026-3126_3027.wav,1470,1486,-16
4733,b-4_2000-5164_2652.wav,VTTS_b-4_2000-5164_2652.wav,3160,3135,25
4734,b-3_3628-3714_3652.wav,VTTS_b-3_3628-3714_3652.wav,2950,2949,1
4735,b-1_3127-3227_3220.wav,VTTS_b-1_3127-3227_3220.wav,1590,1474,116
4736,b-1_276-376_285.wav,VTTS_b-1_276-376_285.wav,1880,1649,231
4737,b-2_713-814_775.wav,VTTS_b-2_713-814_775.wav,1680,1265,415
4738,b-1_1919-2017_1991.wav,VTTS_b-1_1919-2017_1991.wav,4570,4481,89
4739,b-3_1079-1320_1177.wav,VTTS_b-3_1079-1320_1177.wav,6850,6745,105
4740,b-2_1121-1222_1138.wav,VTTS_b-2_1121-1222_1138.wav,2560,2159,401
4741,b-2_2107-2193_2145.wav,VTTS_b-2_2107-2193_2145.wav,1820,1788,32
4742,b-3_1321-1568_1403.wav,VTTS_b-3_1321-1568_1403.wav,8540,8940,-400
4743,b-4_2000-5164_3497.wav,VTTS_b-4_2000-5164_3497.wav,8261,11413,-3152
4744,b-1_4286-4321_4312.wav,VTTS_b-1_4286-4321_4312.wav,3490,4957,-1467
4745,b-4_2000-5164_3888.wav,VTTS_b-4_2000-5164_3888.wav,1415,1881,-466
4746,b-3_6401-6500_6484.wav,VTTS_b-3_6401-6500_6484.wav,4480,4249,231
4747,b-2_1325-1426_1384.wav,VTTS_b-2_1325-1426_1384.wav,3310,2891,419
4748,b-2_2073-2106_2085.wav,VTTS_b-2_2073-2106_2085.wav,3160,5097,-1937
4749,b-3_5639-5744_5677.wav,VTTS_b-3_5639-5744_5677.wav,4500,4992,-492
4750,b-2_1597-1698_1687.wav,VTTS_b-2_1597-1698_1687.wav,9440,9543,-103
4751,b-1_1313-1413_1369.wav,VTTS_b-1_1313-1413_1369.wav,1080,940,140
4752,b-4_2000-5164_4754.wav,VTTS_b-4_2000-5164_4754.wav,4341,4214,127
4753,b-2_1427-1562_1427.wav,VTTS_b-2_1427-1562_1427.wav,1160,1207,-47
4754,b-3_2350-2433_2372.wav,VTTS_b-3_2350-2433_2372.wav,4020,4122,-102
4755,b-4_2000-5164_5081.wav,VTTS_b-4_2000-5164_5081.wav,3751,3471,280
4756,b-4_1401-1505_1489.wav,VTTS_b-4_1401-1505_1489.wav,3570,3855,-285
4757,b-2_713-814_719.wav,VTTS_b-2_713-814_719.wav,2710,4400,-1690
4758,b-4_2000-5164_5122.wav,VTTS_b-4_2000-5164_5122.wav,8631,9578,-947
4759,b-3_4315-4424_4397.wav,VTTS_b-3_4315-4424_4397.wav,5180,6084,-904
4760,b-3_4315-4424_4320.wav,VTTS_b-3_4315-4424_4320.wav,3740,3529,211
4761,b-3_3889-4000_3995.wav,VTTS_b-3_3889-4000_3995.wav,4240,3704,536
4762,b-3_6701-6800_6711.wav,VTTS_b-3_6701-6800_6711.wav,9590,9660,-70
4763,b-4_2000-5164_3971.wav,VTTS_b-4_2000-5164_3971.wav,4900,4435,465
4764,b-3_4498-4605_4581.wav,VTTS_b-3_4498-4605_4581.wav,8090,9253,-1163
4765,b-1_1414-1514_1457.wav,VTTS_b-1_1414-1514_1457.wav,4630,4969,-339
4766,b-1_3632-3732_3722.wav,VTTS_b-1_3632-3732_3722.wav,1490,2624,-1134
4767,b-1_686-793_761.wav,VTTS_b-1_686-793_761.wav,1180,1265,-85
4768,b-1_3430-3530_3506.wav,VTTS_b-1_3430-3530_3506.wav,1420,1533,-113
4769,b-1_3935-4033_3969.wav,VTTS_b-1_3935-4033_3969.wav,3560,3355,205
4770,b-4_401-500_497.wav,VTTS_b-4_401-500_497.wav,2730,2995,-265
4771,b-4_2000-5164_2592.wav,VTTS_b-4_2000-5164_2592.wav,4635,4737,-102
4772,b-4_2000-5164_2627.wav,VTTS_b-4_2000-5164_2627.wav,5110,5213,-103
4773,b-3_1862-1959_1887.wav,VTTS_b-3_1862-1959_1887.wav,3960,3901,59
4774,b-3_3889-4000_3907.wav,VTTS_b-3_3889-4000_3907.wav,8200,8011,189
4775,b-1_3026-3126_3073.wav,VTTS_b-1_3026-3126_3073.wav,2750,2752,-2
4776,b-1_2220-2320_2302.wav,VTTS_b-1_2220-2320_2302.wav,2400,2276,124
4777,b-3_1079-1320_1274.wav,VTTS_b-3_1079-1320_1274.wav,7290,6594,696
4778,b-1_1616-1716_1623.wav,VTTS_b-1_1616-1716_1623.wav,2700,3332,-632
4779,b-1_276-376_345.wav,VTTS_b-1_276-376_345.wav,1750,1800,-50
4780,b-1_1919-2017_2016.wav,VTTS_b-1_1919-2017_2016.wav,5520,5875,-355
4781,b-3_6900-7016_6995.wav,VTTS_b-3_6900-7016_6995.wav,3600,2891,709
4782,b-4_2000-5164_4292.wav,VTTS_b-4_2000-5164_4292.wav,3442,3750,-308
4783,b-4_2000-5164_3335.wav,VTTS_b-4_2000-5164_3335.wav,7478,8127,-649
4784,b-4_2000-5164_4682.wav,VTTS_b-4_2000-5164_4682.wav,1572,1544,28
4785,b-1_175-275_190.wav,VTTS_b-1_175-275_190.wav,1070,1091,-21
4786,b-1_4142-4177_4162.wav,VTTS_b-1_4142-4177_4162.wav,3060,2879,181
4787,b-4_2000-5164_3905.wav,VTTS_b-4_2000-5164_3905.wav,3151,3762,-611
4788,b-3_6016-6115_6041.wav,VTTS_b-3_6016-6115_6041.wav,5290,4772,518
4789,b-3_2089-2176_2134.wav,VTTS_b-3_2089-2176_2134.wav,7030,7047,-17
4790,b-2_611-712_639.wav,VTTS_b-2_611-712_639.wav,1210,1347,-137
4791,b-3_2524-2854_2570.wav,VTTS_b-3_2524-2854_2570.wav,3140,3146,-6
4792,b-1_2826-2926_2882.wav,VTTS_b-1_2826-2926_2882.wav,4530,4679,-149
4793,b-1_1111-1211_1172.wav,VTTS_b-1_1111-1211_1172.wav,1950,1811,139
4794,b-2_2107-2193_2152.wav,VTTS_b-2_2107-2193_2152.wav,1550,1881,-331
4795,b-4_2000-5164_2598.wav,VTTS_b-4_2000-5164_2598.wav,5140,4632,508
4796,b-1_175-275_194.wav,VTTS_b-1_175-275_194.wav,1640,1567,73
4797,b-2_1325-1426_1417.wav,VTTS_b-2_1325-1426_1417.wav,4010,3251,759
4798,b-1_1919-2017_2013.wav,VTTS_b-1_1919-2017_2013.wav,2030,2241,-211
4799,b-3_1079-1320_1122.wav,VTTS_b-3_1079-1320_1122.wav,4530,4319,211
4800,b-2_407-508_482.wav,VTTS_b-2_407-508_482.wav,1500,1533,-33
4801,b-2_101-202_140.wav,VTTS_b-2_101-202_140.wav,1250,1370,-120
4802,b-1_3531-3631_3590.wav,VTTS_b-1_3531-3631_3590.wav,1600,1567,33
4803,b-3_4607-5008_4680.wav,VTTS_b-3_4607-5008_4680.wav,2940,3599,-659
4804,b-1_794-1009_987.wav,VTTS_b-1_794-1009_987.wav,1510,1486,24
4805,b-3_1321-1568_1530.wav,VTTS_b-3_1321-1568_1530.wav,5220,5341,-121
4806,b-4_2000-5164_4320.wav,VTTS_b-4_2000-5164_4320.wav,6964,11610,-4646
4807,b-2_101-202_178.wav,VTTS_b-2_101-202_178.wav,1060,1045,15
4808,b-4_1-52_48.wav,VTTS_b-4_1-52_48.wav,16130,11610,4520
4809,b-3_6701-6800_6720.wav,VTTS_b-3_6701-6800_6720.wav,5810,5828,-18
4810,b-1_2220-2320_2242.wav,VTTS_b-1_2220-2320_2242.wav,1970,1997,-27
4811,b-4_501-1014_860.wav,VTTS_b-4_501-1014_860.wav,4800,4435,365
4812,b-2_1427-1562_1541.wav,VTTS_b-2_1427-1562_1541.wav,3040,2856,184
4813,b-2_1699-1800_1799.wav,VTTS_b-2_1699-1800_1799.wav,3630,3506,124
4814,b-3_4607-5008_4951.wav,VTTS_b-3_4607-5008_4951.wav,4630,4040,590
4815,b-4_2000-5164_4243.wav,VTTS_b-4_2000-5164_4243.wav,4231,4249,-18
4816,b-1_3127-3227_3216.wav,VTTS_b-1_3127-3227_3216.wav,1920,2101,-181
4817,b-4_2000-5164_4180.wav,VTTS_b-4_2000-5164_4180.wav,4827,6861,-2034
4818,b-1_2018-2118_2055.wav,VTTS_b-1_2018-2118_2055.wav,1570,1858,-288
4819,b-4_2000-5164_3184.wav,VTTS_b-4_2000-5164_3184.wav,6208,6293,-85
4820,b-1_650-685_656.wav,VTTS_b-1_650-685_656.wav,5040,4772,268
4821,b-3_6301-6400_6394.wav,VTTS_b-3_6301-6400_6394.wav,4250,4087,163
4822,b-1_1515-1615_1560.wav,VTTS_b-1_1515-1615_1560.wav,2580,2357,223
4823,b-2_407-508_506.wav,VTTS_b-2_407-508_506.wav,1940,1254,686
4824,b-3_1079-1320_1257.wav,VTTS_b-3_1079-1320_1257.wav,5120,4528,592
4825,b-3_3454-3537_3499.wav,VTTS_b-3_3454-3537_3499.wav,6260,6246,14
4826,b-4_2000-5164_3703.wav,VTTS_b-4_2000-5164_3703.wav,5835,6084,-249
4827,b-4_2000-5164_4698.wav,VTTS_b-4_2000-5164_4698.wav,3440,3262,178
4828,b-3_1-97_56.wav,VTTS_b-3_1-97_56.wav,5070,4911,159
4829,b-3_1862-1959_1876.wav,VTTS_b-3_1862-1959_1876.wav,1780,1800,-20
4830,b-3_5853-5956_5899.wav,VTTS_b-3_5853-5956_5899.wav,1370,1347,23
4831,b-2_611-712_692.wav,VTTS_b-2_611-712_692.wav,4250,3971,279
4832,b-1_3935-4033_3997.wav,VTTS_b-1_3935-4033_3997.wav,3700,3320,380
4833,b-1_3329-3429_3417.wav,VTTS_b-1_3329-3429_3417.wav,3390,3123,267
4834,b-4_1506-1600_1569.wav,VTTS_b-4_1506-1600_1569.wav,2770,2438,332
4835,b-2_2413-2500_2483.wav,VTTS_b-2_2413-2500_2483.wav,3560,3622,-62
4836,b-1_579-649_582.wav,VTTS_b-1_579-649_582.wav,6900,5979,921
4837,b-3_501-930_852.wav,VTTS_b-3_501-930_852.wav,4480,4122,358
4838,b-3_6501-6600_6588.wav,VTTS_b-3_6501-6600_6588.wav,5810,5596,214
4839,b-1_175-275_254.wav,VTTS_b-1_175-275_254.wav,3390,4156,-766
4840,b-4_2000-5164_2228.wav,VTTS_b-4_2000-5164_2228.wav,3680,4191,-511
4841,b-4_2000-5164_4838.wav,VTTS_b-4_2000-5164_4838.wav,3155,2902,253
4842,b-3_4001-4103_4025.wav,VTTS_b-3_4001-4103_4025.wav,7460,7291,169
4843,b-3_2524-2854_2622.wav,VTTS_b-3_2524-2854_2622.wav,7720,10449,-2729
4844,b-3_501-930_698.wav,VTTS_b-3_501-930_698.wav,7730,6583,1147
4845,b-1_74-174_153.wav,VTTS_b-1_74-174_153.wav,1950,1997,-47
4846,b-4_2000-5164_4929.wav,VTTS_b-4_2000-5164_4929.wav,1995,2264,-269
4847,b-3_5957-6015_5996.wav,VTTS_b-3_5957-6015_5996.wav,5590,5584,6
4848,b-4_2000-5164_2453.wav,VTTS_b-4_2000-5164_2453.wav,5370,4841,529
4849,b-1_4430-4465_4444.wav,VTTS_b-1_4430-4465_4444.wav,3040,2485,555
4850,b-1_1111-1211_1213.wav,VTTS_b-1_1111-1211_1213.wav,2020,1962,58
4851,b-4_501-1014_878.wav,VTTS_b-4_501-1014_878.wav,5790,5677,113
4852,b-3_5009-5427_5039.wav,VTTS_b-3_5009-5427_5039.wav,7010,7245,-235
4853,b-3_5745-5852_5759.wav,VTTS_b-3_5745-5852_5759.wav,4370,4783,-413
4854,b-4_2000-5164_2146.wav,VTTS_b-4_2000-5164_2146.wav,5850,6130,-280
4855,b-4_2000-5164_3881.wav,VTTS_b-4_2000-5164_3881.wav,5140,5155,-15
4856,b-4_301-400_325.wav,VTTS_b-4_301-400_325.wav,5010,5399,-389
4857,b-4_2000-5164_4834.wav,VTTS_b-4_2000-5164_4834.wav,4518,4632,-114
4858,b-3_5428-5533_5499.wav,VTTS_b-3_5428-5533_5499.wav,4280,4272,8
4859,b-4_2000-5164_4850.wav,VTTS_b-4_2000-5164_4850.wav,6355,5898,457
4860,b-3_2434-2523_2498.wav,VTTS_b-3_2434-2523_2498.wav,4590,4052,538
4861,b-1_3834-3934_3921.wav,VTTS_b-1_3834-3934_3921.wav,1110,1091,19
4862,b-3_4315-4424_4368.wav,VTTS_b-3_4315-4424_4368.wav,8700,8197,503
4863,b-3_6301-6400_6324.wav,VTTS_b-3_6301-6400_6324.wav,7090,6223,867
4864,b-4_2000-5164_2634.wav,VTTS_b-4_2000-5164_2634.wav,2340,2461,-121
4865,b-3_5639-5744_5681.wav,VTTS_b-3_5639-5744_5681.wav,5170,5608,-438
4866,b-2_203-304_244.wav,VTTS_b-2_203-304_244.wav,2250,2218,32
4867,b-1_1515-1615_1602.wav,VTTS_b-1_1515-1615_1602.wav,2220,1962,258
4868,b-2_2209-2310_2228.wav,VTTS_b-2_2209-2310_2228.wav,1460,1335,125
4869,b-1_3026-3126_3068.wav,VTTS_b-1_3026-3126_3068.wav,2220,1997,223
4870,b-1_3430-3530_3530.wav,VTTS_b-1_3430-3530_3530.wav,1720,1579,141
4871,b-1_2220-2320_2266.wav,VTTS_b-1_2220-2320_2266.wav,1730,2554,-824
4872,b-2_1325-1426_1364.wav,VTTS_b-2_1325-1426_1364.wav,2660,3170,-510
4873,b-1_579-649_625.wav,VTTS_b-1_579-649_625.wav,2470,5492,-3022
4874,b-3_501-930_565.wav,VTTS_b-3_501-930_565.wav,6450,5492,958
4875,b-2_2311-2412_2328.wav,VTTS_b-2_2311-2412_2328.wav,1950,1405,545
4876,b-3_5009-5427_5070.wav,VTTS_b-3_5009-5427_5070.wav,1290,1486,-196
4877,b-3_3112-3197_3143.wav,VTTS_b-3_3112-3197_3143.wav,6100,5991,109
4878,b-1_4214-4285_4234.wav,VTTS_b-1_4214-4285_4234.wav,3460,4435,-975
4879,b-1_3127-3227_3151.wav,VTTS_b-1_3127-3227_3151.wav,1050,1173,-123
4880,b-3_4607-5008_4667.wav,VTTS_b-3_4607-5008_4667.wav,2090,2171,-81
4881,b-4_2000-5164_5026.wav,VTTS_b-4_2000-5164_5026.wav,2917,2496,421
4882,b-3_4315-4424_4406.wav,VTTS_b-3_4315-4424_4406.wav,4250,3529,721
4883,b-4_53-150_143.wav,VTTS_b-4_53-150_143.wav,7260,7953,-693
4884,b-2_1801-1902_1896.wav,VTTS_b-2_1801-1902_1896.wav,2540,2299,241
4885,b-3_2524-2854_2608.wav,VTTS_b-3_2524-2854_2608.wav,4240,4075,165
4886,b-1_1414-1514_1474.wav,VTTS_b-1_1414-1514_1474.wav,2620,2287,333
4887,b-3_5533-5638_5554.wav,VTTS_b-3_5533-5638_5554.wav,1440,1312,128
4888,b-3_1568-1665_1615.wav,VTTS_b-3_1568-1665_1615.wav,3040,3088,-48
4889,b-2_509-610_509.wav,VTTS_b-2_509-610_509.wav,3050,3123,-73
4890,b-3_3628-3714_3673.wav,VTTS_b-3_3628-3714_3673.wav,4190,4168,22
4891,b-3_1-97_77.wav,VTTS_b-3_1-97_77.wav,2940,2717,223
4892,b-4_1506-1600_1517.wav,VTTS_b-4_1506-1600_1517.wav,3610,3344,266
4893,b-3_4607-5008_4902.wav,VTTS_b-3_4607-5008_4902.wav,8370,7732,638
4894,b-4_2000-5164_4953.wav,VTTS_b-4_2000-5164_4953.wav,1955,1753,202
4895,b-1_2119-2219_2216.wav,VTTS_b-1_2119-2219_2216.wav,1690,1370,320
4896,b-4_2000-5164_4276.wav,VTTS_b-4_2000-5164_4276.wav,4292,4052,240
4897,b-2_407-508_494.wav,VTTS_b-2_407-508_494.wav,2180,1533,647
4898,b-3_5009-5427_5209.wav,VTTS_b-3_5009-5427_5209.wav,4770,4818,-48
4899,b-2_1427-1562_1513.wav,VTTS_b-2_1427-1562_1513.wav,3960,4122,-162
4900,b-3_5957-6015_5976.wav,VTTS_b-3_5957-6015_5976.wav,7360,7326,34
4901,b-3_196-293_244.wav,VTTS_b-3_196-293_244.wav,5420,5364,56
4902,b-1_3935-4033_4029.wav,VTTS_b-1_3935-4033_4029.wav,2260,3541,-1281
4903,b-1_794-1009_853.wav,VTTS_b-1_794-1009_853.wav,3210,2554,656
4904,b-3_1321-1568_1326.wav,VTTS_b-3_1321-1568_1326.wav,4990,4563,427
4905,b-4_1901-2000_1978.wav,VTTS_b-4_1901-2000_1978.wav,7110,6502,608
4906,b-4_53-150_92.wav,VTTS_b-4_53-150_92.wav,8600,9497,-897
4907,b-2_1427-1562_1517.wav,VTTS_b-2_1427-1562_1517.wav,3690,5143,-1453
4908,b-1_686-793_731.wav,VTTS_b-1_686-793_731.wav,5160,3727,1433
4909,b-3_2524-2854_2727.wav,VTTS_b-3_2524-2854_2727.wav,4670,4389,281
4910,b-2_1597-1698_1699.wav,VTTS_b-2_1597-1698_1699.wav,2010,2322,-312
4911,b-4_53-150_88.wav,VTTS_b-4_53-150_88.wav,9850,8464,1386
4912,b-2_509-610_586.wav,VTTS_b-2_509-610_586.wav,2480,3123,-643
4913,b-4_151-300_190.wav,VTTS_b-4_151-300_190.wav,4340,3100,1240
4914,b-1_1111-1211_1181.wav,VTTS_b-1_1111-1211_1181.wav,1560,1382,178
4915,b-1_2119-2219_2137.wav,VTTS_b-1_2119-2219_2137.wav,4210,5666,-1456
4916,b-3_4498-4605_4517.wav,VTTS_b-3_4498-4605_4517.wav,5670,5283,387
4917,b-3_6501-6600_6502.wav,VTTS_b-3_6501-6600_6502.wav,4540,5596,-1056
4918,b-4_2000-5164_2724.wav,VTTS_b-4_2000-5164_2724.wav,6770,6850,-80
4919,b-3_6116-6215_6192.wav,VTTS_b-3_6116-6215_6192.wav,4620,4447,173
4920,b-3_3538-3627_3603.wav,VTTS_b-3_3538-3627_3603.wav,3900,3808,92
4921,b-1_4466-4498_4477.wav,VTTS_b-1_4466-4498_4477.wav,2040,1846,194
4922,b-4_501-1014_757.wav,VTTS_b-4_501-1014_757.wav,3510,3111,399
4923,b-4_2000-5164_2506.wav,VTTS_b-4_2000-5164_2506.wav,3160,4249,-1089
4924,b-4_2000-5164_2167.wav,VTTS_b-4_2000-5164_2167.wav,1830,1776,54
4925,b-1_1515-1615_1569.wav,VTTS_b-1_1515-1615_1569.wav,2470,2218,252
4926,b-4_151-300_183.wav,VTTS_b-4_151-300_183.wav,2450,1904,546
4927,b-4_2000-5164_3467.wav,VTTS_b-4_2000-5164_3467.wav,5555,5480,75
4928,b-1_175-275_202.wav,VTTS_b-1_175-275_202.wav,1370,1440,-70
4929,b-2_509-610_526.wav,VTTS_b-2_509-610_526.wav,2370,2334,36
4930,b-3_6900-7016_7010.wav,VTTS_b-3_6900-7016_7010.wav,5320,4377,943
4931,b-3_5009-5427_5021.wav,VTTS_b-3_5009-5427_5021.wav,2280,3042,-762
4932,b-4_2000-5164_3324.wav,VTTS_b-4_2000-5164_3324.wav,4796,4807,-11
4933,b-1_3531-3631_3597.wav,VTTS_b-1_3531-3631_3597.wav,3470,4168,-698
4934,b-4_301-400_356.wav,VTTS_b-4_301-400_356.wav,12090,11610,480
4935,b-4_2000-5164_2821.wav,VTTS_b-4_2000-5164_2821.wav,2010,2067,-57
4936,b-3_4207-4314_4213.wav,VTTS_b-3_4207-4314_4213.wav,3780,4005,-225
4937,b-3_3198-3278_3214.wav,VTTS_b-3_3198-3278_3214.wav,10460,11610,-1150
4938,b-1_3127-3227_3132.wav,VTTS_b-1_3127-3227_3132.wav,3640,4180,-540
4939,b-3_5745-5852_5805.wav,VTTS_b-3_5745-5852_5805.wav,4080,4122,-42
4940,b-4_2000-5164_3882.wav,VTTS_b-4_2000-5164_3882.wav,4841,5166,-325
4941,b-4_2000-5164_3842.wav,VTTS_b-4_2000-5164_3842.wav,2200,1962,238
4942,b-3_2524-2854_2586.wav,VTTS_b-3_2524-2854_2586.wav,5170,4563,607
4943,b-3_2524-2854_2809.wav,VTTS_b-3_2524-2854_2809.wav,2880,2926,-46
4944,b-4_151-300_246.wav,VTTS_b-4_151-300_246.wav,5960,5631,329
4945,b-4_2000-5164_4410.wav,VTTS_b-4_2000-5164_4410.wav,10353,10681,-328
4946,b-3_6701-6800_6737.wav,VTTS_b-3_6701-6800_6737.wav,2690,2485,205
4947,b-2_203-304_245.wav,VTTS_b-2_203-304_245.wav,2500,3553,-1053
4948,b-3_3803-3888_3874.wav,VTTS_b-3_3803-3888_3874.wav,5320,5259,61
4949,b-2_2107-2193_2175.wav,VTTS_b-2_2107-2193_2175.wav,1980,1997,-17
4950,b-3_6801-6900_6882.wav,VTTS_b-3_6801-6900_6882.wav,2950,2879,71
4951,b-1_794-1009_968.wav,VTTS_b-1_794-1009_968.wav,2470,2543,-73
4952,b-4_2000-5164_3669.wav,VTTS_b-4_2000-5164_3669.wav,3779,3309,470
4953,b-1_1-73_50.wav,VTTS_b-1_1-73_50.wav,1860,1695,165
4954,b-3_931-979_958.wav,VTTS_b-3_931-979_958.wav,2060,2055,5
4955,b-4_2000-5164_3810.wav,VTTS_b-4_2000-5164_3810.wav,2507,2299,208
4956,b-3_1079-1320_1123.wav,VTTS_b-3_1079-1320_1123.wav,9510,10844,-1334
4957,b-2_713-814_774.wav,VTTS_b-2_713-814_774.wav,4280,3704,576
4958,b-3_1321-1568_1376.wav,VTTS_b-3_1321-1568_1376.wav,3530,3448,82
4959,b-4_2000-5164_4417.wav,VTTS_b-4_2000-5164_4417.wav,3423,4075,-652
4960,b-1_3430-3530_3473.wav,VTTS_b-1_3430-3530_3473.wav,1300,1300,0
4961,b-3_501-930_504.wav,VTTS_b-3_501-930_504.wav,7230,7941,-711
4962,b-1_3733-3833_3832.wav,VTTS_b-1_3733-3833_3832.wav,1900,1858,42
4963,b-1_650-685_684.wav,VTTS_b-1_650-685_684.wav,4210,3773,437
4964,b-1_3228-3328_3286.wav,VTTS_b-1_3228-3328_3286.wav,940,859,81
4965,b-3_2524-2854_2665.wav,VTTS_b-3_2524-2854_2665.wav,4210,3506,704
4966,b-3_6301-6400_6355.wav,VTTS_b-3_6301-6400_6355.wav,3140,3262,-122
4967,b-3_980-1077_1061.wav,VTTS_b-3_980-1077_1061.wav,6690,11610,-4920
4968,b-4_2000-5164_2928.wav,VTTS_b-4_2000-5164_2928.wav,5007,7082,-2075
4969,b-1_478-578_559.wav,VTTS_b-1_478-578_559.wav,2330,2101,229
4970,b-3_1079-1320_1248.wav,VTTS_b-3_1079-1320_1248.wav,6400,6293,107
4971,b-3_6601-6700_6671.wav,VTTS_b-3_6601-6700_6671.wav,6450,3820,2630
4972,b-1_794-1009_869.wav,VTTS_b-1_794-1009_869.wav,1720,1440,280
4973,b-4_401-500_425.wav,VTTS_b-4_401-500_425.wav,1270,1254,16
4974,b-3_6900-7016_6965.wav,VTTS_b-3_6900-7016_6965.wav,4650,3437,1213
4975,b-1_74-174_86.wav,VTTS_b-1_74-174_86.wav,1220,1103,117
4976,b-1_1313-1413_1397.wav,VTTS_b-1_1313-1413_1397.wav,4450,5352,-902
4977,b-4_151-300_171.wav,VTTS_b-4_151-300_171.wav,8200,8081,119
4978,b-2_101-202_133.wav,VTTS_b-2_101-202_133.wav,1850,1858,-8
4979,b-3_5853-5956_5859.wav,VTTS_b-3_5853-5956_5859.wav,10830,9834,996
4980,b-4_2000-5164_4586.wav,VTTS_b-4_2000-5164_4586.wav,2414,2659,-245
4981,b-3_4207-4314_4242.wav,VTTS_b-3_4207-4314_4242.wav,6750,9532,-2782
4982,b-3_392-500_488.wav,VTTS_b-3_392-500_488.wav,1980,1846,134
4983,b-2_1597-1698_1640.wav,VTTS_b-2_1597-1698_1640.wav,1220,1045,175
4984,b-4_2000-5164_4559.wav,VTTS_b-4_2000-5164_4559.wav,7435,6896,539
4985,b-4_1101-1220_1123.wav,VTTS_b-4_1101-1220_1123.wav,8310,7895,415
4986,b-1_1212-1312_1270.wav,VTTS_b-1_1212-1312_1270.wav,3150,3506,-356
4987,b-1_3228-3328_3235.wav,VTTS_b-1_3228-3328_3235.wav,1420,1289,131
4988,b-3_980-1077_1017.wav,VTTS_b-3_980-1077_1017.wav,5300,5039,261
4989,b-4_2000-5164_3676.wav,VTTS_b-4_2000-5164_3676.wav,6859,7268,-409
4990,b-3_3198-3278_3253.wav,VTTS_b-3_3198-3278_3253.wav,4880,4563,317
4991,b-3_5745-5852_5771.wav,VTTS_b-3_5745-5852_5771.wav,6840,6676,164
4992,b-2_305-406_356.wav,VTTS_b-2_305-406_356.wav,4790,5329,-539
4993,b-4_2000-5164_3716.wav,VTTS_b-4_2000-5164_3716.wav,4015,5190,-1175
4994,b-3_1666-1763_1746.wav,VTTS_b-3_1666-1763_1746.wav,5920,7094,-1174
4995,b-2_101-202_194.wav,VTTS_b-2_101-202_194.wav,1100,1115,-15
4996,b-2_101-202_127.wav,VTTS_b-2_101-202_127.wav,1110,1138,-28
4997,b-1_1717-1817_1751.wav,VTTS_b-1_1717-1817_1751.wav,1770,1730,40
4998,b-1_1616-1716_1680.wav,VTTS_b-1_1616-1716_1680.wav,2210,2601,-391
4999,b-3_2524-2854_2853.wav,VTTS_b-3_2524-2854_2853.wav,2500,3135,-635
5000,b-2_611-712_711.wav,VTTS_b-2_611-712_711.wav,1660,1219,441
5001,b-1_2624-2724_2710.wav,VTTS_b-1_2624-2724_2710.wav,1150,1498,-348
5002,b-2_2413-2500_2449.wav,VTTS_b-2_2413-2500_2449.wav,960,917,43
5003,b-4_2000-5164_4093.wav,VTTS_b-4_2000-5164_4093.wav,4955,5294,-339
5004,b-1_377-477_379.wav,VTTS_b-1_377-477_379.wav,1320,1254,66
5005,b-2_509-610_563.wav,VTTS_b-2_509-610_563.wav,1600,1730,-130
5006,b-3_4498-4605_4508.wav,VTTS_b-3_4498-4605_4508.wav,4350,3831,519
5007,b-4_1401-1505_1498.wav,VTTS_b-4_1401-1505_1498.wav,5160,4748,412
5008,b-1_377-477_474.wav,VTTS_b-1_377-477_474.wav,1050,1173,-123
5009,b-3_294-391_298.wav,VTTS_b-3_294-391_298.wav,2930,2786,144
5010,b-3_931-979_942.wav,VTTS_b-3_931-979_942.wav,2960,3239,-279
5011,b-4_1901-2000_1933.wav,VTTS_b-4_1901-2000_1933.wav,9260,10728,-1468
5012,b-4_501-1014_951.wav,VTTS_b-4_501-1014_951.wav,10040,10646,-606
5013,b-2_101-202_184.wav,VTTS_b-2_101-202_184.wav,2250,2438,-188
5014,b-2_815-916_911.wav,VTTS_b-2_815-916_911.wav,1800,2194,-394
5015,b-3_3454-3537_3479.wav,VTTS_b-3_3454-3537_3479.wav,5310,5433,-123
5016,b-3_931-979_954.wav,VTTS_b-3_931-979_954.wav,6490,6467,23
5017,b-3_3715-3802_3794.wav,VTTS_b-3_3715-3802_3794.wav,4890,4679,211
5018,b-1_2321-2421_2332.wav,VTTS_b-1_2321-2421_2332.wav,1020,998,22
5019,b-3_2350-2433_2421.wav,VTTS_b-3_2350-2433_2421.wav,3430,3355,75
5020,b-4_2000-5164_3455.wav,VTTS_b-4_2000-5164_3455.wav,8185,7906,279
5021,b-3_4498-4605_4556.wav,VTTS_b-3_4498-4605_4556.wav,3800,4737,-937
5022,b-1_3228-3328_3316.wav,VTTS_b-1_3228-3328_3316.wav,1630,1950,-320
5023,b-1_2422-2522_2423.wav,VTTS_b-1_2422-2522_2423.wav,1440,1428,12
5024,b-3_4498-4605_4572.wav,VTTS_b-3_4498-4605_4572.wav,7100,7779,-679
5025,b-1_175-275_227.wav,VTTS_b-1_175-275_227.wav,1810,1800,10
5026,b-3_196-293_214.wav,VTTS_b-3_196-293_214.wav,5460,5584,-124
5027,b-1_1313-1413_1321.wav,VTTS_b-1_1313-1413_1321.wav,3060,2833,227
5028,b-2_2209-2310_2267.wav,VTTS_b-2_2209-2310_2267.wav,2900,2148,752
5029,b-2_2040-2072_2064.wav,VTTS_b-2_2040-2072_2064.wav,1370,1405,-35
5030,b-3_294-391_338.wav,VTTS_b-3_294-391_338.wav,3940,3762,178
5031,b-4_301-400_371.wav,VTTS_b-4_301-400_371.wav,5800,5410,390
5032,b-1_3935-4033_3993.wav,VTTS_b-1_3935-4033_3993.wav,1630,1382,248
5033,b-1_2321-2421_2374.wav,VTTS_b-1_2321-2421_2374.wav,1180,1231,-51
5034,b-2_305-406_359.wav,VTTS_b-2_305-406_359.wav,1960,1985,-25
5035,b-1_1313-1413_1400.wav,VTTS_b-1_1313-1413_1400.wav,5470,4632,838
5036,b-4_501-1014_664.wav,VTTS_b-4_501-1014_664.wav,1960,1904,56
5037,b-4_2000-5164_4032.wav,VTTS_b-4_2000-5164_4032.wav,6601,10600,-3999
5038,b-3_1666-1763_1763.wav,VTTS_b-3_1666-1763_1763.wav,4050,3483,567
5039,b-1_3329-3429_3383.wav,VTTS_b-1_3329-3429_3383.wav,2340,3425,-1085
5040,b-1_1010-1110_1014.wav,VTTS_b-1_1010-1110_1014.wav,1590,1428,162
5041,b-4_2000-5164_3374.wav,VTTS_b-4_2000-5164_3374.wav,6341,6745,-404
5042,b-4_2000-5164_5069.wav,VTTS_b-4_2000-5164_5069.wav,8122,9764,-1642
5043,b-2_917-1018_939.wav,VTTS_b-2_917-1018_939.wav,940,1126,-186
5044,b-1_3531-3631_3581.wav,VTTS_b-1_3531-3631_3581.wav,1180,1265,-85
5045,b-1_3531-3631_3578.wav,VTTS_b-1_3531-3631_3578.wav,1100,1138,-38
5046,b-3_501-930_864.wav,VTTS_b-3_501-930_864.wav,3420,2937,483
5047,b-1_1212-1312_1234.wav,VTTS_b-1_1212-1312_1234.wav,1440,1451,-11
5048,b-3_3279-3363_3326.wav,VTTS_b-3_3279-3363_3326.wav,6220,5271,949
5049,b-3_501-930_920.wav,VTTS_b-3_501-930_920.wav,10450,9207,1243
5050,b-4_1901-2000_1945.wav,VTTS_b-4_1901-2000_1945.wav,5380,4957,423
5051,b-4_2000-5164_3711.wav,VTTS_b-4_2000-5164_3711.wav,2800,3309,-509
5052,b-3_2943-3024_2949.wav,VTTS_b-3_2943-3024_2949.wav,4250,4098,152
5053,b-4_2000-5164_3818.wav,VTTS_b-4_2000-5164_3818.wav,4053,3947,106
5054,b-2_305-406_374.wav,VTTS_b-2_305-406_374.wav,6490,6978,-488
5055,b-1_3228-3328_3272.wav,VTTS_b-1_3228-3328_3272.wav,4830,5016,-186
5056,b-4_501-1014_808.wav,VTTS_b-4_501-1014_808.wav,3310,3158,152
5057,b-3_2524-2854_2573.wav,VTTS_b-3_2524-2854_2573.wav,7310,11610,-4300
5058,b-1_3026-3126_3035.wav,VTTS_b-1_3026-3126_3035.wav,4470,3715,755
5059,b-3_1321-1568_1519.wav,VTTS_b-3_1321-1568_1519.wav,3790,3379,411
5060,b-4_2000-5164_5093.wav,VTTS_b-4_2000-5164_5093.wav,9609,10762,-1153
5061,b-4_501-1014_516.wav,VTTS_b-4_501-1014_516.wav,4020,3924,96
5062,b-4_2000-5164_4024.wav,VTTS_b-4_2000-5164_4024.wav,5083,4772,311
5063,b-3_4207-4314_4266.wav,VTTS_b-3_4207-4314_4266.wav,4070,4052,18
5064,b-1_1818-1918_1881.wav,VTTS_b-1_1818-1918_1881.wav,1270,1382,-112
5065,b-3_6301-6400_6384.wav,VTTS_b-3_6301-6400_6384.wav,3330,3286,44
5066,b-3_6801-6900_6817.wav,VTTS_b-3_6801-6900_6817.wav,2490,2043,447
5067,b-4_2000-5164_3074.wav,VTTS_b-4_2000-5164_3074.wav,4665,4133,532
5068,b-3_4104-4206_4119.wav,VTTS_b-3_4104-4206_4119.wav,7780,7802,-22
5069,b-3_3112-3197_3128.wav,VTTS_b-3_3112-3197_3128.wav,6460,5248,1212
5070,b-3_3538-3627_3625.wav,VTTS_b-3_3538-3627_3625.wav,7810,8638,-828
5071,b-3_3279-3363_3316.wav,VTTS_b-3_3279-3363_3316.wav,3760,3286,474
5072,b-4_2000-5164_2114.wav,VTTS_b-4_2000-5164_2114.wav,1610,1544,66
5073,b-2_611-712_663.wav,VTTS_b-2_611-712_663.wav,580,650,-70
5074,b-3_2089-2176_2157.wav,VTTS_b-3_2089-2176_2157.wav,4990,11610,-6620
5075,b-3_931-979_975.wav,VTTS_b-3_931-979_975.wav,1580,1544,36
5076,b-3_5009-5427_5188.wav,VTTS_b-3_5009-5427_5188.wav,4870,2844,2026
5077,b-3_3715-3802_3767.wav,VTTS_b-3_3715-3802_3767.wav,6580,7175,-595
5078,b-1_3834-3934_3862.wav,VTTS_b-1_3834-3934_3862.wav,3670,4145,-475
5079,b-2_1223-1324_1266.wav,VTTS_b-2_1223-1324_1266.wav,1570,1544,26
5080,b-3_5428-5533_5444.wav,VTTS_b-3_5428-5533_5444.wav,4670,5375,-705
5081,b-3_392-500_425.wav,VTTS_b-3_392-500_425.wav,2010,1939,71
5082,b-3_1568-1665_1590.wav,VTTS_b-3_1568-1665_1590.wav,9620,11610,-1990
5083,b-3_4607-5008_4663.wav,VTTS_b-3_4607-5008_4663.wav,2140,2670,-530
5084,b-2_1325-1426_1415.wav,VTTS_b-2_1325-1426_1415.wav,1310,1173,137
5085,b-4_2000-5164_2836.wav,VTTS_b-4_2000-5164_2836.wav,3600,3181,419
5086,b-1_1-73_54.wav,VTTS_b-1_1-73_54.wav,5180,5666,-486
5087,b-1_2927-3025_2955.wav,VTTS_b-1_2927-3025_2955.wav,1690,1718,-28
5088,b-1_2018-2118_2020.wav,VTTS_b-1_2018-2118_2020.wav,1440,1428,12
5089,b-3_6601-6700_6688.wav,VTTS_b-3_6601-6700_6688.wav,3770,4342,-572
5090,b-3_1079-1320_1280.wav,VTTS_b-3_1079-1320_1280.wav,9200,8824,376
5091,b-1_1-73_17.wav,VTTS_b-1_1-73_17.wav,2650,2624,26
5092,b-3_5745-5852_5788.wav,VTTS_b-3_5745-5852_5788.wav,5560,5016,544
5093,b-3_5009-5427_5163.wav,VTTS_b-3_5009-5427_5163.wav,4600,4180,420
5094,b-1_794-1009_978.wav,VTTS_b-1_794-1009_978.wav,4130,5016,-886
5095,b-4_1014-1100_1066.wav,VTTS_b-4_1014-1100_1066.wav,8960,7384,1576
5096,b-4_2000-5164_4127.wav,VTTS_b-4_2000-5164_4127.wav,3530,4110,-580
5097,b-4_1014-1100_1026.wav,VTTS_b-4_1014-1100_1026.wav,7620,7396,224
5098,b-3_6601-6700_6611.wav,VTTS_b-3_6601-6700_6611.wav,6620,6084,536
5099,b-4_2000-5164_4344.wav,VTTS_b-4_2000-5164_4344.wav,5231,5108,123
5100,b-4_2000-5164_4285.wav,VTTS_b-4_2000-5164_4285.wav,6792,8487,-1695
5101,b-1_3430-3530_3437.wav,VTTS_b-1_3430-3530_3437.wav,2100,2113,-13
5102,b-1_3632-3732_3650.wav,VTTS_b-1_3632-3732_3650.wav,2880,2786,94
5103,b-3_4498-4605_4590.wav,VTTS_b-3_4498-4605_4590.wav,4550,6571,-2021
5104,b-4_1-52_21.wav,VTTS_b-4_1-52_21.wav,6950,6780,170
5105,b-4_2000-5164_3152.wav,VTTS_b-4_2000-5164_3152.wav,3204,4017,-813
5106,b-3_5009-5427_5074.wav,VTTS_b-3_5009-5427_5074.wav,6200,5596,604
5107,b-3_98-195_169.wav,VTTS_b-3_98-195_169.wav,2550,2473,77
5108,b-4_2000-5164_4663.wav,VTTS_b-4_2000-5164_4663.wav,5713,6687,-974
5109,b-2_1597-1698_1660.wav,VTTS_b-2_1597-1698_1660.wav,1800,1556,244
5110,b-2_305-406_348.wav,VTTS_b-2_305-406_348.wav,2030,2043,-13
5111,b-4_2000-5164_2163.wav,VTTS_b-4_2000-5164_2163.wav,1020,894,126
5112,b-4_1814-1900_1869.wav,VTTS_b-4_1814-1900_1869.wav,3870,4307,-437
5113,b-2_1019-1120_1088.wav,VTTS_b-2_1019-1120_1088.wav,4700,11610,-6910
5114,b-1_1515-1615_1542.wav,VTTS_b-1_1515-1615_1542.wav,3900,3646,254
5115,b-3_1764-1861_1800.wav,VTTS_b-3_1764-1861_1800.wav,4620,4284,336
5116,b-1_2826-2926_2829.wav,VTTS_b-1_2826-2926_2829.wav,3780,3251,529
5117,b-2_2073-2106_2083.wav,VTTS_b-2_2073-2106_2083.wav,990,1091,-101
5118,b-4_401-500_444.wav,VTTS_b-4_401-500_444.wav,4110,3622,488
5119,b-4_2000-5164_2791.wav,VTTS_b-4_2000-5164_2791.wav,6720,6664,56
5120,b-4_2000-5164_4626.wav,VTTS_b-4_2000-5164_4626.wav,5736,5642,94
5121,b-3_392-500_411.wav,VTTS_b-3_392-500_411.wav,8950,9195,-245
5122,b-3_5428-5533_5520.wav,VTTS_b-3_5428-5533_5520.wav,5670,6130,-460
5123,b-4_2000-5164_3432.wav,VTTS_b-4_2000-5164_3432.wav,2293,2252,41
5124,b-4_1-52_37.wav,VTTS_b-4_1-52_37.wav,6700,6513,187
5125,b-3_6301-6400_6398.wav,VTTS_b-3_6301-6400_6398.wav,2660,2798,-138
5126,b-4_2000-5164_3369.wav,VTTS_b-4_2000-5164_3369.wav,5733,6734,-1001
5127,b-4_2000-5164_2963.wav,VTTS_b-4_2000-5164_2963.wav,2963,2914,49
5128,b-4_1221-1300_1284.wav,VTTS_b-4_1221-1300_1284.wav,3950,4052,-102
5129,b-3_501-930_668.wav,VTTS_b-3_501-930_668.wav,8700,8440,260
5130,b-1_3127-3227_3131.wav,VTTS_b-1_3127-3227_3131.wav,2030,2020,10
5131,b-3_5853-5956_5909.wav,VTTS_b-3_5853-5956_5909.wav,6490,6316,174
5132,b-4_151-300_229.wav,VTTS_b-4_151-300_229.wav,6320,5712,608
5133,b-1_74-174_127.wav,VTTS_b-1_74-174_127.wav,3040,3495,-455
5134,b-1_2422-2522_2478.wav,VTTS_b-1_2422-2522_2478.wav,1860,1846,14
5135,b-4_2000-5164_3998.wav,VTTS_b-4_2000-5164_3998.wav,5919,7361,-1442
5136,b-3_5009-5427_5181.wav,VTTS_b-3_5009-5427_5181.wav,3410,3808,-398
5137,b-4_501-1014_694.wav,VTTS_b-4_501-1014_694.wav,8570,6676,1894
5138,b-4_2000-5164_3765.wav,VTTS_b-4_2000-5164_3765.wav,5060,5387,-327
5139,b-3_1-97_48.wav,VTTS_b-3_1-97_48.wav,4070,3402,668
5140,b-4_501-1014_723.wav,VTTS_b-4_501-1014_723.wav,2090,1962,128
5141,b-1_1-73_55.wav,VTTS_b-1_1-73_55.wav,5380,3808,1572
5142,b-4_501-1014_1008.wav,VTTS_b-4_501-1014_1008.wav,3220,3042,178
5143,b-1_1111-1211_1207.wav,VTTS_b-1_1111-1211_1207.wav,1930,2159,-229
5144,b-3_5009-5427_5297.wav,VTTS_b-3_5009-5427_5297.wav,8100,8301,-201
5145,b-2_1223-1324_1292.wav,VTTS_b-2_1223-1324_1292.wav,6370,5306,1064
5146,b-4_2000-5164_3249.wav,VTTS_b-4_2000-5164_3249.wav,5341,5283,58
5147,b-3_2434-2523_2434.wav,VTTS_b-3_2434-2523_2434.wav,2660,2612,48
5148,b-3_5009-5427_5077.wav,VTTS_b-3_5009-5427_5077.wav,5710,5236,474
5149,b-3_392-500_499.wav,VTTS_b-3_392-500_499.wav,8210,8905,-695
5150,b-3_3112-3197_3112.wav,VTTS_b-3_3112-3197_3112.wav,9930,11610,-1680
5151,b-3_3538-3627_3579.wav,VTTS_b-3_3538-3627_3579.wav,3760,4540,-780
5152,b-4_1901-2000_1996.wav,VTTS_b-4_1901-2000_1996.wav,6210,6792,-582
5153,b-3_3715-3802_3790.wav,VTTS_b-3_3715-3802_3790.wav,5210,4969,241
5154,b-1_1818-1918_1906.wav,VTTS_b-1_1818-1918_1906.wav,2200,1916,284
5155,b-2_2107-2193_2130.wav,VTTS_b-2_2107-2193_2130.wav,1880,2125,-245
5156,b-4_501-1014_747.wav,VTTS_b-4_501-1014_747.wav,5550,5132,418
5157,b-4_501-1014_840.wav,VTTS_b-4_501-1014_840.wav,5550,6165,-615
5158,b-4_501-1014_956.wav,VTTS_b-4_501-1014_956.wav,1250,1161,89
5159,b-3_4607-5008_4721.wav,VTTS_b-3_4607-5008_4721.wav,4630,5735,-1105
5160,b-4_2000-5164_3965.wav,VTTS_b-4_2000-5164_3965.wav,4955,5050,-95
5161,b-4_2000-5164_2876.wav,VTTS_b-4_2000-5164_2876.wav,4190,3738,452
5162,b-1_1212-1312_1240.wav,VTTS_b-1_1212-1312_1240.wav,1260,1080,180
5163,b-3_98-195_190.wav,VTTS_b-3_98-195_190.wav,5350,4737,613
5164,b-3_1079-1320_1279.wav,VTTS_b-3_1079-1320_1279.wav,12310,10820,1490
5165,b-3_4207-4314_4296.wav,VTTS_b-3_4207-4314_4296.wav,4980,4830,150
5166,b-4_2000-5164_2039.wav,VTTS_b-4_2000-5164_2039.wav,2850,4191,-1341
5167,b-2_101-202_118.wav,VTTS_b-2_101-202_118.wav,3730,7175,-3445
5168,b-4_2000-5164_3575.wav,VTTS_b-4_2000-5164_3575.wav,2457,2659,-202
5169,b-3_6801-6900_6848.wav,VTTS_b-3_6801-6900_6848.wav,1340,1068,272
5170,b-3_3538-3627_3569.wav,VTTS_b-3_3538-3627_3569.wav,2650,4110,-1460
5171,b-1_3531-3631_3579.wav,VTTS_b-1_3531-3631_3579.wav,1650,1718,-68
5172,b-3_2089-2176_2129.wav,VTTS_b-3_2089-2176_2129.wav,5850,5642,208
5173,b-1_794-1009_918.wav,VTTS_b-1_794-1009_918.wav,1710,1765,-55
5174,b-1_175-275_235.wav,VTTS_b-1_175-275_235.wav,1870,3518,-1648
5175,b-4_2000-5164_4135.wav,VTTS_b-4_2000-5164_4135.wav,5171,4795,376
5176,b-4_2000-5164_4364.wav,VTTS_b-4_2000-5164_4364.wav,2112,2345,-233
5177,b-4_2000-5164_2938.wav,VTTS_b-4_2000-5164_2938.wav,4886,4493,393
5178,b-2_407-508_426.wav,VTTS_b-2_407-508_426.wav,1510,1428,82
5179,b-3_1568-1665_1570.wav,VTTS_b-3_1568-1665_1570.wav,4230,5074,-844
5180,b-3_2943-3024_2990.wav,VTTS_b-3_2943-3024_2990.wav,7340,7396,-56
5181,b-4_501-1014_584.wav,VTTS_b-4_501-1014_584.wav,13500,11610,1890
5182,b-4_151-300_176.wav,VTTS_b-4_151-300_176.wav,3550,3355,195
5183,b-1_3430-3530_3518.wav,VTTS_b-1_3430-3530_3518.wav,2300,2380,-80
5184,b-3_2350-2433_2381.wav,VTTS_b-3_2350-2433_2381.wav,7750,7187,563
5185,b-1_3834-3934_3843.wav,VTTS_b-1_3834-3934_3843.wav,1590,1614,-24
5186,b-4_2000-5164_4094.wav,VTTS_b-4_2000-5164_4094.wav,6557,6780,-223
5187,b-1_1515-1615_1598.wav,VTTS_b-1_1515-1615_1598.wav,2260,2055,205
5188,b-2_305-406_331.wav,VTTS_b-2_305-406_331.wav,1260,1219,41
5189,b-3_4315-4424_4327.wav,VTTS_b-3_4315-4424_4327.wav,6180,7082,-902
5190,b-2_101-202_119.wav,VTTS_b-2_101-202_119.wav,1040,998,42
5191,b-4_2000-5164_4385.wav,VTTS_b-4_2000-5164_4385.wav,3023,3344,-321
5192,b-3_2000-2088_2000.wav,VTTS_b-3_2000-2088_2000.wav,3790,3634,156
5193,b-4_2000-5164_2602.wav,VTTS_b-4_2000-5164_2602.wav,5300,7605,-2305
5194,b-4_2000-5164_4781.wav,VTTS_b-4_2000-5164_4781.wav,1326,1022,304
5195,b-1_4466-4498_4478.wav,VTTS_b-1_4466-4498_4478.wav,4000,4957,-957
5196,b-1_74-174_106.wav,VTTS_b-1_74-174_106.wav,2300,1846,454
5197,b-4_2000-5164_4384.wav,VTTS_b-4_2000-5164_4384.wav,6280,6142,138
5198,b-3_6301-6400_6342.wav,VTTS_b-3_6301-6400_6342.wav,8620,8661,-41
5199,b-3_2524-2854_2752.wav,VTTS_b-3_2524-2854_2752.wav,8400,9160,-760
5200,b-1_2220-2320_2299.wav,VTTS_b-1_2220-2320_2299.wav,1840,1834,6
5201,b-1_1-73_3.wav,VTTS_b-1_1-73_3.wav,3520,3251,269
5202,b-1_276-376_325.wav,VTTS_b-1_276-376_325.wav,1540,1242,298
5203,b-1_4286-4321_4295.wav,VTTS_b-1_4286-4321_4295.wav,850,604,246
5204,b-1_3935-4033_3935.wav,VTTS_b-1_3935-4033_3935.wav,1370,1300,70
5205,b-3_2177-2266_2202.wav,VTTS_b-3_2177-2266_2202.wav,4150,4005,145
5206,b-4_2000-5164_3431.wav,VTTS_b-4_2000-5164_3431.wav,1158,1068,90
5207,b-2_1427-1562_1451.wav,VTTS_b-2_1427-1562_1451.wav,2530,3704,-1174
5208,b-3_501-930_618.wav,VTTS_b-3_501-930_618.wav,2820,3042,-222
5209,b-1_794-1009_860.wav,VTTS_b-1_794-1009_860.wav,3360,3878,-518
5210,b-1_3632-3732_3725.wav,VTTS_b-1_3632-3732_3725.wav,3640,3553,87
5211,b-4_501-1014_884.wav,VTTS_b-4_501-1014_884.wav,2020,2159,-139
5212,b-2_1597-1698_1673.wav,VTTS_b-2_1597-1698_1673.wav,2540,2891,-351
5213,b-3_6701-6800_6708.wav,VTTS_b-3_6701-6800_6708.wav,1890,1939,-49
5214,b-4_2000-5164_4669.wav,VTTS_b-4_2000-5164_4669.wav,2890,3367,-477
5215,b-4_1014-1100_1046.wav,VTTS_b-4_1014-1100_1046.wav,1840,1567,273
5216,b-4_2000-5164_4686.wav,VTTS_b-4_2000-5164_4686.wav,5573,5143,430
5217,b-4_2000-5164_4768.wav,VTTS_b-4_2000-5164_4768.wav,10125,9868,257
5218,b-1_478-578_512.wav,VTTS_b-1_478-578_512.wav,1210,1614,-404
5219,b-3_6401-6500_6440.wav,VTTS_b-3_6401-6500_6440.wav,4060,3576,484
5220,b-4_2000-5164_3584.wav,VTTS_b-4_2000-5164_3584.wav,2843,2752,91
5221,b-4_501-1014_997.wav,VTTS_b-4_501-1014_997.wav,8230,8324,-94
5222,b-4_2000-5164_4110.wav,VTTS_b-4_2000-5164_4110.wav,5354,5666,-312
5223,b-4_2000-5164_4199.wav,VTTS_b-4_2000-5164_4199.wav,2804,2844,-40
5224,b-4_2000-5164_3863.wav,VTTS_b-4_2000-5164_3863.wav,1714,1567,147
5225,b-3_6801-6900_6838.wav,VTTS_b-3_6801-6900_6838.wav,7350,8707,-1357
5226,b-4_151-300_278.wav,VTTS_b-4_151-300_278.wav,6920,6444,476
5227,b-1_4106-4141_4106.wav,VTTS_b-1_4106-4141_4106.wav,1850,1904,-54
5228,b-4_1301-1400_1310.wav,VTTS_b-4_1301-1400_1310.wav,3150,3030,120
5229,b-4_2000-5164_4204.wav,VTTS_b-4_2000-5164_4204.wav,5962,5933,29
5230,b-1_3632-3732_3644.wav,VTTS_b-1_3632-3732_3644.wav,1530,1579,-49
5231,b-3_3803-3888_3825.wav,VTTS_b-3_3803-3888_3825.wav,3370,3077,293
5232,b-4_301-400_374.wav,VTTS_b-4_301-400_374.wav,6590,6803,-213
5233,b-1_794-1009_914.wav,VTTS_b-1_794-1009_914.wav,2360,3471,-1111
5234,b-3_4607-5008_4969.wav,VTTS_b-3_4607-5008_4969.wav,8730,10333,-1603
5235,b-1_2220-2320_2312.wav,VTTS_b-1_2220-2320_2312.wav,2800,2775,25
5236,b-1_1-73_61.wav,VTTS_b-1_1-73_61.wav,5050,4957,93
5237,b-3_1568-1665_1663.wav,VTTS_b-3_1568-1665_1663.wav,4260,4133,127
5238,b-1_2422-2522_2455.wav,VTTS_b-1_2422-2522_2455.wav,2310,3367,-1057
5239,b-4_2000-5164_2640.wav,VTTS_b-4_2000-5164_2640.wav,3600,3181,419
5240,b-4_2000-5164_3042.wav,VTTS_b-4_2000-5164_3042.wav,5625,5445,180
5241,b-3_4607-5008_4689.wav,VTTS_b-3_4607-5008_4689.wav,8950,9985,-1035
5242,b-3_6900-7016_6905.wav,VTTS_b-3_6900-7016_6905.wav,5090,4470,620
5243,b-4_301-400_326.wav,VTTS_b-4_301-400_326.wav,1050,975,75
5244,b-3_5009-5427_5376.wav,VTTS_b-3_5009-5427_5376.wav,3230,3634,-404
5245,b-3_2000-2088_2062.wav,VTTS_b-3_2000-2088_2062.wav,3650,3820,-170
5246,b-1_1212-1312_1235.wav,VTTS_b-1_1212-1312_1235.wav,2270,2438,-168
5247,b-1_686-793_756.wav,VTTS_b-1_686-793_756.wav,3580,3262,318
5248,b-1_1212-1312_1296.wav,VTTS_b-1_1212-1312_1296.wav,1950,1869,81
5249,b-1_3632-3732_3699.wav,VTTS_b-1_3632-3732_3699.wav,1300,1277,23
5250,b-1_2220-2320_2235.wav,VTTS_b-1_2220-2320_2235.wav,1990,1916,74
5251,b-3_5853-5956_5868.wav,VTTS_b-3_5853-5956_5868.wav,3580,3030,550
5252,b-2_509-610_528.wav,VTTS_b-2_509-610_528.wav,2560,2392,168
5253,b-4_2000-5164_4820.wav,VTTS_b-4_2000-5164_4820.wav,5714,4609,1105
5254,b-3_5745-5852_5819.wav,VTTS_b-3_5745-5852_5819.wav,6570,6258,312
5255,b-1_3127-3227_3183.wav,VTTS_b-1_3127-3227_3183.wav,1830,1869,-39
5256,b-4_2000-5164_4227.wav,VTTS_b-4_2000-5164_4227.wav,11287,11610,-323
5257,b-1_1313-1413_1352.wav,VTTS_b-1_1313-1413_1352.wav,2020,2171,-151
5258,b-1_2624-2724_2715.wav,VTTS_b-1_2624-2724_2715.wav,4080,4609,-529
5259,b-3_4607-5008_4824.wav,VTTS_b-3_4607-5008_4824.wav,3390,3355,35
5260,b-3_294-391_315.wav,VTTS_b-3_294-391_315.wav,5230,6223,-993
5261,b-2_1597-1698_1635.wav,VTTS_b-2_1597-1698_1635.wav,1180,1045,135
5262,b-1_2624-2724_2707.wav,VTTS_b-1_2624-2724_2707.wav,1280,1625,-345
5263,b-3_3538-3627_3592.wav,VTTS_b-3_3538-3627_3592.wav,6910,6014,896
5264,b-3_5009-5427_5011.wav,VTTS_b-3_5009-5427_5011.wav,3620,3762,-142
5265,b-1_2725-2825_2809.wav,VTTS_b-1_2725-2825_2809.wav,1110,1115,-5
5266,b-4_2000-5164_4519.wav,VTTS_b-4_2000-5164_4519.wav,3502,3390,112
5267,b-3_3803-3888_3843.wav,VTTS_b-3_3803-3888_3843.wav,3840,3982,-142
5268,b-1_2422-2522_2479.wav,VTTS_b-1_2422-2522_2479.wav,2600,2810,-210
5269,b-4_2000-5164_4646.wav,VTTS_b-4_2000-5164_4646.wav,3194,2995,199
5270,b-2_1903-2038_2024.wav,VTTS_b-2_1903-2038_2024.wav,1260,1486,-226
5271,b-3_2434-2523_2453.wav,VTTS_b-3_2434-2523_2453.wav,5580,5433,147
5272,b-4_2000-5164_4895.wav,VTTS_b-4_2000-5164_4895.wav,4670,4702,-32
5273,b-4_2000-5164_2109.wav,VTTS_b-4_2000-5164_2109.wav,9010,10426,-1416
5274,b-2_1019-1120_1084.wav,VTTS_b-2_1019-1120_1084.wav,1790,2043,-253
5275,b-3_5533-5638_5566.wav,VTTS_b-3_5533-5638_5566.wav,5710,5503,207
5276,b-2_1325-1426_1351.wav,VTTS_b-2_1325-1426_1351.wav,630,685,-55
5277,b-2_2209-2310_2307.wav,VTTS_b-2_2209-2310_2307.wav,2020,2055,-35
5278,b-4_1814-1900_1870.wav,VTTS_b-4_1814-1900_1870.wav,3020,2577,443
5279,b-4_1707-1813_1755.wav,VTTS_b-4_1707-1813_1755.wav,4100,3379,721
5280,b-3_4001-4103_4089.wav,VTTS_b-3_4001-4103_4089.wav,4600,4296,304
5281,b-1_1616-1716_1666.wav,VTTS_b-1_1616-1716_1666.wav,1520,1695,-175
5282,b-2_1-100_39.wav,VTTS_b-2_1-100_39.wav,4030,4748,-718
5283,b-3_5957-6015_5985.wav,VTTS_b-3_5957-6015_5985.wav,7060,8266,-1206
5284,b-1_377-477_396.wav,VTTS_b-1_377-477_396.wav,1540,1474,66
5285,b-4_2000-5164_2988.wav,VTTS_b-4_2000-5164_2988.wav,5457,5968,-511
5286,b-3_5009-5427_5052.wav,VTTS_b-3_5009-5427_5052.wav,4100,4528,-428
5287,b-2_2107-2193_2155.wav,VTTS_b-2_2107-2193_2155.wav,1570,1289,281
5288,b-3_4207-4314_4248.wav,VTTS_b-3_4207-4314_4248.wav,6320,7140,-820
5289,b-3_2524-2854_2540.wav,VTTS_b-3_2524-2854_2540.wav,4860,4481,379
5290,b-3_5428-5533_5449.wav,VTTS_b-3_5428-5533_5449.wav,4280,4702,-422
5291,b-3_2434-2523_2491.wav,VTTS_b-3_2434-2523_2491.wav,2430,2508,-78
5292,b-3_6900-7016_6934.wav,VTTS_b-3_6900-7016_6934.wav,12500,11610,890
5293,b-1_2422-2522_2422.wav,VTTS_b-1_2422-2522_2422.wav,1930,1962,-32
5294,b-3_6116-6215_6185.wav,VTTS_b-3_6116-6215_6185.wav,6030,6606,-576
5295,b-2_2413-2500_2435.wav,VTTS_b-2_2413-2500_2435.wav,4810,5120,-310
5296,b-2_1427-1562_1470.wav,VTTS_b-2_1427-1562_1470.wav,6080,6536,-456
5297,b-4_2000-5164_2593.wav,VTTS_b-4_2000-5164_2593.wav,2020,1660,360
5298,b-3_4607-5008_4966.wav,VTTS_b-3_4607-5008_4966.wav,9160,9021,139
5299,b-4_2000-5164_3889.wav,VTTS_b-4_2000-5164_3889.wav,7757,8626,-869
5300,b-4_151-300_178.wav,VTTS_b-4_151-300_178.wav,2390,2775,-385
5301,b-1_2523-2623_2601.wav,VTTS_b-1_2523-2623_2601.wav,1580,1579,1
5302,b-2_1427-1562_1464.wav,VTTS_b-2_1427-1562_1464.wav,4670,3866,804
5303,b-4_1506-1600_1523.wav,VTTS_b-4_1506-1600_1523.wav,2000,1997,3
5304,b-3_4607-5008_4790.wav,VTTS_b-3_4607-5008_4790.wav,2300,2206,94
5305,b-1_2422-2522_2520.wav,VTTS_b-1_2422-2522_2520.wav,2180,1974,206
5306,b-2_2107-2193_2188.wav,VTTS_b-2_2107-2193_2188.wav,1710,1382,328
5307,b-3_6401-6500_6485.wav,VTTS_b-3_6401-6500_6485.wav,5790,5619,171
5308,b-3_5009-5427_5063.wav,VTTS_b-3_5009-5427_5063.wav,3660,3042,618
5309,b-1_3531-3631_3626.wav,VTTS_b-1_3531-3631_3626.wav,1680,2601,-921
5310,b-1_1515-1615_1515.wav,VTTS_b-1_1515-1615_1515.wav,1460,1324,136
5311,b-4_2000-5164_3013.wav,VTTS_b-4_2000-5164_3013.wav,6558,6316,242
5312,b-1_276-376_287.wav,VTTS_b-1_276-376_287.wav,1750,2159,-409
5313,b-3_6016-6115_6113.wav,VTTS_b-3_6016-6115_6113.wav,7440,7605,-165
5314,b-1_794-1009_848.wav,VTTS_b-1_794-1009_848.wav,2640,2624,16
5315,b-3_5009-5427_5010.wav,VTTS_b-3_5009-5427_5010.wav,5100,4783,317
5316,b-3_4001-4103_4092.wav,VTTS_b-3_4001-4103_4092.wav,9690,11262,-1572
5317,b-2_815-916_901.wav,VTTS_b-2_815-916_901.wav,2630,6769,-4139
5318,b-2_1699-1800_1789.wav,VTTS_b-2_1699-1800_1789.wav,2140,3158,-1018
5319,b-1_4394-4429_4424.wav,VTTS_b-1_4394-4429_4424.wav,2390,2485,-95
5320,b-1_1919-2017_1930.wav,VTTS_b-1_1919-2017_1930.wav,3180,2868,312
5321,b-1_1919-2017_1949.wav,VTTS_b-1_1919-2017_1949.wav,5000,4656,344
5322,b-4_2000-5164_2690.wav,VTTS_b-4_2000-5164_2690.wav,6715,6513,202
5323,b-3_4001-4103_4026.wav,VTTS_b-3_4001-4103_4026.wav,6800,6269,531
5324,b-3_4607-5008_4673.wav,VTTS_b-3_4607-5008_4673.wav,2660,2647,13
5325,b-4_2000-5164_3487.wav,VTTS_b-4_2000-5164_3487.wav,5245,5050,195
5326,b-3_501-930_762.wav,VTTS_b-3_501-930_762.wav,4380,4191,189
5327,b-3_3279-3363_3356.wav,VTTS_b-3_3279-3363_3356.wav,3350,3297,53
5328,b-3_4607-5008_4707.wav,VTTS_b-3_4607-5008_4707.wav,4040,4017,23
5329,b-4_2000-5164_3572.wav,VTTS_b-4_2000-5164_3572.wav,3119,2728,391
5330,b-1_2927-3025_3004.wav,VTTS_b-1_2927-3025_3004.wav,3060,3204,-144
5331,b-3_2267-2349_2306.wav,VTTS_b-3_2267-2349_2306.wav,3690,4865,-1175
5332,b-1_478-578_575.wav,VTTS_b-1_478-578_575.wav,1360,1672,-312
5333,b-4_2000-5164_3704.wav,VTTS_b-4_2000-5164_3704.wav,4660,4656,4
5334,b-3_501-930_850.wav,VTTS_b-3_501-930_850.wav,3160,3170,-10
5335,b-4_2000-5164_4788.wav,VTTS_b-4_2000-5164_4788.wav,3925,4296,-371
5336,b-4_2000-5164_2833.wav,VTTS_b-4_2000-5164_2833.wav,4620,4725,-105
5337,b-3_5533-5638_5579.wav,VTTS_b-3_5533-5638_5579.wav,6090,5770,320
5338,b-1_1515-1615_1593.wav,VTTS_b-1_1515-1615_1593.wav,1360,1382,-22
5339,b-4_2000-5164_3305.wav,VTTS_b-4_2000-5164_3305.wav,6123,6153,-30
5340,b-3_2855-2942_2867.wav,VTTS_b-3_2855-2942_2867.wav,4000,4714,-714
5341,b-3_5009-5427_5255.wav,VTTS_b-3_5009-5427_5255.wav,4100,4122,-22
5342,b-2_611-712_705.wav,VTTS_b-2_611-712_705.wav,2350,2252,98
5343,b-3_6116-6215_6182.wav,VTTS_b-3_6116-6215_6182.wav,8960,9207,-247
5344,b-1_1717-1817_1778.wav,VTTS_b-1_1717-1817_1778.wav,1410,1265,145
5345,b-3_5745-5852_5817.wav,VTTS_b-3_5745-5852_5817.wav,4960,4284,676
5346,b-1_1111-1211_1160.wav,VTTS_b-1_1111-1211_1160.wav,3460,4156,-696
5347,b-2_815-916_839.wav,VTTS_b-2_815-916_839.wav,1290,1091,199
5348,b-4_1221-1300_1255.wav,VTTS_b-4_1221-1300_1255.wav,1870,1718,152
5349,b-3_4498-4605_4587.wav,VTTS_b-3_4498-4605_4587.wav,8800,11610,-2810
5350,b-3_3803-3888_3804.wav,VTTS_b-3_3803-3888_3804.wav,5260,4841,419
5351,b-4_151-300_277.wav,VTTS_b-4_151-300_277.wav,5590,5213,377
5352,b-2_1903-2038_1970.wav,VTTS_b-2_1903-2038_1970.wav,2150,2113,37
5353,b-1_4214-4285_4231.wav,VTTS_b-1_4214-4285_4231.wav,2690,2926,-236
5354,b-1_2119-2219_2149.wav,VTTS_b-1_2119-2219_2149.wav,2620,2937,-317
5355,b-2_407-508_478.wav,VTTS_b-2_407-508_478.wav,2210,2554,-344
5356,b-4_2000-5164_4164.wav,VTTS_b-4_2000-5164_4164.wav,5882,7860,-1978
5357,b-4_2000-5164_4283.wav,VTTS_b-4_2000-5164_4283.wav,5067,11610,-6543
5358,b-2_1801-1902_1889.wav,VTTS_b-2_1801-1902_1889.wav,2300,2670,-370
5359,b-2_509-610_599.wav,VTTS_b-2_509-610_599.wav,3870,3077,793
5360,b-3_3454-3537_3488.wav,VTTS_b-3_3454-3537_3488.wav,3970,3982,-12
5361,b-4_151-300_225.wav,VTTS_b-4_151-300_225.wav,4300,4540,-240
5362,b-4_2000-5164_3345.wav,VTTS_b-4_2000-5164_3345.wav,4350,4644,-294
5363,b-4_2000-5164_2164.wav,VTTS_b-4_2000-5164_2164.wav,2510,2368,142
5364,b-1_1616-1716_1630.wav,VTTS_b-1_1616-1716_1630.wav,1180,1033,147
5365,b-1_276-376_295.wav,VTTS_b-1_276-376_295.wav,2120,2183,-63
5366,b-4_1401-1505_1483.wav,VTTS_b-4_1401-1505_1483.wav,4860,5375,-515
5367,b-3_5428-5533_5466.wav,VTTS_b-3_5428-5533_5466.wav,3520,3553,-33
5368,b-3_5639-5744_5712.wav,VTTS_b-3_5639-5744_5712.wav,2440,2403,37
5369,b-3_4104-4206_4195.wav,VTTS_b-3_4104-4206_4195.wav,4390,3727,663
5370,b-2_1597-1698_1622.wav,VTTS_b-2_1597-1698_1622.wav,6640,6885,-245
5371,b-2_1801-1902_1859.wav,VTTS_b-2_1801-1902_1859.wav,4300,3529,771
5372,b-3_5009-5427_5015.wav,VTTS_b-3_5009-5427_5015.wav,5520,5526,-6
5373,b-4_501-1014_673.wav,VTTS_b-4_501-1014_673.wav,5730,5329,401
5374,b-3_4607-5008_4687.wav,VTTS_b-3_4607-5008_4687.wav,6420,6653,-233
5375,b-3_501-930_722.wav,VTTS_b-3_501-930_722.wav,3220,3262,-42
5376,b-4_2000-5164_3846.wav,VTTS_b-4_2000-5164_3846.wav,3211,2972,239
5377,b-4_1601-1706_1622.wav,VTTS_b-4_1601-1706_1622.wav,9580,10310,-730
5378,b-3_4315-4424_4341.wav,VTTS_b-3_4315-4424_4341.wav,7790,6037,1753
5379,b-1_3430-3530_3480.wav,VTTS_b-1_3430-3530_3480.wav,3210,3204,6
5380,b-4_2000-5164_5022.wav,VTTS_b-4_2000-5164_5022.wav,1780,1440,340
5381,b-3_3112-3197_3195.wav,VTTS_b-3_3112-3197_3195.wav,3820,3878,-58
5382,b-3_2524-2854_2804.wav,VTTS_b-3_2524-2854_2804.wav,6250,6223,27
5383,b-4_501-1014_713.wav,VTTS_b-4_501-1014_713.wav,5080,11610,-6530
5384,b-3_1568-1665_1616.wav,VTTS_b-3_1568-1665_1616.wav,1960,2159,-199
5385,b-3_6900-7016_7012.wav,VTTS_b-3_6900-7016_7012.wav,5090,4818,272
5386,b-2_203-304_214.wav,VTTS_b-2_203-304_214.wav,1120,1068,52
5387,b-4_1601-1706_1641.wav,VTTS_b-4_1601-1706_1641.wav,5710,4853,857
5388,b-3_4207-4314_4281.wav,VTTS_b-3_4207-4314_4281.wav,6020,5782,238
5389,b-4_2000-5164_3120.wav,VTTS_b-4_2000-5164_3120.wav,5680,5654,26
5390,b-3_3198-3278_3240.wav,VTTS_b-3_3198-3278_3240.wav,6110,6316,-206
5391,b-1_2523-2623_2556.wav,VTTS_b-1_2523-2623_2556.wav,2280,1858,422
5392,b-4_2000-5164_4486.wav,VTTS_b-4_2000-5164_4486.wav,3096,3135,-39
5393,b-3_5009-5427_5140.wav,VTTS_b-3_5009-5427_5140.wav,1110,1138,-28
5394,b-1_2321-2421_2410.wav,VTTS_b-1_2321-2421_2410.wav,2430,2055,375
5395,b-4_1601-1706_1699.wav,VTTS_b-4_1601-1706_1699.wav,4760,6432,-1672
5396,b-4_501-1014_920.wav,VTTS_b-4_501-1014_920.wav,4790,3796,994
5397,b-1_2624-2724_2643.wav,VTTS_b-1_2624-2724_2643.wav,1220,1207,13
5398,b-3_294-391_348.wav,VTTS_b-3_294-391_348.wav,7240,7303,-63
5399,b-3_2524-2854_2572.wav,VTTS_b-3_2524-2854_2572.wav,1700,1683,17
5400,b-4_2000-5164_4936.wav,VTTS_b-4_2000-5164_4936.wav,3783,3541,242
5401,b-4_2000-5164_3246.wav,VTTS_b-4_2000-5164_3246.wav,3311,3785,-474
5402,b-3_6301-6400_6377.wav,VTTS_b-3_6301-6400_6377.wav,5670,5433,237
5403,b-2_611-712_657.wav,VTTS_b-2_611-712_657.wav,1030,1149,-119
5404,b-4_2000-5164_3903.wav,VTTS_b-4_2000-5164_3903.wav,7130,6954,176
5405,b-2_2209-2310_2258.wav,VTTS_b-2_2209-2310_2258.wav,1230,1207,23
5406,b-3_3112-3197_3184.wav,VTTS_b-3_3112-3197_3184.wav,1850,1730,120
5407,b-1_2927-3025_2998.wav,VTTS_b-1_2927-3025_2998.wav,2590,3158,-568
5408,b-2_1325-1426_1420.wav,VTTS_b-2_1325-1426_1420.wav,2030,2287,-257
5409,b-3_5009-5427_5230.wav,VTTS_b-3_5009-5427_5230.wav,3860,4075,-215
5410,b-1_1313-1413_1360.wav,VTTS_b-1_1313-1413_1360.wav,1620,1347,273
5411,b-3_2000-2088_2085.wav,VTTS_b-3_2000-2088_2085.wav,4610,4122,488
5412,b-1_4430-4465_4434.wav,VTTS_b-1_4430-4465_4434.wav,2670,3123,-453
5413,b-4_2000-5164_3639.wav,VTTS_b-4_2000-5164_3639.wav,1975,1823,152
5414,b-3_6301-6400_6312.wav,VTTS_b-3_6301-6400_6312.wav,2200,2113,87
5415,b-2_1019-1120_1024.wav,VTTS_b-2_1019-1120_1024.wav,1410,2148,-738
5416,b-3_2089-2176_2098.wav,VTTS_b-3_2089-2176_2098.wav,6730,5445,1285
5417,b-2_1-100_57.wav,VTTS_b-2_1-100_57.wav,3480,6269,-2789
5418,b-1_478-578_550.wav,VTTS_b-1_478-578_550.wav,1420,1625,-205
5419,b-2_1223-1324_1299.wav,VTTS_b-2_1223-1324_1299.wav,3830,3053,777
5420,b-1_3127-3227_3171.wav,VTTS_b-1_3127-3227_3171.wav,3650,3460,190
5421,b-2_1121-1222_1166.wav,VTTS_b-2_1121-1222_1166.wav,1700,1265,435
5422,b-3_3279-3363_3333.wav,VTTS_b-3_3279-3363_3333.wav,3120,3111,9
5423,b-1_1414-1514_1464.wav,VTTS_b-1_1414-1514_1464.wav,2310,2496,-186
5424,b-1_4466-4498_4483.wav,VTTS_b-1_4466-4498_4483.wav,1760,1846,-86
5425,b-1_2523-2623_2589.wav,VTTS_b-1_2523-2623_2589.wav,2010,1904,106
5426,b-4_2000-5164_3234.wav,VTTS_b-4_2000-5164_3234.wav,5734,5921,-187
5427,b-4_501-1014_811.wav,VTTS_b-4_501-1014_811.wav,2930,2949,-19
5428,b-4_1901-2000_1947.wav,VTTS_b-4_1901-2000_1947.wav,5290,5642,-352
5429,b-1_3026-3126_3054.wav,VTTS_b-1_3026-3126_3054.wav,5760,6130,-370
5430,b-3_2524-2854_2722.wav,VTTS_b-3_2524-2854_2722.wav,6100,5735,365
5431,b-3_4498-4605_4549.wav,VTTS_b-3_4498-4605_4549.wav,4090,4098,-8
5432,b-3_2524-2854_2738.wav,VTTS_b-3_2524-2854_2738.wav,2990,3053,-63
5433,b-4_2000-5164_2449.wav,VTTS_b-4_2000-5164_2449.wav,4120,4342,-222
5434,b-3_1568-1665_1614.wav,VTTS_b-3_1568-1665_1614.wav,6380,5805,575
5435,b-3_3803-3888_3808.wav,VTTS_b-3_3803-3888_3808.wav,6260,5433,827
5436,b-3_6217-6274_6260.wav,VTTS_b-3_6217-6274_6260.wav,9910,10019,-109
5437,b-1_1111-1211_1144.wav,VTTS_b-1_1111-1211_1144.wav,4870,3901,969
5438,b-1_579-649_585.wav,VTTS_b-1_579-649_585.wav,2240,2276,-36
5439,b-3_1666-1763_1714.wav,VTTS_b-3_1666-1763_1714.wav,6380,6873,-493
5440,b-2_509-610_522.wav,VTTS_b-2_509-610_522.wav,2180,1300,880
5441,b-3_3889-4000_3954.wav,VTTS_b-3_3889-4000_3954.wav,5340,5294,46
5442,b-1_1818-1918_1847.wav,VTTS_b-1_1818-1918_1847.wav,2430,2183,247
5443,b-2_101-202_151.wav,VTTS_b-2_101-202_151.wav,1600,1695,-95
5444,b-3_3538-3627_3584.wav,VTTS_b-3_3538-3627_3584.wav,4800,4923,-123
5445,b-4_2000-5164_4604.wav,VTTS_b-4_2000-5164_4604.wav,1561,1823,-262
5446,b-2_1801-1902_1821.wav,VTTS_b-2_1801-1902_1821.wav,5550,5642,-92
5447,b-4_2000-5164_3790.wav,VTTS_b-4_2000-5164_3790.wav,1900,1753,147
5448,b-3_6900-7016_6994.wav,VTTS_b-3_6900-7016_6994.wav,530,453,77
5449,b-4_2000-5164_2122.wav,VTTS_b-4_2000-5164_2122.wav,4290,4203,87
5450,b-4_1301-1400_1362.wav,VTTS_b-4_1301-1400_1362.wav,6930,6908,22
5451,b-3_4607-5008_4772.wav,VTTS_b-3_4607-5008_4772.wav,2700,3286,-586
5452,b-3_1764-1861_1769.wav,VTTS_b-3_1764-1861_1769.wav,3270,3982,-712
5453,b-4_2000-5164_2923.wav,VTTS_b-4_2000-5164_2923.wav,3709,3425,284
5454,b-1_1515-1615_1540.wav,VTTS_b-1_1515-1615_1540.wav,3420,3762,-342
5455,b-4_2000-5164_4806.wav,VTTS_b-4_2000-5164_4806.wav,1172,964,208
5456,b-4_2000-5164_5079.wav,VTTS_b-4_2000-5164_5079.wav,2940,3262,-322
5457,b-3_501-930_588.wav,VTTS_b-3_501-930_588.wav,6700,6769,-69
5458,b-3_6900-7016_7007.wav,VTTS_b-3_6900-7016_7007.wav,2860,2264,596
5459,b-3_3364-3453_3443.wav,VTTS_b-3_3364-3453_3443.wav,4240,4087,153
5460,b-4_2000-5164_3134.wav,VTTS_b-4_2000-5164_3134.wav,3421,3111,310
5461,b-3_3198-3278_3227.wav,VTTS_b-3_3198-3278_3227.wav,5420,6165,-745
5462,b-1_4178-4213_4206.wav,VTTS_b-1_4178-4213_4206.wav,3800,4029,-229
5463,b-4_2000-5164_2240.wav,VTTS_b-4_2000-5164_2240.wav,950,755,195
5464,b-3_294-391_321.wav,VTTS_b-3_294-391_321.wav,7620,7744,-124
5465,b-1_377-477_427.wav,VTTS_b-1_377-477_427.wav,1440,1602,-162
5466,b-1_3834-3934_3855.wav,VTTS_b-1_3834-3934_3855.wav,3240,2937,303
5467,b-1_2422-2522_2491.wav,VTTS_b-1_2422-2522_2491.wav,2350,2694,-344
5468,b-2_2311-2412_2363.wav,VTTS_b-2_2311-2412_2363.wav,3200,3878,-678
5469,b-4_1401-1505_1456.wav,VTTS_b-4_1401-1505_1456.wav,4570,4435,135
5470,b-1_3127-3227_3141.wav,VTTS_b-1_3127-3227_3141.wav,2610,2949,-339
5471,b-3_3279-3363_3304.wav,VTTS_b-3_3279-3363_3304.wav,5890,5457,433
5472,b-3_98-195_119.wav,VTTS_b-3_98-195_119.wav,3700,3773,-73
5473,b-4_2000-5164_5095.wav,VTTS_b-4_2000-5164_5095.wav,6096,5898,198
5474,b-3_5428-5533_5529.wav,VTTS_b-3_5428-5533_5529.wav,3390,3111,279
5475,b-4_2000-5164_4379.wav,VTTS_b-4_2000-5164_4379.wav,5145,5155,-10
5476,b-4_2000-5164_2868.wav,VTTS_b-4_2000-5164_2868.wav,10770,11610,-840
5477,b-1_74-174_173.wav,VTTS_b-1_74-174_173.wav,2790,3042,-252
5478,b-2_1427-1562_1489.wav,VTTS_b-2_1427-1562_1489.wav,1360,1370,-10
5479,b-4_501-1014_919.wav,VTTS_b-4_501-1014_919.wav,3300,3379,-79
5480,b-2_1801-1902_1819.wav,VTTS_b-2_1801-1902_1819.wav,2690,2519,171
5481,b-3_2177-2266_2179.wav,VTTS_b-3_2177-2266_2179.wav,5620,4760,860
5482,b-4_2000-5164_4206.wav,VTTS_b-4_2000-5164_4206.wav,5756,11610,-5854
5483,b-2_407-508_470.wav,VTTS_b-2_407-508_470.wav,1640,1498,142
5484,b-1_1212-1312_1254.wav,VTTS_b-1_1212-1312_1254.wav,3690,3738,-48
5485,b-2_2194-2208_2205.wav,VTTS_b-2_2194-2208_2205.wav,2290,2322,-32
5486,b-4_2000-5164_4416.wav,VTTS_b-4_2000-5164_4416.wav,1243,1115,128
5487,b-1_3127-3227_3173.wav,VTTS_b-1_3127-3227_3173.wav,3080,4017,-937
5488,b-3_3628-3714_3666.wav,VTTS_b-3_3628-3714_3666.wav,3620,3518,102
5489,b-3_4315-4424_4339.wav,VTTS_b-3_4315-4424_4339.wav,7440,8278,-838
5490,b-3_5009-5427_5200.wav,VTTS_b-3_5009-5427_5200.wav,4120,3901,219
5491,b-4_1506-1600_1539.wav,VTTS_b-4_1506-1600_1539.wav,2010,2125,-115
5492,b-3_2267-2349_2344.wav,VTTS_b-3_2267-2349_2344.wav,4130,4888,-758
5493,b-2_305-406_358.wav,VTTS_b-2_305-406_358.wav,1720,1939,-219
5494,b-3_6501-6600_6551.wav,VTTS_b-3_6501-6600_6551.wav,6600,6200,400
5495,b-1_4070-4105_4103.wav,VTTS_b-1_4070-4105_4103.wav,2750,2891,-141
5496,b-3_3803-3888_3871.wav,VTTS_b-3_3803-3888_3871.wav,6140,5851,289
5497,b-3_4001-4103_4068.wav,VTTS_b-3_4001-4103_4068.wav,1170,1045,125
5498,b-4_301-400_337.wav,VTTS_b-4_301-400_337.wav,2160,2357,-197
5499,b-4_53-150_120.wav,VTTS_b-4_53-150_120.wav,9050,7744,1306
5500,b-3_196-293_247.wav,VTTS_b-3_196-293_247.wav,5410,5503,-93
5501,b-3_4104-4206_4126.wav,VTTS_b-3_4104-4206_4126.wav,1350,1277,73
5502,b-2_305-406_385.wav,VTTS_b-2_305-406_385.wav,1560,1533,27
5503,b-4_1101-1220_1113.wav,VTTS_b-4_1101-1220_1113.wav,6310,7012,-702
5504,b-1_3531-3631_3615.wav,VTTS_b-1_3531-3631_3615.wav,4770,6153,-1383
5505,b-3_6801-6900_6869.wav,VTTS_b-3_6801-6900_6869.wav,4430,4133,297
5506,b-2_1801-1902_1835.wav,VTTS_b-2_1801-1902_1835.wav,2870,2682,188
5507,b-4_151-300_268.wav,VTTS_b-4_151-300_268.wav,3170,4180,-1010
5508,b-1_2523-2623_2602.wav,VTTS_b-1_2523-2623_2602.wav,1070,871,199
5509,b-2_2413-2500_2414.wav,VTTS_b-2_2413-2500_2414.wav,1330,1254,76
5510,b-1_1313-1413_1340.wav,VTTS_b-1_1313-1413_1340.wav,3750,2926,824
5511,b-4_2000-5164_3480.wav,VTTS_b-4_2000-5164_3480.wav,6249,11610,-5361
5512,b-1_1717-1817_1779.wav,VTTS_b-1_1717-1817_1779.wav,3300,4075,-775
5513,b-4_2000-5164_2259.wav,VTTS_b-4_2000-5164_2259.wav,2320,2566,-246
5514,b-4_1707-1813_1801.wav,VTTS_b-4_1707-1813_1801.wav,3390,3193,197
5515,b-4_2000-5164_2296.wav,VTTS_b-4_2000-5164_2296.wav,7760,10844,-3084
5516,b-1_377-477_414.wav,VTTS_b-1_377-477_414.wav,4140,3750,390
5517,b-3_1-97_94.wav,VTTS_b-3_1-97_94.wav,11210,8893,2317
5518,b-1_3834-3934_3918.wav,VTTS_b-1_3834-3934_3918.wav,1400,1393,7
5519,b-3_6801-6900_6863.wav,VTTS_b-3_6801-6900_6863.wav,3520,3785,-265
5520,b-4_2000-5164_2382.wav,VTTS_b-4_2000-5164_2382.wav,2805,3808,-1003
5521,b-3_1321-1568_1340.wav,VTTS_b-3_1321-1568_1340.wav,3400,3100,300
5522,b-3_5853-5956_5894.wav,VTTS_b-3_5853-5956_5894.wav,4180,3448,732
5523,b-4_501-1014_643.wav,VTTS_b-4_501-1014_643.wav,3710,3704,6
5524,b-4_2000-5164_4335.wav,VTTS_b-4_2000-5164_4335.wav,2670,2670,0
5525,b-3_1321-1568_1366.wav,VTTS_b-3_1321-1568_1366.wav,4950,5840,-890
5526,b-3_4425-4497_4469.wav,VTTS_b-3_4425-4497_4469.wav,5330,4528,802
5527,b-3_1-97_24.wav,VTTS_b-3_1-97_24.wav,4920,4412,508
5528,b-3_2855-2942_2861.wav,VTTS_b-3_2855-2942_2861.wav,7530,7686,-156
5529,b-1_377-477_449.wav,VTTS_b-1_377-477_449.wav,3340,3460,-120
5530,b-3_4498-4605_4501.wav,VTTS_b-3_4498-4605_4501.wav,4720,4365,355
5531,b-3_5639-5744_5691.wav,VTTS_b-3_5639-5744_5691.wav,6480,5619,861
5532,b-4_53-150_112.wav,VTTS_b-4_53-150_112.wav,9820,8893,927
5533,b-1_2826-2926_2918.wav,VTTS_b-1_2826-2926_2918.wav,2830,3274,-444
5534,b-3_3715-3802_3722.wav,VTTS_b-3_3715-3802_3722.wav,10240,10577,-337
5535,b-4_2000-5164_5049.wav,VTTS_b-4_2000-5164_5049.wav,1853,1579,274
5536,b-4_2000-5164_3474.wav,VTTS_b-4_2000-5164_3474.wav,3448,3193,255
5537,b-1_2624-2724_2702.wav,VTTS_b-1_2624-2724_2702.wav,2900,3204,-304
5538,b-3_4607-5008_4657.wav,VTTS_b-3_4607-5008_4657.wav,4890,4516,374
5539,b-4_2000-5164_2533.wav,VTTS_b-4_2000-5164_2533.wav,4580,5399,-819
5540,b-4_2000-5164_2695.wav,VTTS_b-4_2000-5164_2695.wav,1530,1451,79
5541,b-2_1903-2038_1968.wav,VTTS_b-2_1903-2038_1968.wav,1790,1567,223
5542,b-3_3279-3363_3322.wav,VTTS_b-3_3279-3363_3322.wav,5040,4899,141
5543,b-3_501-930_679.wav,VTTS_b-3_501-930_679.wav,8180,8139,41
5544,b-3_5009-5427_5115.wav,VTTS_b-3_5009-5427_5115.wav,4730,5422,-692
5545,b-3_3364-3453_3373.wav,VTTS_b-3_3364-3453_3373.wav,4090,4272,-182
5546,b-3_2267-2349_2323.wav,VTTS_b-3_2267-2349_2323.wav,11740,11610,130
5547,b-3_3628-3714_3693.wav,VTTS_b-3_3628-3714_3693.wav,8200,6177,2023
5548,b-4_2000-5164_4273.wav,VTTS_b-4_2000-5164_4273.wav,1941,1974,-33
5549,b-3_4207-4314_4293.wav,VTTS_b-3_4207-4314_4293.wav,3170,2902,268
5550,b-3_3112-3197_3193.wav,VTTS_b-3_3112-3197_3193.wav,4050,3007,1043
5551,b-4_501-1014_869.wav,VTTS_b-4_501-1014_869.wav,5640,6269,-629
5552,b-3_6801-6900_6868.wav,VTTS_b-3_6801-6900_6868.wav,3860,3727,133
5553,b-4_2000-5164_3171.wav,VTTS_b-4_2000-5164_3171.wav,2820,2612,208
5554,b-1_2725-2825_2791.wav,VTTS_b-1_2725-2825_2791.wav,1380,1103,277
5555,b-3_196-293_197.wav,VTTS_b-3_196-293_197.wav,3740,3135,605
5556,b-1_1919-2017_1979.wav,VTTS_b-1_1919-2017_1979.wav,1550,1324,226
5557,b-3_5009-5427_5337.wav,VTTS_b-3_5009-5427_5337.wav,4660,4772,-112
5558,b-4_2000-5164_4163.wav,VTTS_b-4_2000-5164_4163.wav,4916,5828,-912
5559,b-1_2220-2320_2251.wav,VTTS_b-1_2220-2320_2251.wav,1940,1741,199
5560,b-3_6016-6115_6095.wav,VTTS_b-3_6016-6115_6095.wav,12380,11610,770
5561,b-4_2000-5164_4506.wav,VTTS_b-4_2000-5164_4506.wav,5099,4354,745
5562,b-2_407-508_487.wav,VTTS_b-2_407-508_487.wav,1150,1207,-57
5563,b-1_4394-4429_4405.wav,VTTS_b-1_4394-4429_4405.wav,1560,1521,39
5564,b-4_151-300_207.wav,VTTS_b-4_151-300_207.wav,7070,7384,-314
5565,b-3_5639-5744_5739.wav,VTTS_b-3_5639-5744_5739.wav,3250,3471,-221
5566,b-3_1079-1320_1217.wav,VTTS_b-3_1079-1320_1217.wav,2330,3042,-712
5567,b-1_579-649_600.wav,VTTS_b-1_579-649_600.wav,1930,1858,72
5568,b-2_1597-1698_1697.wav,VTTS_b-2_1597-1698_1697.wav,1580,1382,198
5569,b-1_377-477_407.wav,VTTS_b-1_377-477_407.wav,5310,6896,-1586
5570,b-3_196-293_198.wav,VTTS_b-3_196-293_198.wav,5490,5132,358
5571,b-1_1111-1211_1147.wav,VTTS_b-1_1111-1211_1147.wav,3420,3274,146
5572,b-2_101-202_169.wav,VTTS_b-2_101-202_169.wav,1570,1567,3
5573,b-4_2000-5164_4149.wav,VTTS_b-4_2000-5164_4149.wav,3511,2891,620
5574,b-4_2000-5164_2465.wav,VTTS_b-4_2000-5164_2465.wav,6755,7129,-374
5575,b-3_501-930_717.wav,VTTS_b-3_501-930_717.wav,1900,1858,42
5576,b-3_3538-3627_3613.wav,VTTS_b-3_3538-3627_3613.wav,5140,4841,299
5577,b-3_6701-6800_6758.wav,VTTS_b-3_6701-6800_6758.wav,12380,10879,1501
5578,b-2_1563-1596_1592.wav,VTTS_b-2_1563-1596_1592.wav,1780,1776,4
5579,b-3_5009-5427_5378.wav,VTTS_b-3_5009-5427_5378.wav,5110,5480,-370
5580,b-3_2177-2266_2241.wav,VTTS_b-3_2177-2266_2241.wav,7060,5991,1069
5581,b-1_3632-3732_3730.wav,VTTS_b-1_3632-3732_3730.wav,3180,2937,243
5582,b-4_2000-5164_3963.wav,VTTS_b-4_2000-5164_3963.wav,4411,4098,313
5583,b-4_1707-1813_1741.wav,VTTS_b-4_1707-1813_1741.wav,2800,2705,95
5584,b-1_3430-3530_3485.wav,VTTS_b-1_3430-3530_3485.wav,2010,2090,-80
5585,b-3_3198-3278_3261.wav,VTTS_b-3_3198-3278_3261.wav,14240,11610,2630
5586,b-1_1010-1110_1076.wav,VTTS_b-1_1010-1110_1076.wav,1950,1916,34
5587,b-3_6301-6400_6386.wav,VTTS_b-3_6301-6400_6386.wav,3610,4087,-477
5588,b-3_4104-4206_4167.wav,VTTS_b-3_4104-4206_4167.wav,8270,7860,410
5589,b-4_2000-5164_3547.wav,VTTS_b-4_2000-5164_3547.wav,4184,3506,678
5590,b-3_1079-1320_1169.wav,VTTS_b-3_1079-1320_1169.wav,5650,5863,-213
5591,b-2_1699-1800_1737.wav,VTTS_b-2_1699-1800_1737.wav,3220,3669,-449
5592,b-3_4607-5008_4639.wav,VTTS_b-3_4607-5008_4639.wav,2540,2485,55
5593,b-3_501-930_888.wav,VTTS_b-3_501-930_888.wav,2230,2078,152
5594,b-1_2321-2421_2380.wav,VTTS_b-1_2321-2421_2380.wav,2400,2508,-108
5595,b-4_2000-5164_2754.wav,VTTS_b-4_2000-5164_2754.wav,6100,6931,-831
5596,b-1_3935-4033_3950.wav,VTTS_b-1_3935-4033_3950.wav,1200,1428,-228
5597,b-1_579-649_599.wav,VTTS_b-1_579-649_599.wav,1330,1184,146
5598,b-4_1221-1300_1262.wav,VTTS_b-4_1221-1300_1262.wav,3710,4029,-319
5599,b-3_6501-6600_6549.wav,VTTS_b-3_6501-6600_6549.wav,3570,4156,-586
5600,b-1_1414-1514_1466.wav,VTTS_b-1_1414-1514_1466.wav,1460,1207,253
5601,b-4_2000-5164_3343.wav,VTTS_b-4_2000-5164_3343.wav,7117,7430,-313
5602,b-3_5009-5427_5165.wav,VTTS_b-3_5009-5427_5165.wav,4340,4005,335
5603,b-2_407-508_461.wav,VTTS_b-2_407-508_461.wav,3470,5550,-2080
5604,b-3_2434-2523_2467.wav,VTTS_b-3_2434-2523_2467.wav,4230,4365,-135
5605,b-4_2000-5164_4386.wav,VTTS_b-4_2000-5164_4386.wav,6002,5666,336
5606,b-3_4607-5008_4781.wav,VTTS_b-3_4607-5008_4781.wav,5900,6385,-485
5607,b-1_794-1009_827.wav,VTTS_b-1_794-1009_827.wav,3170,2241,929
5608,b-3_4498-4605_4567.wav,VTTS_b-3_4498-4605_4567.wav,5250,4667,583
5609,b-3_6701-6800_6703.wav,VTTS_b-3_6701-6800_6703.wav,11600,11610,-10
5610,b-2_203-304_224.wav,VTTS_b-2_203-304_224.wav,3740,3669,71
5611,b-3_2177-2266_2238.wav,VTTS_b-3_2177-2266_2238.wav,1610,2577,-967
5612,b-3_5639-5744_5663.wav,VTTS_b-3_5639-5744_5663.wav,5400,5828,-428
5613,b-3_3025-3111_3095.wav,VTTS_b-3_3025-3111_3095.wav,3430,3100,330
5614,b-3_5639-5744_5678.wav,VTTS_b-3_5639-5744_5678.wav,5480,11610,-6130
5615,b-1_1212-1312_1246.wav,VTTS_b-1_1212-1312_1246.wav,2190,1950,240
5616,b-3_1-97_45.wav,VTTS_b-3_1-97_45.wav,4060,3796,264
5617,b-3_4607-5008_4825.wav,VTTS_b-3_4607-5008_4825.wav,8110,8208,-98
5618,b-3_2524-2854_2569.wav,VTTS_b-3_2524-2854_2569.wav,5950,5457,493
5619,b-1_4178-4213_4212.wav,VTTS_b-1_4178-4213_4212.wav,2180,2020,160
5620,b-1_3632-3732_3715.wav,VTTS_b-1_3632-3732_3715.wav,3240,3251,-11
5621,b-4_2000-5164_3252.wav,VTTS_b-4_2000-5164_3252.wav,5104,5213,-109
5622,b-4_1301-1400_1363.wav,VTTS_b-4_1301-1400_1363.wav,8220,7140,1080
5623,b-3_3112-3197_3192.wav,VTTS_b-3_3112-3197_3192.wav,3340,3320,20
5624,b-3_2000-2088_2051.wav,VTTS_b-3_2000-2088_2051.wav,8200,6815,1385
5625,b-1_1515-1615_1609.wav,VTTS_b-1_1515-1615_1609.wav,2180,2101,79
5626,b-3_5428-5533_5442.wav,VTTS_b-3_5428-5533_5442.wav,2720,3286,-566
5627,b-4_2000-5164_3806.wav,VTTS_b-4_2000-5164_3806.wav,2672,2659,13
5628,b-3_6501-6600_6552.wav,VTTS_b-3_6501-6600_6552.wav,1740,2078,-338
5629,b-1_1717-1817_1765.wav,VTTS_b-1_1717-1817_1765.wav,2220,1892,328
5630,b-4_1014-1100_1016.wav,VTTS_b-4_1014-1100_1016.wav,2950,2682,268
5631,b-1_478-578_490.wav,VTTS_b-1_478-578_490.wav,3290,3251,39
5632,b-4_2000-5164_2190.wav,VTTS_b-4_2000-5164_2190.wav,5490,6687,-1197
5633,b-2_1801-1902_1858.wav,VTTS_b-2_1801-1902_1858.wav,2630,2833,-203
5634,b-3_2524-2854_2746.wav,VTTS_b-3_2524-2854_2746.wav,3240,3228,12
5635,b-4_1707-1813_1810.wav,VTTS_b-4_1707-1813_1810.wav,7060,7070,-10
5636,b-2_2413-2500_2424.wav,VTTS_b-2_2413-2500_2424.wav,1930,1800,130
5637,b-4_1-52_9.wav,VTTS_b-4_1-52_9.wav,6480,7639,-1159
5638,b-3_4207-4314_4232.wav,VTTS_b-3_4207-4314_4232.wav,4120,3971,149
5639,b-4_301-400_310.wav,VTTS_b-4_301-400_310.wav,4030,3785,245
5640,b-1_579-649_626.wav,VTTS_b-1_579-649_626.wav,2540,2450,90
5641,b-1_2321-2421_2400.wav,VTTS_b-1_2321-2421_2400.wav,1610,1683,-73
5642,b-4_2000-5164_2685.wav,VTTS_b-4_2000-5164_2685.wav,2100,2090,10
5643,b-2_2413-2500_2465.wav,VTTS_b-2_2413-2500_2465.wav,3470,3065,405
5644,b-4_2000-5164_4680.wav,VTTS_b-4_2000-5164_4680.wav,5915,5851,64
5645,b-4_2000-5164_3744.wav,VTTS_b-4_2000-5164_3744.wav,1220,1173,47
5646,b-3_1764-1861_1861.wav,VTTS_b-3_1764-1861_1861.wav,3760,3262,498
5647,b-4_2000-5164_4764.wav,VTTS_b-4_2000-5164_4764.wav,10956,11610,-654
5648,b-1_1616-1716_1644.wav,VTTS_b-1_1616-1716_1644.wav,2880,2717,163
5649,b-4_501-1014_556.wav,VTTS_b-4_501-1014_556.wav,4560,4168,392
5650,b-2_1903-2038_1923.wav,VTTS_b-2_1903-2038_1923.wav,1870,1858,12
5651,b-2_101-202_174.wav,VTTS_b-2_101-202_174.wav,1420,1405,15
5652,b-1_794-1009_814.wav,VTTS_b-1_794-1009_814.wav,2140,2461,-321
5653,b-4_1301-1400_1348.wav,VTTS_b-4_1301-1400_1348.wav,7910,7744,166
5654,b-4_2000-5164_3192.wav,VTTS_b-4_2000-5164_3192.wav,3842,4029,-187
5655,b-3_3198-3278_3219.wav,VTTS_b-3_3198-3278_3219.wav,2860,2786,74
5656,b-4_2000-5164_2027.wav,VTTS_b-4_2000-5164_2027.wav,8060,10855,-2795
5657,b-3_5009-5427_5363.wav,VTTS_b-3_5009-5427_5363.wav,2360,2461,-101
5658,b-1_2826-2926_2845.wav,VTTS_b-1_2826-2926_2845.wav,2040,2043,-3
5659,b-3_2855-2942_2860.wav,VTTS_b-3_2855-2942_2860.wav,3170,3251,-81
5660,b-1_3834-3934_3922.wav,VTTS_b-1_3834-3934_3922.wav,1020,1869,-849
5661,b-4_2000-5164_2977.wav,VTTS_b-4_2000-5164_2977.wav,4883,5224,-341
5662,b-4_501-1014_912.wav,VTTS_b-4_501-1014_912.wav,3470,2902,568
5663,b-1_2826-2926_2828.wav,VTTS_b-1_2826-2926_2828.wav,2650,2531,119
5664,b-1_3127-3227_3192.wav,VTTS_b-1_3127-3227_3192.wav,1510,1416,94
5665,b-3_5533-5638_5632.wav,VTTS_b-3_5533-5638_5632.wav,5160,4748,412
5666,b-4_2000-5164_4893.wav,VTTS_b-4_2000-5164_4893.wav,5060,4772,288
5667,b-4_2000-5164_2561.wav,VTTS_b-4_2000-5164_2561.wav,7025,7384,-359
5668,b-4_501-1014_657.wav,VTTS_b-4_501-1014_657.wav,4450,4249,201
5669,b-2_2413-2500_2485.wav,VTTS_b-2_2413-2500_2485.wav,1170,1196,-26
5670,b-3_3889-4000_3999.wav,VTTS_b-3_3889-4000_3999.wav,7910,7036,874
5671,b-3_2524-2854_2724.wav,VTTS_b-3_2524-2854_2724.wav,4280,4156,124
5672,b-2_101-202_109.wav,VTTS_b-2_101-202_109.wav,1710,1916,-206
5673,b-3_196-293_238.wav,VTTS_b-3_196-293_238.wav,12320,11610,710
5674,b-3_3628-3714_3637.wav,VTTS_b-3_3628-3714_3637.wav,4440,4284,156
5675,b-4_501-1014_626.wav,VTTS_b-4_501-1014_626.wav,5390,5143,247
5676,b-4_1401-1505_1416.wav,VTTS_b-4_1401-1505_1416.wav,3190,2601,589
5677,b-4_1221-1300_1260.wav,VTTS_b-4_1221-1300_1260.wav,5840,6200,-360
5678,b-4_2000-5164_3419.wav,VTTS_b-4_2000-5164_3419.wav,4844,4899,-55
5679,b-3_5745-5852_5849.wav,VTTS_b-3_5745-5852_5849.wav,4680,4516,164
5680,b-3_4607-5008_4922.wav,VTTS_b-3_4607-5008_4922.wav,2630,2438,192
5681,b-3_5533-5638_5576.wav,VTTS_b-3_5533-5638_5576.wav,6230,6560,-330
5682,b-3_4498-4605_4534.wav,VTTS_b-3_4498-4605_4534.wav,8090,7442,648
5683,b-3_501-930_732.wav,VTTS_b-3_501-930_732.wav,8690,8046,644
5684,b-4_2000-5164_3545.wav,VTTS_b-4_2000-5164_3545.wav,5194,5224,-30
5685,b-3_1568-1665_1600.wav,VTTS_b-3_1568-1665_1600.wav,7250,6653,597
5686,b-4_1301-1400_1320.wav,VTTS_b-4_1301-1400_1320.wav,1320,1312,8
5687,b-2_2209-2310_2279.wav,VTTS_b-2_2209-2310_2279.wav,2500,2902,-402
5688,b-4_501-1014_917.wav,VTTS_b-4_501-1014_917.wav,12100,11122,978
5689,b-3_4315-4424_4363.wav,VTTS_b-3_4315-4424_4363.wav,3000,2450,550
5690,b-2_101-202_143.wav,VTTS_b-2_101-202_143.wav,2260,2635,-375
5691,b-3_4607-5008_4881.wav,VTTS_b-3_4607-5008_4881.wav,3330,3344,-14
5692,b-1_3127-3227_3205.wav,VTTS_b-1_3127-3227_3205.wav,1160,1126,34
5693,b-4_2000-5164_4971.wav,VTTS_b-4_2000-5164_4971.wav,10002,10089,-87
5694,b-4_2000-5164_2232.wav,VTTS_b-4_2000-5164_2232.wav,2770,2833,-63
5695,b-3_1666-1763_1733.wav,VTTS_b-3_1666-1763_1733.wav,6770,7663,-893
5696,b-3_4315-4424_4404.wav,VTTS_b-3_4315-4424_4404.wav,5880,7012,-1132
5697,b-1_3329-3429_3332.wav,VTTS_b-1_3329-3429_3332.wav,3770,4377,-607
5698,b-4_2000-5164_3823.wav,VTTS_b-4_2000-5164_3823.wav,2178,1974,204
5699,b-3_1079-1320_1303.wav,VTTS_b-3_1079-1320_1303.wav,4700,4621,79
5700,b-3_6301-6400_6376.wav,VTTS_b-3_6301-6400_6376.wav,10930,11610,-680
5701,b-1_1-73_16.wav,VTTS_b-1_1-73_16.wav,2100,2125,-25
5702,b-4_2000-5164_3934.wav,VTTS_b-4_2000-5164_3934.wav,3893,3727,166
5703,b-1_2119-2219_2176.wav,VTTS_b-1_2119-2219_2176.wav,2410,2299,111
5704,b-3_3889-4000_3987.wav,VTTS_b-3_3889-4000_3987.wav,6900,7454,-554
5705,b-3_3279-3363_3320.wav,VTTS_b-3_3279-3363_3320.wav,4420,3564,856
5706,b-2_611-712_624.wav,VTTS_b-2_611-712_624.wav,2990,3170,-180
5707,b-3_501-930_544.wav,VTTS_b-3_501-930_544.wav,1910,1672,238
5708,b-3_1-97_62.wav,VTTS_b-3_1-97_62.wav,4180,3808,372
5709,b-1_2523-2623_2608.wav,VTTS_b-1_2523-2623_2608.wav,1910,1916,-6
5710,b-4_2000-5164_4125.wav,VTTS_b-4_2000-5164_4125.wav,3475,3239,236
5711,b-1_4070-4105_4087.wav,VTTS_b-1_4070-4105_4087.wav,2060,1892,168
5712,b-1_4322-4357_4337.wav,VTTS_b-1_4322-4357_4337.wav,3300,3158,142
5713,b-4_2000-5164_4921.wav,VTTS_b-4_2000-5164_4921.wav,3165,11610,-8445
5714,b-1_1212-1312_1229.wav,VTTS_b-1_1212-1312_1229.wav,4490,3727,763
5715,b-3_501-930_682.wav,VTTS_b-3_501-930_682.wav,1620,1486,134
5716,b-3_5009-5427_5186.wav,VTTS_b-3_5009-5427_5186.wav,3380,3773,-393
5717,b-4_2000-5164_3559.wav,VTTS_b-4_2000-5164_3559.wav,3784,3529,255
5718,b-3_294-391_309.wav,VTTS_b-3_294-391_309.wav,5060,4865,195
5719,b-2_2311-2412_2400.wav,VTTS_b-2_2311-2412_2400.wav,3130,3460,-330
5720,b-1_1313-1413_1371.wav,VTTS_b-1_1313-1413_1371.wav,1640,1358,282
5721,b-1_1818-1918_1891.wav,VTTS_b-1_1818-1918_1891.wav,2320,2519,-199
5722,b-2_611-712_680.wav,VTTS_b-2_611-712_680.wav,1520,2078,-558
5723,b-4_1401-1505_1499.wav,VTTS_b-4_1401-1505_1499.wav,4070,4563,-493
5724,b-3_3803-3888_3810.wav,VTTS_b-3_3803-3888_3810.wav,9360,8557,803
5725,b-3_5009-5427_5301.wav,VTTS_b-3_5009-5427_5301.wav,9330,8580,750
5726,b-3_5428-5533_5475.wav,VTTS_b-3_5428-5533_5475.wav,4190,4098,92
5727,b-3_4207-4314_4279.wav,VTTS_b-3_4207-4314_4279.wav,3940,4133,-193
5728,b-3_1764-1861_1842.wav,VTTS_b-3_1764-1861_1842.wav,7200,7129,71
5729,b-4_1707-1813_1721.wav,VTTS_b-4_1707-1813_1721.wav,2330,2241,89
5730,b-4_2000-5164_2845.wav,VTTS_b-4_2000-5164_2845.wav,1735,1811,-76
5731,b-1_2018-2118_2062.wav,VTTS_b-1_2018-2118_2062.wav,2040,1881,159
5732,b-4_2000-5164_4665.wav,VTTS_b-4_2000-5164_4665.wav,3361,3959,-598
5733,b-1_2220-2320_2229.wav,VTTS_b-1_2220-2320_2229.wav,1130,1138,-8
5734,b-3_2350-2433_2356.wav,VTTS_b-3_2350-2433_2356.wav,8100,6850,1250
5735,b-3_6701-6800_6735.wav,VTTS_b-3_6701-6800_6735.wav,1640,1556,84
5736,b-4_1014-1100_1042.wav,VTTS_b-4_1014-1100_1042.wav,3460,3390,70
5737,b-3_4207-4314_4216.wav,VTTS_b-3_4207-4314_4216.wav,6600,11610,-5010
5738,b-2_1121-1222_1122.wav,VTTS_b-2_1121-1222_1122.wav,2020,2078,-58
5739,b-1_1515-1615_1573.wav,VTTS_b-1_1515-1615_1573.wav,2340,2450,-110
5740,b-4_2000-5164_2537.wav,VTTS_b-4_2000-5164_2537.wav,10035,11029,-994
5741,b-1_3935-4033_3937.wav,VTTS_b-1_3935-4033_3937.wav,1900,1927,-27
5742,b-2_1903-2038_1910.wav,VTTS_b-2_1903-2038_1910.wav,2430,2345,85
5743,b-4_2000-5164_3290.wav,VTTS_b-4_2000-5164_3290.wav,6552,6107,445
5744,b-3_2943-3024_2995.wav,VTTS_b-3_2943-3024_2995.wav,4860,5387,-527
5745,b-1_2422-2522_2471.wav,VTTS_b-1_2422-2522_2471.wav,1920,1753,167
5746,b-1_1111-1211_1176.wav,VTTS_b-1_1111-1211_1176.wav,4350,4505,-155
5747,b-2_917-1018_957.wav,VTTS_b-2_917-1018_957.wav,5130,5712,-582
5748,b-3_1079-1320_1281.wav,VTTS_b-3_1079-1320_1281.wav,11330,9973,1357
5749,b-3_2524-2854_2766.wav,VTTS_b-3_2524-2854_2766.wav,3650,3483,167
5750,b-3_1079-1320_1103.wav,VTTS_b-3_1079-1320_1103.wav,3250,4156,-906
5751,b-1_1010-1110_1080.wav,VTTS_b-1_1010-1110_1080.wav,3570,2879,691
5752,b-2_407-508_408.wav,VTTS_b-2_407-508_408.wav,2570,2496,74
5753,b-3_2524-2854_2719.wav,VTTS_b-3_2524-2854_2719.wav,4860,4690,170
5754,b-3_1321-1568_1476.wav,VTTS_b-3_1321-1568_1476.wav,2320,2218,102
5755,b-3_1666-1763_1731.wav,VTTS_b-3_1666-1763_1731.wav,8580,7546,1034
5756,b-4_2000-5164_3388.wav,VTTS_b-4_2000-5164_3388.wav,956,1045,-89
5757,b-2_1019-1120_1102.wav,VTTS_b-2_1019-1120_1102.wav,5950,4807,1143
5758,b-1_3329-3429_3347.wav,VTTS_b-1_3329-3429_3347.wav,2880,4226,-1346
5759,b-4_1014-1100_1063.wav,VTTS_b-4_1014-1100_1063.wav,2460,2322,138
5760,b-4_2000-5164_4591.wav,VTTS_b-4_2000-5164_4591.wav,2365,3553,-1188
5761,b-4_2000-5164_5108.wav,VTTS_b-4_2000-5164_5108.wav,6345,7535,-1190
5762,b-1_650-685_666.wav,VTTS_b-1_650-685_666.wav,2650,2171,479
5763,b-2_815-916_878.wav,VTTS_b-2_815-916_878.wav,1400,1324,76
5764,b-4_2000-5164_3161.wav,VTTS_b-4_2000-5164_3161.wav,1384,1196,188
5765,b-3_3364-3453_3395.wav,VTTS_b-3_3364-3453_3395.wav,6240,5190,1050
5766,b-4_2000-5164_2803.wav,VTTS_b-4_2000-5164_2803.wav,8720,11610,-2890
5767,b-3_501-930_776.wav,VTTS_b-3_501-930_776.wav,7440,8975,-1535
5768,b-2_611-712_672.wav,VTTS_b-2_611-712_672.wav,3020,3135,-115
5769,b-4_2000-5164_4111.wav,VTTS_b-4_2000-5164_4111.wav,6727,7872,-1145
5770,b-3_4607-5008_4852.wav,VTTS_b-3_4607-5008_4852.wav,2500,2438,62
5771,b-2_101-202_189.wav,VTTS_b-2_101-202_189.wav,1450,1440,10
5772,b-2_815-916_881.wav,VTTS_b-2_815-916_881.wav,1970,1683,287
5773,b-3_6701-6800_6754.wav,VTTS_b-3_6701-6800_6754.wav,5470,5155,315
5774,b-2_1019-1120_1061.wav,VTTS_b-2_1019-1120_1061.wav,1990,2519,-529
5775,b-4_151-300_193.wav,VTTS_b-4_151-300_193.wav,4570,4180,390
5776,b-4_2000-5164_4839.wav,VTTS_b-4_2000-5164_4839.wav,5352,4563,789
5777,b-1_794-1009_863.wav,VTTS_b-1_794-1009_863.wav,2000,2322,-322
5778,b-3_1079-1320_1146.wav,VTTS_b-3_1079-1320_1146.wav,2640,2426,214
5779,b-1_1-73_6.wav,VTTS_b-1_1-73_6.wav,3590,5573,-1983
5780,b-2_203-304_252.wav,VTTS_b-2_203-304_252.wav,2770,2670,100
5781,b-1_1313-1413_1412.wav,VTTS_b-1_1313-1413_1412.wav,1780,1521,259
5782,b-1_3228-3328_3328.wav,VTTS_b-1_3228-3328_3328.wav,1470,1405,65
5783,b-4_2000-5164_4328.wav,VTTS_b-4_2000-5164_4328.wav,9230,9404,-174
5784,b-3_4207-4314_4290.wav,VTTS_b-3_4207-4314_4290.wav,5540,5039,501
5785,b-1_4214-4285_4217.wav,VTTS_b-1_4214-4285_4217.wav,2530,2972,-442
5786,b-1_1414-1514_1447.wav,VTTS_b-1_1414-1514_1447.wav,6010,6699,-689
5787,b-1_3026-3126_3060.wav,VTTS_b-1_3026-3126_3060.wav,1350,1265,85
5788,b-3_196-293_281.wav,VTTS_b-3_196-293_281.wav,4120,4690,-570
5789,b-3_6801-6900_6867.wav,VTTS_b-3_6801-6900_6867.wav,5400,5294,106
5790,b-3_1666-1763_1687.wav,VTTS_b-3_1666-1763_1687.wav,3330,3402,-72
5791,b-3_4315-4424_4350.wav,VTTS_b-3_4315-4424_4350.wav,6210,7546,-1336
5792,b-3_4607-5008_4962.wav,VTTS_b-3_4607-5008_4962.wav,10920,11610,-690
5793,b-3_5428-5533_5468.wav,VTTS_b-3_5428-5533_5468.wav,2610,2740,-130
5794,b-4_2000-5164_3320.wav,VTTS_b-4_2000-5164_3320.wav,5084,5190,-106
5795,b-2_2209-2310_2235.wav,VTTS_b-2_2209-2310_2235.wav,1530,1498,32
5796,b-1_276-376_373.wav,VTTS_b-1_276-376_373.wav,3310,4679,-1369
5797,b-3_6401-6500_6423.wav,VTTS_b-3_6401-6500_6423.wav,4810,4981,-171
5798,b-4_2000-5164_2270.wav,VTTS_b-4_2000-5164_2270.wav,15960,11610,4350
5799,b-4_1506-1600_1532.wav,VTTS_b-4_1506-1600_1532.wav,2760,2531,229
5800,b-3_2524-2854_2550.wav,VTTS_b-3_2524-2854_2550.wav,2320,2310,10
5801,b-3_4104-4206_4171.wav,VTTS_b-3_4104-4206_4171.wav,8610,8951,-341
5802,b-1_2220-2320_2297.wav,VTTS_b-1_2220-2320_2297.wav,3860,3367,493
5803,b-4_2000-5164_4737.wav,VTTS_b-4_2000-5164_4737.wav,4359,4249,110
5804,b-4_2000-5164_4089.wav,VTTS_b-4_2000-5164_4089.wav,5698,6107,-409
5805,b-4_1901-2000_1998.wav,VTTS_b-4_1901-2000_1998.wav,6000,5410,590
5806,b-3_6401-6500_6490.wav,VTTS_b-3_6401-6500_6490.wav,5150,4667,483
5807,b-4_501-1014_992.wav,VTTS_b-4_501-1014_992.wav,2090,1324,766
5808,b-2_2413-2500_2495.wav,VTTS_b-2_2413-2500_2495.wav,1220,1196,24
5809,b-1_3329-3429_3349.wav,VTTS_b-1_3329-3429_3349.wav,1530,1521,9
5810,b-4_151-300_210.wav,VTTS_b-4_151-300_210.wav,2300,1881,419
5811,b-3_5009-5427_5241.wav,VTTS_b-3_5009-5427_5241.wav,6750,5793,957
5812,b-1_2422-2522_2450.wav,VTTS_b-1_2422-2522_2450.wav,2110,2020,90
5813,b-4_2000-5164_2334.wav,VTTS_b-4_2000-5164_2334.wav,7050,6734,316
5814,b-2_1903-2038_2004.wav,VTTS_b-2_1903-2038_2004.wav,5510,4145,1365
5815,b-3_3889-4000_3897.wav,VTTS_b-3_3889-4000_3897.wav,13670,11238,2432
5816,b-2_2073-2106_2078.wav,VTTS_b-2_2073-2106_2078.wav,1200,1324,-124
5817,b-4_1601-1706_1665.wav,VTTS_b-4_1601-1706_1665.wav,6240,5782,458
5818,b-2_203-304_299.wav,VTTS_b-2_203-304_299.wav,1970,1985,-15
5819,b-4_2000-5164_2648.wav,VTTS_b-4_2000-5164_2648.wav,3630,4528,-898
5820,b-3_4425-4497_4484.wav,VTTS_b-3_4425-4497_4484.wav,4600,4377,223
5821,b-1_1010-1110_1092.wav,VTTS_b-1_1010-1110_1092.wav,5470,10066,-4596
5822,b-4_2000-5164_5021.wav,VTTS_b-4_2000-5164_5021.wav,1824,1834,-10
5823,b-3_4498-4605_4544.wav,VTTS_b-3_4498-4605_4544.wav,3730,3413,317
5824,b-4_2000-5164_2665.wav,VTTS_b-4_2000-5164_2665.wav,2190,2276,-86
5825,b-3_3454-3537_3454.wav,VTTS_b-3_3454-3537_3454.wav,2960,2914,46
5826,b-3_2000-2088_2005.wav,VTTS_b-3_2000-2088_2005.wav,5770,5294,476
5827,b-2_1-100_8.wav,VTTS_b-2_1-100_8.wav,1030,1126,-96
5828,b-3_3279-3363_3285.wav,VTTS_b-3_3279-3363_3285.wav,6010,5294,716
5829,b-3_5428-5533_5482.wav,VTTS_b-3_5428-5533_5482.wav,3690,3379,311
5830,b-4_1506-1600_1598.wav,VTTS_b-4_1506-1600_1598.wav,2570,2531,39
5831,b-1_4106-4141_4133.wav,VTTS_b-1_4106-4141_4133.wav,4540,5085,-545
5832,b-4_2000-5164_4329.wav,VTTS_b-4_2000-5164_4329.wav,1200,1138,62
5833,b-4_2000-5164_4689.wav,VTTS_b-4_2000-5164_4689.wav,6870,8371,-1501
5834,b-4_2000-5164_3294.wav,VTTS_b-4_2000-5164_3294.wav,4186,4052,134
5835,b-1_3329-3429_3360.wav,VTTS_b-1_3329-3429_3360.wav,3980,3971,9
5836,b-3_4425-4497_4463.wav,VTTS_b-3_4425-4497_4463.wav,7000,6211,789
5837,b-4_501-1014_1010.wav,VTTS_b-4_501-1014_1010.wav,3930,4992,-1062
5838,b-1_2826-2926_2907.wav,VTTS_b-1_2826-2926_2907.wav,6400,5573,827
5839,b-3_4607-5008_4807.wav,VTTS_b-3_4607-5008_4807.wav,6340,6478,-138
5840,b-3_5428-5533_5494.wav,VTTS_b-3_5428-5533_5494.wav,6370,6385,-15
5841,b-3_1-97_93.wav,VTTS_b-3_1-97_93.wav,6810,5933,877
5842,b-1_1515-1615_1616.wav,VTTS_b-1_1515-1615_1616.wav,3390,3773,-383
5843,b-4_2000-5164_2637.wav,VTTS_b-4_2000-5164_2637.wav,1470,1405,65
5844,b-3_2000-2088_2028.wav,VTTS_b-3_2000-2088_2028.wav,4000,3529,471
5845,b-3_1321-1568_1526.wav,VTTS_b-3_1321-1568_1526.wav,5310,5329,-19
5846,b-3_2089-2176_2127.wav,VTTS_b-3_2089-2176_2127.wav,8690,10031,-1341
5847,b-2_1223-1324_1285.wav,VTTS_b-2_1223-1324_1285.wav,1780,1730,50
5848,b-3_4607-5008_4654.wav,VTTS_b-3_4607-5008_4654.wav,6000,5503,497
5849,b-3_1666-1763_1757.wav,VTTS_b-3_1666-1763_1757.wav,4850,4737,113
5850,b-2_1121-1222_1145.wav,VTTS_b-2_1121-1222_1145.wav,2630,2786,-156
5851,b-2_2413-2500_2479.wav,VTTS_b-2_2413-2500_2479.wav,3360,3181,179
5852,b-4_2000-5164_3470.wav,VTTS_b-4_2000-5164_3470.wav,2656,4133,-1477
5853,b-3_2089-2176_2123.wav,VTTS_b-3_2089-2176_2123.wav,3620,3471,149
5854,b-3_1079-1320_1152.wav,VTTS_b-3_1079-1320_1152.wav,5700,4934,766
5855,b-2_2073-2106_2102.wav,VTTS_b-2_2073-2106_2102.wav,1680,1625,55
5856,b-4_2000-5164_2711.wav,VTTS_b-4_2000-5164_2711.wav,2320,2717,-397
5857,b-4_2000-5164_3334.wav,VTTS_b-4_2000-5164_3334.wav,2732,3053,-321
5858,b-3_3198-3278_3269.wav,VTTS_b-3_3198-3278_3269.wav,2850,3053,-203
5859,b-3_501-930_771.wav,VTTS_b-3_501-930_771.wav,4750,4470,280
5860,b-1_1212-1312_1262.wav,VTTS_b-1_1212-1312_1262.wav,2410,2694,-284
5861,b-2_407-508_481.wav,VTTS_b-2_407-508_481.wav,3980,3286,694
5862,b-3_5533-5638_5611.wav,VTTS_b-3_5533-5638_5611.wav,6820,11610,-4790
5863,b-2_101-202_154.wav,VTTS_b-2_101-202_154.wav,2030,2241,-211
5864,b-3_4207-4314_4233.wav,VTTS_b-3_4207-4314_4233.wav,4890,4807,83
5865,b-3_4607-5008_4947.wav,VTTS_b-3_4607-5008_4947.wav,5570,5422,148
5866,b-1_2725-2825_2789.wav,VTTS_b-1_2725-2825_2789.wav,1460,1486,-26
5867,b-4_2000-5164_3656.wav,VTTS_b-4_2000-5164_3656.wav,2366,2322,44
5868,b-3_4315-4424_4356.wav,VTTS_b-3_4315-4424_4356.wav,4950,4226,724
5869,b-3_501-930_785.wav,VTTS_b-3_501-930_785.wav,4370,4180,190
5870,b-4_2000-5164_3266.wav,VTTS_b-4_2000-5164_3266.wav,7429,6687,742
5871,b-3_1764-1861_1817.wav,VTTS_b-3_1764-1861_1817.wav,6980,9660,-2680
5872,b-3_501-930_834.wav,VTTS_b-3_501-930_834.wav,5910,6107,-197
5873,b-2_1903-2038_1992.wav,VTTS_b-2_1903-2038_1992.wav,2920,2833,87
5874,b-2_815-916_850.wav,VTTS_b-2_815-916_850.wav,1160,1463,-303
5875,b-3_1666-1763_1760.wav,VTTS_b-3_1666-1763_1760.wav,6190,5387,803
5876,b-4_1814-1900_1854.wav,VTTS_b-4_1814-1900_1854.wav,4780,5909,-1129
5877,b-1_3127-3227_3156.wav,VTTS_b-1_3127-3227_3156.wav,4980,4865,115
5878,b-1_2321-2421_2329.wav,VTTS_b-1_2321-2421_2329.wav,1910,1881,29
5879,b-3_501-930_713.wav,VTTS_b-3_501-930_713.wav,4470,4748,-278
5880,b-2_815-916_846.wav,VTTS_b-2_815-916_846.wav,4070,3680,390
5881,b-4_1506-1600_1524.wav,VTTS_b-4_1506-1600_1524.wav,2780,2519,261
5882,b-1_686-793_712.wav,VTTS_b-1_686-793_712.wav,3290,2972,318
5883,b-4_2000-5164_2606.wav,VTTS_b-4_2000-5164_2606.wav,1350,1335,15
5884,b-3_2267-2349_2296.wav,VTTS_b-3_2267-2349_2296.wav,4220,3982,238
5885,b-2_2209-2310_2240.wav,VTTS_b-2_2209-2310_2240.wav,1350,1393,-43
5886,b-4_501-1014_798.wav,VTTS_b-4_501-1014_798.wav,5080,4911,169
5887,b-3_1321-1568_1468.wav,VTTS_b-3_1321-1568_1468.wav,3850,3901,-51
5888,b-4_2000-5164_4776.wav,VTTS_b-4_2000-5164_4776.wav,2400,2322,78
5889,b-3_6601-6700_6687.wav,VTTS_b-3_6601-6700_6687.wav,3350,3413,-63
5890,b-1_4322-4357_4331.wav,VTTS_b-1_4322-4357_4331.wav,2250,2519,-269
5891,b-2_1699-1800_1709.wav,VTTS_b-2_1699-1800_1709.wav,2080,3971,-1891
5892,b-3_5639-5744_5695.wav,VTTS_b-3_5639-5744_5695.wav,5740,5689,51
5893,b-4_1301-1400_1349.wav,VTTS_b-4_1301-1400_1349.wav,1420,1300,120
5894,b-4_2000-5164_5011.wav,VTTS_b-4_2000-5164_5011.wav,2003,1881,122
5895,b-2_407-508_498.wav,VTTS_b-2_407-508_498.wav,3070,2682,388
5896,b-3_3538-3627_3557.wav,VTTS_b-3_3538-3627_3557.wav,5130,5735,-605
5897,b-4_301-400_389.wav,VTTS_b-4_301-400_389.wav,8360,7372,988
5898,b-3_1079-1320_1226.wav,VTTS_b-3_1079-1320_1226.wav,7430,7918,-488
5899,b-3_4104-4206_4187.wav,VTTS_b-3_4104-4206_4187.wav,6360,6188,172
5900,b-4_2000-5164_4353.wav,VTTS_b-4_2000-5164_4353.wav,2791,2821,-30
5901,b-1_3026-3126_3123.wav,VTTS_b-1_3026-3126_3123.wav,2530,2229,301
5902,b-3_392-500_414.wav,VTTS_b-3_392-500_414.wav,5090,5085,5
5903,b-4_53-150_129.wav,VTTS_b-4_53-150_129.wav,7130,7024,106
5904,b-3_1862-1959_1883.wav,VTTS_b-3_1862-1959_1883.wav,3420,3646,-226
5905,b-4_2000-5164_4281.wav,VTTS_b-4_2000-5164_4281.wav,4119,4296,-177
5906,b-4_1221-1300_1285.wav,VTTS_b-4_1221-1300_1285.wav,2230,2334,-104
5907,b-3_1666-1763_1728.wav,VTTS_b-3_1666-1763_1728.wav,7120,7755,-635
5908,b-3_4207-4314_4283.wav,VTTS_b-3_4207-4314_4283.wav,4310,3692,618
5909,b-1_276-376_378.wav,VTTS_b-1_276-376_378.wav,1080,1149,-69
5910,b-2_917-1018_1015.wav,VTTS_b-2_917-1018_1015.wav,2160,1649,511
5911,b-3_980-1077_1005.wav,VTTS_b-3_980-1077_1005.wav,3150,2380,770
5912,b-3_3803-3888_3887.wav,VTTS_b-3_3803-3888_3887.wav,5570,5062,508
5913,b-3_1-97_83.wav,VTTS_b-3_1-97_83.wav,7340,7070,270
5914,b-2_1325-1426_1402.wav,VTTS_b-2_1325-1426_1402.wav,8520,9868,-1348
5915,b-2_407-508_418.wav,VTTS_b-2_407-508_418.wav,1750,1649,101
5916,b-2_2311-2412_2409.wav,VTTS_b-2_2311-2412_2409.wav,820,871,-51
5917,b-3_6016-6115_6048.wav,VTTS_b-3_6016-6115_6048.wav,10280,9938,342
5918,b-3_4498-4605_4525.wav,VTTS_b-3_4498-4605_4525.wav,3630,3692,-62
5919,b-4_501-1014_564.wav,VTTS_b-4_501-1014_564.wav,8920,8812,108
5920,b-1_794-1009_931.wav,VTTS_b-1_794-1009_931.wav,4110,4005,105
5921,b-3_1079-1320_1192.wav,VTTS_b-3_1079-1320_1192.wav,5260,5909,-649
5922,b-1_3531-3631_3584.wav,VTTS_b-1_3531-3631_3584.wav,4720,4528,192
5923,b-2_2311-2412_2355.wav,VTTS_b-2_2311-2412_2355.wav,1100,1045,55
5924,b-4_2000-5164_2775.wav,VTTS_b-4_2000-5164_2775.wav,5255,5944,-689
5925,b-4_501-1014_620.wav,VTTS_b-4_501-1014_620.wav,7220,6896,324
5926,b-4_2000-5164_4362.wav,VTTS_b-4_2000-5164_4362.wav,2344,1962,382
5927,b-2_1903-2038_1917.wav,VTTS_b-2_1903-2038_1917.wav,1550,2032,-482
5928,b-2_1325-1426_1418.wav,VTTS_b-2_1325-1426_1418.wav,3440,3599,-159
5929,b-4_2000-5164_2936.wav,VTTS_b-4_2000-5164_2936.wav,3622,3622,0
5930,b-1_3733-3833_3826.wav,VTTS_b-1_3733-3833_3826.wav,1760,1939,-179
5931,b-4_501-1014_772.wav,VTTS_b-4_501-1014_772.wav,6650,6327,323
5932,b-3_1079-1320_1120.wav,VTTS_b-3_1079-1320_1120.wav,6210,7094,-884
5933,b-1_3430-3530_3490.wav,VTTS_b-1_3430-3530_3490.wav,1020,1115,-95
5934,b-4_2000-5164_4253.wav,VTTS_b-4_2000-5164_4253.wav,6408,6385,23
5935,b-4_2000-5164_4419.wav,VTTS_b-4_2000-5164_4419.wav,2696,2786,-90
5936,b-1_2321-2421_2415.wav,VTTS_b-1_2321-2421_2415.wav,2950,2786,164
5937,b-3_3538-3627_3555.wav,VTTS_b-3_3538-3627_3555.wav,2250,2171,79
5938,b-3_3198-3278_3263.wav,VTTS_b-3_3198-3278_3263.wav,6660,6873,-213
5939,b-4_2000-5164_2681.wav,VTTS_b-4_2000-5164_2681.wav,1710,1614,96
5940,b-3_5009-5427_5090.wav,VTTS_b-3_5009-5427_5090.wav,5590,6002,-412
5941,b-3_6116-6215_6139.wav,VTTS_b-3_6116-6215_6139.wav,6020,5677,343
5942,b-3_5009-5427_5129.wav,VTTS_b-3_5009-5427_5129.wav,6940,6780,160
5943,b-3_6701-6800_6794.wav,VTTS_b-3_6701-6800_6794.wav,4400,4528,-128
5944,b-1_175-275_259.wav,VTTS_b-1_175-275_259.wav,1730,1927,-197
5945,b-2_2107-2193_2140.wav,VTTS_b-2_2107-2193_2140.wav,3730,4017,-287
5946,b-4_1301-1400_1308.wav,VTTS_b-4_1301-1400_1308.wav,3020,2740,280
5947,b-1_276-376_363.wav,VTTS_b-1_276-376_363.wav,11670,11610,60
5948,b-1_1919-2017_1941.wav,VTTS_b-1_1919-2017_1941.wav,2660,2543,117
5949,b-4_2000-5164_4570.wav,VTTS_b-4_2000-5164_4570.wav,5709,6200,-491
5950,b-4_2000-5164_4126.wav,VTTS_b-4_2000-5164_4126.wav,3557,3170,387
5951,b-3_1862-1959_1864.wav,VTTS_b-3_1862-1959_1864.wav,2740,2519,221
5952,b-4_53-150_78.wav,VTTS_b-4_53-150_78.wav,7500,8150,-650
5953,b-4_1401-1505_1451.wav,VTTS_b-4_1401-1505_1451.wav,6140,6293,-153
5954,b-4_2000-5164_4537.wav,VTTS_b-4_2000-5164_4537.wav,5221,4923,298
5955,b-3_3889-4000_4000.wav,VTTS_b-3_3889-4000_4000.wav,5650,5805,-155
5956,b-1_1919-2017_1947.wav,VTTS_b-1_1919-2017_1947.wav,1320,1277,43
5957,b-1_1-73_28.wav,VTTS_b-1_1-73_28.wav,1300,1265,35
5958,b-3_2855-2942_2933.wav,VTTS_b-3_2855-2942_2933.wav,2850,2961,-111
5959,b-3_1764-1861_1775.wav,VTTS_b-3_1764-1861_1775.wav,3630,3553,77
5960,b-4_2000-5164_4041.wav,VTTS_b-4_2000-5164_4041.wav,3330,3111,219
5961,b-1_2624-2724_2709.wav,VTTS_b-1_2624-2724_2709.wav,2200,2438,-238
5962,b-3_4104-4206_4139.wav,VTTS_b-3_4104-4206_4139.wav,7310,6722,588
5963,b-4_501-1014_591.wav,VTTS_b-4_501-1014_591.wav,5020,4667,353
5964,b-4_1814-1900_1850.wav,VTTS_b-4_1814-1900_1850.wav,3330,3053,277
5965,b-3_3279-3363_3307.wav,VTTS_b-3_3279-3363_3307.wav,2920,3088,-168
5966,b-2_407-508_458.wav,VTTS_b-2_407-508_458.wav,1440,1509,-69
5967,b-4_1-52_51.wav,VTTS_b-4_1-52_51.wav,8570,9102,-532
5968,b-4_2000-5164_2819.wav,VTTS_b-4_2000-5164_2819.wav,1620,1544,76
5969,b-3_5745-5852_5777.wav,VTTS_b-3_5745-5852_5777.wav,4450,4667,-217
5970,b-1_1818-1918_1872.wav,VTTS_b-1_1818-1918_1872.wav,2500,2972,-472
5971,b-3_1960-2000_1981.wav,VTTS_b-3_1960-2000_1981.wav,6340,6571,-231
5972,b-3_2350-2433_2374.wav,VTTS_b-3_2350-2433_2374.wav,4750,4354,396
5973,b-3_1764-1861_1792.wav,VTTS_b-3_1764-1861_1792.wav,7270,8940,-1670
5974,b-2_1325-1426_1334.wav,VTTS_b-2_1325-1426_1334.wav,3240,2125,1115
5975,b-3_6016-6115_6017.wav,VTTS_b-3_6016-6115_6017.wav,1290,1103,187
5976,b-3_5009-5427_5040.wav,VTTS_b-3_5009-5427_5040.wav,2700,2949,-249
5977,b-3_3279-3363_3355.wav,VTTS_b-3_3279-3363_3355.wav,7150,7105,45
5978,b-3_5533-5638_5538.wav,VTTS_b-3_5533-5638_5538.wav,8120,7848,272
5979,b-3_2855-2942_2919.wav,VTTS_b-3_2855-2942_2919.wav,2700,3019,-319
5980,b-1_3632-3732_3667.wav,VTTS_b-1_3632-3732_3667.wav,3680,5259,-1579
5981,b-1_175-275_196.wav,VTTS_b-1_175-275_196.wav,1050,917,133
5982,b-3_2524-2854_2849.wav,VTTS_b-3_2524-2854_2849.wav,2010,2171,-161
5983,b-1_2119-2219_2188.wav,VTTS_b-1_2119-2219_2188.wav,2750,4261,-1511
5984,b-4_2000-5164_2629.wav,VTTS_b-4_2000-5164_2629.wav,4980,5201,-221
5985,b-2_1563-1596_1587.wav,VTTS_b-2_1563-1596_1587.wav,4080,5515,-1435
5986,b-2_1427-1562_1479.wav,VTTS_b-2_1427-1562_1479.wav,4230,4040,190
5987,b-4_1-52_1.wav,VTTS_b-4_1-52_1.wav,8140,8789,-649
5988,b-2_2311-2412_2344.wav,VTTS_b-2_2311-2412_2344.wav,3080,3181,-101
5989,b-1_3329-3429_3391.wav,VTTS_b-1_3329-3429_3391.wav,5130,4656,474
5990,b-1_4322-4357_4345.wav,VTTS_b-1_4322-4357_4345.wav,1790,1823,-33
5991,b-3_5009-5427_5371.wav,VTTS_b-3_5009-5427_5371.wav,3100,2740,360
5992,b-3_501-930_765.wav,VTTS_b-3_501-930_765.wav,3400,3506,-106
5993,b-1_3026-3126_3051.wav,VTTS_b-1_3026-3126_3051.wav,2110,2229,-119
5994,b-1_1313-1413_1395.wav,VTTS_b-1_1313-1413_1395.wav,1730,1591,139
5995,b-1_276-376_297.wav,VTTS_b-1_276-376_297.wav,1230,1219,11
5996,b-3_2000-2088_2044.wav,VTTS_b-3_2000-2088_2044.wav,5570,5433,137
5997,b-4_2000-5164_5141.wav,VTTS_b-4_2000-5164_5141.wav,6852,10995,-4143
5998,b-4_501-1014_928.wav,VTTS_b-4_501-1014_928.wav,4390,3831,559
5999,b-2_2209-2310_2236.wav,VTTS_b-2_2209-2310_2236.wav,2000,2009,-9
6000,b-1_650-685_667.wav,VTTS_b-1_650-685_667.wav,3850,5283,-1433
6001,b-1_276-376_312.wav,VTTS_b-1_276-376_312.wav,1460,2125,-665
6002,b-3_4607-5008_5000.wav,VTTS_b-3_4607-5008_5000.wav,3200,2810,390
6003,b-3_294-391_330.wav,VTTS_b-3_294-391_330.wav,5400,6014,-614
6004,b-4_501-1014_982.wav,VTTS_b-4_501-1014_982.wav,5240,4807,433
6005,b-3_2434-2523_2452.wav,VTTS_b-3_2434-2523_2452.wav,4590,4052,538
6006,b-4_1814-1900_1828.wav,VTTS_b-4_1814-1900_1828.wav,3590,3413,177
6007,b-1_3430-3530_3504.wav,VTTS_b-1_3430-3530_3504.wav,1760,1649,111
6008,b-4_501-1014_969.wav,VTTS_b-4_501-1014_969.wav,730,720,10
6009,b-4_2000-5164_3030.wav,VTTS_b-4_2000-5164_3030.wav,10059,10902,-843
6010,b-3_5009-5427_5204.wav,VTTS_b-3_5009-5427_5204.wav,4980,4551,429
6011,b-4_1707-1813_1809.wav,VTTS_b-4_1707-1813_1809.wav,2020,1881,139
6012,b-3_3198-3278_3267.wav,VTTS_b-3_3198-3278_3267.wav,3190,3158,32
6013,b-4_501-1014_763.wav,VTTS_b-4_501-1014_763.wav,4890,4540,350
6014,b-4_2000-5164_3486.wav,VTTS_b-4_2000-5164_3486.wav,7086,7372,-286
6015,b-3_3628-3714_3649.wav,VTTS_b-3_3628-3714_3649.wav,4340,4435,-95
6016,b-4_2000-5164_2772.wav,VTTS_b-4_2000-5164_2772.wav,1355,1231,124
6017,b-1_4034-4069_4035.wav,VTTS_b-1_4034-4069_4035.wav,4180,5387,-1207
6018,b-4_2000-5164_3862.wav,VTTS_b-4_2000-5164_3862.wav,3357,2798,559
6019,b-2_1325-1426_1370.wav,VTTS_b-2_1325-1426_1370.wav,11610,11610,0
6020,b-3_2267-2349_2334.wav,VTTS_b-3_2267-2349_2334.wav,4520,4249,271
6021,b-1_794-1009_840.wav,VTTS_b-1_794-1009_840.wav,3780,3007,773
6022,b-4_2000-5164_3381.wav,VTTS_b-4_2000-5164_3381.wav,2878,2763,115
6023,b-1_2725-2825_2812.wav,VTTS_b-1_2725-2825_2812.wav,2230,2322,-92
6024,b-2_1597-1698_1623.wav,VTTS_b-2_1597-1698_1623.wav,1550,1579,-29
6025,b-3_501-930_621.wav,VTTS_b-3_501-930_621.wav,7440,7546,-106
6026,b-1_686-793_696.wav,VTTS_b-1_686-793_696.wav,3380,3053,327
6027,b-4_1707-1813_1802.wav,VTTS_b-4_1707-1813_1802.wav,5880,5236,644
6028,b-4_501-1014_871.wav,VTTS_b-4_501-1014_871.wav,9140,8371,769
6029,b-1_3733-3833_3746.wav,VTTS_b-1_3733-3833_3746.wav,1410,1927,-517
6030,b-3_501-930_539.wav,VTTS_b-3_501-930_539.wav,3630,4354,-724
6031,b-3_3454-3537_3537.wav,VTTS_b-3_3454-3537_3537.wav,4810,4075,735
6032,b-4_2000-5164_4404.wav,VTTS_b-4_2000-5164_4404.wav,1355,1231,124
6033,b-4_2000-5164_3285.wav,VTTS_b-4_2000-5164_3285.wav,4865,4586,279
6034,b-3_5009-5427_5249.wav,VTTS_b-3_5009-5427_5249.wav,5280,5422,-142
6035,b-1_3026-3126_3117.wav,VTTS_b-1_3026-3126_3117.wav,2300,2241,59
6036,b-4_1814-1900_1898.wav,VTTS_b-4_1814-1900_1898.wav,7060,6513,547
6037,b-3_1079-1320_1111.wav,VTTS_b-3_1079-1320_1111.wav,4330,4307,23
6038,b-3_1960-2000_1994.wav,VTTS_b-3_1960-2000_1994.wav,7360,6699,661
6039,b-4_2000-5164_3189.wav,VTTS_b-4_2000-5164_3189.wav,8559,8940,-381
6040,b-4_2000-5164_2373.wav,VTTS_b-4_2000-5164_2373.wav,4185,4481,-296
6041,b-1_1919-2017_1983.wav,VTTS_b-1_1919-2017_1983.wav,2710,2322,388
6042,b-3_3025-3111_3048.wav,VTTS_b-3_3025-3111_3048.wav,3210,2984,226
6043,b-1_1616-1716_1709.wav,VTTS_b-1_1616-1716_1709.wav,1190,1138,52
6044,b-1_2624-2724_2628.wav,VTTS_b-1_2624-2724_2628.wav,3920,5480,-1560
6045,b-2_1699-1800_1725.wav,VTTS_b-2_1699-1800_1725.wav,3460,2659,801
6046,b-2_1699-1800_1780.wav,VTTS_b-2_1699-1800_1780.wav,2350,1672,678
6047,b-3_980-1077_991.wav,VTTS_b-3_980-1077_991.wav,9700,9416,284
6048,b-3_1-97_76.wav,VTTS_b-3_1-97_76.wav,3720,3471,249
6049,b-4_2000-5164_4018.wav,VTTS_b-4_2000-5164_4018.wav,1909,1823,86
6050,b-3_1321-1568_1374.wav,VTTS_b-3_1321-1568_1374.wav,4390,4632,-242
6051,b-1_3733-3833_3817.wav,VTTS_b-1_3733-3833_3817.wav,2760,2810,-50
6052,b-4_2000-5164_5028.wav,VTTS_b-4_2000-5164_5028.wav,3318,3413,-95
6053,b-1_2018-2118_2113.wav,VTTS_b-1_2018-2118_2113.wav,1520,1451,69
6054,b-4_2000-5164_2528.wav,VTTS_b-4_2000-5164_2528.wav,3720,3913,-193
6055,b-1_4394-4429_4408.wav,VTTS_b-1_4394-4429_4408.wav,2560,4516,-1956
6056,b-2_815-916_888.wav,VTTS_b-2_815-916_888.wav,2310,2461,-151
6057,b-3_501-930_886.wav,VTTS_b-3_501-930_886.wav,6120,5909,211
6058,b-3_4607-5008_4898.wav,VTTS_b-3_4607-5008_4898.wav,6430,5492,938
6059,b-2_1801-1902_1830.wav,VTTS_b-2_1801-1902_1830.wav,1890,1939,-49
6060,b-1_4322-4357_4348.wav,VTTS_b-1_4322-4357_4348.wav,1430,1521,-91
6061,b-4_2000-5164_4975.wav,VTTS_b-4_2000-5164_4975.wav,6137,6362,-225
6062,b-2_611-712_700.wav,VTTS_b-2_611-712_700.wav,3330,2694,636
6063,b-3_5533-5638_5568.wav,VTTS_b-3_5533-5638_5568.wav,4830,5817,-987
6064,b-4_1707-1813_1787.wav,VTTS_b-4_1707-1813_1787.wav,6860,6200,660
6065,b-4_2000-5164_4794.wav,VTTS_b-4_2000-5164_4794.wav,3116,2995,121
6066,b-1_1717-1817_1761.wav,VTTS_b-1_1717-1817_1761.wav,1800,2194,-394
6067,b-2_1801-1902_1822.wav,VTTS_b-2_1801-1902_1822.wav,5540,5619,-79
6068,b-1_3329-3429_3329.wav,VTTS_b-1_3329-3429_3329.wav,1240,1370,-130
6069,b-3_3889-4000_3896.wav,VTTS_b-3_3889-4000_3896.wav,6110,7628,-1518
6070,b-3_5533-5638_5629.wav,VTTS_b-3_5533-5638_5629.wav,2830,2670,160
6071,b-1_650-685_650.wav,VTTS_b-1_650-685_650.wav,4820,4830,-10
6072,b-3_6401-6500_6422.wav,VTTS_b-3_6401-6500_6422.wav,4450,6432,-1982
6073,b-3_294-391_364.wav,VTTS_b-3_294-391_364.wav,3950,4110,-160
6074,b-4_2000-5164_3562.wav,VTTS_b-4_2000-5164_3562.wav,2095,2043,52
6075,b-4_2000-5164_4815.wav,VTTS_b-4_2000-5164_4815.wav,8601,8069,532
6076,b-3_3538-3627_3582.wav,VTTS_b-3_3538-3627_3582.wav,3110,2914,196
6077,b-3_1321-1568_1387.wav,VTTS_b-3_1321-1568_1387.wav,4250,3785,465
6078,b-4_2000-5164_2009.wav,VTTS_b-4_2000-5164_2009.wav,5491,5677,-186
6079,b-4_501-1014_776.wav,VTTS_b-4_501-1014_776.wav,8320,11610,-3290
6080,b-2_509-610_554.wav,VTTS_b-2_509-610_554.wav,1330,1753,-423
6081,b-2_1019-1120_1116.wav,VTTS_b-2_1019-1120_1116.wav,1990,1730,260
6082,b-2_509-610_541.wav,VTTS_b-2_509-610_541.wav,4360,4807,-447
6083,b-3_1321-1568_1460.wav,VTTS_b-3_1321-1568_1460.wav,8410,7407,1003
6084,b-3_1764-1861_1781.wav,VTTS_b-3_1764-1861_1781.wav,1780,1219,561
6085,b-3_501-930_910.wav,VTTS_b-3_501-930_910.wav,4860,4145,715
6086,b-3_294-391_303.wav,VTTS_b-3_294-391_303.wav,7290,6745,545
6087,b-1_4394-4429_4429.wav,VTTS_b-1_4394-4429_4429.wav,1490,1579,-89
6088,b-4_2000-5164_5033.wav,VTTS_b-4_2000-5164_5033.wav,4540,3924,616
6089,b-3_1-97_95.wav,VTTS_b-3_1-97_95.wav,6410,6978,-568
6090,b-1_2321-2421_2352.wav,VTTS_b-1_2321-2421_2352.wav,5100,5317,-217
6091,b-2_2073-2106_2094.wav,VTTS_b-2_2073-2106_2094.wav,1360,1312,48
6092,b-2_509-610_605.wav,VTTS_b-2_509-610_605.wav,3100,4133,-1033
6093,b-4_301-400_387.wav,VTTS_b-4_301-400_387.wav,1530,1498,32
6094,b-4_2000-5164_2823.wav,VTTS_b-4_2000-5164_2823.wav,2560,2531,29
6095,b-1_1818-1918_1884.wav,VTTS_b-1_1818-1918_1884.wav,2130,1892,238
6096,b-3_392-500_490.wav,VTTS_b-3_392-500_490.wav,2890,2543,347
6097,b-3_2943-3024_2951.wav,VTTS_b-3_2943-3024_2951.wav,3920,4528,-608
6098,b-1_1919-2017_1986.wav,VTTS_b-1_1919-2017_1986.wav,6150,5294,856
6099,b-3_2943-3024_2973.wav,VTTS_b-3_2943-3024_2973.wav,4020,3889,131
6100,b-1_1414-1514_1439.wav,VTTS_b-1_1414-1514_1439.wav,2080,2194,-114
6101,b-1_3632-3732_3673.wav,VTTS_b-1_3632-3732_3673.wav,3950,4122,-172
6102,b-4_1601-1706_1669.wav,VTTS_b-4_1601-1706_1669.wav,3530,3297,233
6103,b-3_3364-3453_3453.wav,VTTS_b-3_3364-3453_3453.wav,4900,4516,384
6104,b-3_3889-4000_3925.wav,VTTS_b-3_3889-4000_3925.wav,3080,2821,259
6105,b-1_1010-1110_1045.wav,VTTS_b-1_1010-1110_1045.wav,1680,1509,171
6106,b-4_2000-5164_2782.wav,VTTS_b-4_2000-5164_2782.wav,4405,4063,342
6107,b-4_1401-1505_1409.wav,VTTS_b-4_1401-1505_1409.wav,6610,7175,-565
6108,b-3_3454-3537_3519.wav,VTTS_b-3_3454-3537_3519.wav,3590,3506,84
6109,b-3_2524-2854_2806.wav,VTTS_b-3_2524-2854_2806.wav,4040,4621,-581
6110,b-4_1401-1505_1457.wav,VTTS_b-4_1401-1505_1457.wav,2100,1997,103
6111,b-1_2321-2421_2349.wav,VTTS_b-1_2321-2421_2349.wav,2130,1846,284
6112,b-1_4070-4105_4080.wav,VTTS_b-1_4070-4105_4080.wav,2350,2345,5
6113,b-3_980-1077_1048.wav,VTTS_b-3_980-1077_1048.wav,4440,4609,-169
6114,b-3_3112-3197_3179.wav,VTTS_b-3_3112-3197_3179.wav,4840,4365,475
6115,b-3_2524-2854_2541.wav,VTTS_b-3_2524-2854_2541.wav,6370,5921,449
6116,b-3_501-930_689.wav,VTTS_b-3_501-930_689.wav,5630,5074,556
6117,b-1_74-174_94.wav,VTTS_b-1_74-174_94.wav,4510,5294,-784
6118,b-3_3889-4000_3985.wav,VTTS_b-3_3889-4000_3985.wav,7930,7187,743
6119,b-3_980-1077_1075.wav,VTTS_b-3_980-1077_1075.wav,5880,5619,261
6120,b-3_4498-4605_4566.wav,VTTS_b-3_4498-4605_4566.wav,4060,3947,113
6121,b-3_294-391_302.wav,VTTS_b-3_294-391_302.wav,4670,4493,177
6122,b-2_2040-2072_2059.wav,VTTS_b-2_2040-2072_2059.wav,2490,2601,-111
6123,b-3_5853-5956_5919.wav,VTTS_b-3_5853-5956_5919.wav,2220,2148,72
6124,b-3_6801-6900_6843.wav,VTTS_b-3_6801-6900_6843.wav,5780,6362,-582
6125,b-3_4104-4206_4183.wav,VTTS_b-3_4104-4206_4183.wav,3700,3355,345
6126,b-3_2524-2854_2634.wav,VTTS_b-3_2524-2854_2634.wav,4890,4063,827
6127,b-4_2000-5164_4749.wav,VTTS_b-4_2000-5164_4749.wav,1135,1091,44
6128,b-4_1901-2000_1956.wav,VTTS_b-4_1901-2000_1956.wav,4550,4191,359
6129,b-1_3531-3631_3588.wav,VTTS_b-1_3531-3631_3588.wav,2780,2635,145
6130,b-3_2267-2349_2342.wav,VTTS_b-3_2267-2349_2342.wav,7110,6954,156
6131,b-3_980-1077_1039.wav,VTTS_b-3_980-1077_1039.wav,4440,4319,121
6132,b-4_1707-1813_1781.wav,VTTS_b-4_1707-1813_1781.wav,6960,6989,-29
6133,b-3_501-930_694.wav,VTTS_b-3_501-930_694.wav,5090,5445,-355
6134,b-3_6501-6600_6516.wav,VTTS_b-3_6501-6600_6516.wav,4990,4551,439
6135,b-3_2855-2942_2939.wav,VTTS_b-3_2855-2942_2939.wav,4990,6002,-1012
6136,b-1_2119-2219_2170.wav,VTTS_b-1_2119-2219_2170.wav,1390,1300,90
6137,b-1_2422-2522_2515.wav,VTTS_b-1_2422-2522_2515.wav,4110,4389,-279
6138,b-1_1010-1110_1056.wav,VTTS_b-1_1010-1110_1056.wav,5270,5840,-570
6139,b-1_3632-3732_3695.wav,VTTS_b-1_3632-3732_3695.wav,1790,2229,-439
6140,b-1_686-793_789.wav,VTTS_b-1_686-793_789.wav,1810,1625,185
6141,b-4_1506-1600_1581.wav,VTTS_b-4_1506-1600_1581.wav,3310,3344,-34
6142,b-3_2524-2854_2808.wav,VTTS_b-3_2524-2854_2808.wav,6970,6954,16
6143,b-1_2018-2118_2044.wav,VTTS_b-1_2018-2118_2044.wav,3090,2635,455
6144,b-4_2000-5164_2970.wav,VTTS_b-4_2000-5164_2970.wav,6423,5724,699
6145,b-1_1414-1514_1459.wav,VTTS_b-1_1414-1514_1459.wav,2790,2670,120
6146,b-2_1325-1426_1383.wav,VTTS_b-2_1325-1426_1383.wav,1330,1474,-144
6147,b-4_2000-5164_2580.wav,VTTS_b-4_2000-5164_2580.wav,5620,5828,-208
6148,b-3_5853-5956_5913.wav,VTTS_b-3_5853-5956_5913.wav,5100,4365,735
6149,b-4_2000-5164_2875.wav,VTTS_b-4_2000-5164_2875.wav,9080,8893,187
6150,b-4_2000-5164_2816.wav,VTTS_b-4_2000-5164_2816.wav,6190,6235,-45
6151,b-3_6900-7016_6936.wav,VTTS_b-3_6900-7016_6936.wav,6200,6409,-209
6152,b-1_377-477_430.wav,VTTS_b-1_377-477_430.wav,2300,2322,-22
6153,b-2_1427-1562_1454.wav,VTTS_b-2_1427-1562_1454.wav,5470,4365,1105
6154,b-1_2321-2421_2359.wav,VTTS_b-1_2321-2421_2359.wav,5510,4899,611
6155,b-2_1801-1902_1851.wav,VTTS_b-2_1801-1902_1851.wav,1380,1428,-48
6156,b-2_203-304_269.wav,VTTS_b-2_203-304_269.wav,2730,2496,234
6157,b-1_1919-2017_1921.wav,VTTS_b-1_1919-2017_1921.wav,3000,2926,74
6158,b-1_2826-2926_2860.wav,VTTS_b-1_2826-2926_2860.wav,2420,2450,-30
6159,b-3_5009-5427_5037.wav,VTTS_b-3_5009-5427_5037.wav,8150,7732,418
6160,b-3_4607-5008_4669.wav,VTTS_b-3_4607-5008_4669.wav,2750,2485,265
6161,b-3_501-930_740.wav,VTTS_b-3_501-930_740.wav,3350,3297,53
6162,b-3_5009-5427_5342.wav,VTTS_b-3_5009-5427_5342.wav,3770,4075,-305
6163,b-1_1919-2017_1935.wav,VTTS_b-1_1919-2017_1935.wav,2450,2345,105
6164,b-3_3279-3363_3290.wav,VTTS_b-3_3279-3363_3290.wav,8060,7651,409
6165,b-3_6116-6215_6158.wav,VTTS_b-3_6116-6215_6158.wav,6590,6177,413
6166,b-4_2000-5164_2826.wav,VTTS_b-4_2000-5164_2826.wav,4600,4029,571
6167,b-3_1079-1320_1224.wav,VTTS_b-3_1079-1320_1224.wav,5330,5712,-382
6168,b-3_1321-1568_1491.wav,VTTS_b-3_1321-1568_1491.wav,3690,3239,451
6169,b-4_53-150_87.wav,VTTS_b-4_53-150_87.wav,8620,7488,1132
6170,b-4_2000-5164_4254.wav,VTTS_b-4_2000-5164_4254.wav,2758,2601,157
6171,b-2_1223-1324_1276.wav,VTTS_b-2_1223-1324_1276.wav,1900,2055,-155
6172,b-4_2000-5164_2914.wav,VTTS_b-4_2000-5164_2914.wav,7101,7001,100
6173,b-3_4607-5008_4660.wav,VTTS_b-3_4607-5008_4660.wav,2740,9183,-6443
6174,b-4_1101-1220_1176.wav,VTTS_b-4_1101-1220_1176.wav,4120,4644,-524
6175,b-4_2000-5164_4642.wav,VTTS_b-4_2000-5164_4642.wav,1578,3088,-1510
6176,b-3_3198-3278_3244.wav,VTTS_b-3_3198-3278_3244.wav,3690,3553,137
6177,b-3_2177-2266_2201.wav,VTTS_b-3_2177-2266_2201.wav,8730,8173,557
6178,b-1_3430-3530_3459.wav,VTTS_b-1_3430-3530_3459.wav,1600,1498,102
6179,b-2_2107-2193_2165.wav,VTTS_b-2_2107-2193_2165.wav,1490,1579,-89
6180,b-3_392-500_485.wav,VTTS_b-3_392-500_485.wav,6140,7755,-1615
6181,b-1_1717-1817_1809.wav,VTTS_b-1_1717-1817_1809.wav,3130,2612,518
6182,b-3_6274-6300_6292.wav,VTTS_b-3_6274-6300_6292.wav,3040,3286,-246
6183,b-1_3733-3833_3766.wav,VTTS_b-1_3733-3833_3766.wav,1040,1068,-28
6184,b-1_1010-1110_1010.wav,VTTS_b-1_1010-1110_1010.wav,2070,1834,236
6185,b-1_276-376_366.wav,VTTS_b-1_276-376_366.wav,3340,4516,-1176
6186,b-4_2000-5164_5001.wav,VTTS_b-4_2000-5164_5001.wav,5696,5805,-109
6187,b-1_3127-3227_3136.wav,VTTS_b-1_3127-3227_3136.wav,1220,1103,117
6188,b-3_6601-6700_6674.wav,VTTS_b-3_6601-6700_6674.wav,6940,7233,-293
6189,b-3_3628-3714_3680.wav,VTTS_b-3_3628-3714_3680.wav,8980,7964,1016
6190,b-3_6900-7016_6932.wav,VTTS_b-3_6900-7016_6932.wav,10540,10077,463
6191,b-4_1101-1220_1175.wav,VTTS_b-4_1101-1220_1175.wav,1500,1591,-91
6192,b-1_4466-4498_4497.wav,VTTS_b-1_4466-4498_4497.wav,2620,2891,-271
6193,b-4_1-52_2.wav,VTTS_b-4_1-52_2.wav,6940,11610,-4670
6194,b-4_2000-5164_3859.wav,VTTS_b-4_2000-5164_3859.wav,2535,2543,-8
6195,b-3_4607-5008_4964.wav,VTTS_b-3_4607-5008_4964.wav,2310,2090,220
6196,b-1_175-275_195.wav,VTTS_b-1_175-275_195.wav,1330,1207,123
6197,b-1_1313-1413_1339.wav,VTTS_b-1_1313-1413_1339.wav,2770,3425,-655
6198,b-3_2000-2088_2029.wav,VTTS_b-3_2000-2088_2029.wav,3460,4725,-1265
6199,b-1_3834-3934_3853.wav,VTTS_b-1_3834-3934_3853.wav,2080,1997,83
6200,b-1_3329-3429_3357.wav,VTTS_b-1_3329-3429_3357.wav,5580,6165,-585
6201,b-1_2927-3025_2960.wav,VTTS_b-1_2927-3025_2960.wav,1790,1695,95
6202,b-4_53-150_142.wav,VTTS_b-4_53-150_142.wav,6770,6861,-91
6203,b-4_2000-5164_3384.wav,VTTS_b-4_2000-5164_3384.wav,1515,1289,226
6204,b-1_377-477_431.wav,VTTS_b-1_377-477_431.wav,2290,2020,270
6205,b-1_1313-1413_1367.wav,VTTS_b-1_1313-1413_1367.wav,1690,1533,157
6206,b-3_5639-5744_5705.wav,VTTS_b-3_5639-5744_5705.wav,4400,4214,186
6207,b-3_1079-1320_1176.wav,VTTS_b-3_1079-1320_1176.wav,10330,10693,-363
6208,b-3_196-293_232.wav,VTTS_b-3_196-293_232.wav,3210,3088,122
6209,b-2_1597-1698_1681.wav,VTTS_b-2_1597-1698_1681.wav,2990,3425,-435
6210,b-3_2524-2854_2642.wav,VTTS_b-3_2524-2854_2642.wav,3760,3576,184
6211,b-2_101-202_191.wav,VTTS_b-2_101-202_191.wav,1240,1207,33
6212,b-3_2524-2854_2556.wav,VTTS_b-3_2524-2854_2556.wav,6810,7233,-423
6213,b-3_501-930_547.wav,VTTS_b-3_501-930_547.wav,5410,5480,-70
6214,b-3_2524-2854_2562.wav,VTTS_b-3_2524-2854_2562.wav,7620,10333,-2713
6215,b-2_2073-2106_2081.wav,VTTS_b-2_2073-2106_2081.wav,2220,1904,316
6216,b-3_1764-1861_1845.wav,VTTS_b-3_1764-1861_1845.wav,5650,5317,333
6217,b-3_5009-5427_5123.wav,VTTS_b-3_5009-5427_5123.wav,6530,6838,-308
6218,b-2_2311-2412_2374.wav,VTTS_b-2_2311-2412_2374.wav,2260,1974,286
6219,b-3_2089-2176_2167.wav,VTTS_b-3_2089-2176_2167.wav,4880,4725,155
6220,b-1_1818-1918_1899.wav,VTTS_b-1_1818-1918_1899.wav,2740,2496,244
6221,b-3_3538-3627_3585.wav,VTTS_b-3_3538-3627_3585.wav,6030,5004,1026
6222,b-1_2220-2320_2254.wav,VTTS_b-1_2220-2320_2254.wav,1240,1149,91
6223,b-1_1111-1211_1131.wav,VTTS_b-1_1111-1211_1131.wav,3150,3320,-170
6224,b-1_794-1009_798.wav,VTTS_b-1_794-1009_798.wav,1150,1242,-92
6225,b-1_1010-1110_1053.wav,VTTS_b-1_1010-1110_1053.wav,2370,2171,199
6226,b-3_501-930_527.wav,VTTS_b-3_501-930_527.wav,5150,5782,-632
6227,b-3_501-930_667.wav,VTTS_b-3_501-930_667.wav,4510,4830,-320
6228,b-3_5745-5852_5755.wav,VTTS_b-3_5745-5852_5755.wav,5760,5445,315
6229,b-2_509-610_597.wav,VTTS_b-2_509-610_597.wav,910,1800,-890
6230,b-4_2000-5164_2656.wav,VTTS_b-4_2000-5164_2656.wav,3060,3994,-934
6231,b-1_2927-3025_3025.wav,VTTS_b-1_2927-3025_3025.wav,4720,5085,-365
6232,b-1_1414-1514_1463.wav,VTTS_b-1_1414-1514_1463.wav,1700,1509,191
6233,b-4_501-1014_845.wav,VTTS_b-4_501-1014_845.wav,6320,5793,527
6234,b-4_1506-1600_1506.wav,VTTS_b-4_1506-1600_1506.wav,6620,6838,-218
6235,b-4_1901-2000_1977.wav,VTTS_b-4_1901-2000_1977.wav,9600,10205,-605
6236,b-2_815-916_832.wav,VTTS_b-2_815-916_832.wav,880,894,-14
6237,b-3_6501-6600_6560.wav,VTTS_b-3_6501-6600_6560.wav,3230,3704,-474
6238,b-3_4104-4206_4118.wav,VTTS_b-3_4104-4206_4118.wav,7100,6861,239
6239,b-1_3531-3631_3573.wav,VTTS_b-1_3531-3631_3573.wav,1370,2287,-917
6240,b-1_3329-3429_3388.wav,VTTS_b-1_3329-3429_3388.wav,4660,5422,-762
6241,b-1_4070-4105_4073.wav,VTTS_b-1_4070-4105_4073.wav,3250,3587,-337
6242,b-3_5009-5427_5404.wav,VTTS_b-3_5009-5427_5404.wav,3580,3599,-19
6243,b-3_3715-3802_3772.wav,VTTS_b-3_3715-3802_3772.wav,9360,8673,687
6244,b-1_4178-4213_4207.wav,VTTS_b-1_4178-4213_4207.wav,4260,4191,69
6245,b-3_6016-6115_6066.wav,VTTS_b-3_6016-6115_6066.wav,3330,2752,578
6246,b-3_4498-4605_4571.wav,VTTS_b-3_4498-4605_4571.wav,4180,5294,-1114
6247,b-1_2018-2118_2095.wav,VTTS_b-1_2018-2118_2095.wav,1450,1451,-1
6248,b-3_2524-2854_2814.wav,VTTS_b-3_2524-2854_2814.wav,8670,8452,218
6249,b-4_151-300_275.wav,VTTS_b-4_151-300_275.wav,3910,3878,32
6250,b-4_1221-1300_1239.wav,VTTS_b-4_1221-1300_1239.wav,5250,4934,316
6251,b-4_2000-5164_2308.wav,VTTS_b-4_2000-5164_2308.wav,1320,1242,78
6252,b-2_1019-1120_1089.wav,VTTS_b-2_1019-1120_1089.wav,3730,4040,-310
6253,b-3_4425-4497_4433.wav,VTTS_b-3_4425-4497_4433.wav,7430,6815,615
6254,b-1_175-275_179.wav,VTTS_b-1_175-275_179.wav,3280,4377,-1097
6255,b-3_1321-1568_1351.wav,VTTS_b-3_1321-1568_1351.wav,3620,3367,253
6256,b-3_4607-5008_4708.wav,VTTS_b-3_4607-5008_4708.wav,4630,4133,497
6257,b-3_5745-5852_5820.wav,VTTS_b-3_5745-5852_5820.wav,3750,3297,453
6258,b-1_2927-3025_2939.wav,VTTS_b-1_2927-3025_2939.wav,1590,1498,92
6259,b-3_2524-2854_2800.wav,VTTS_b-3_2524-2854_2800.wav,5100,4656,444
6260,b-3_4104-4206_4160.wav,VTTS_b-3_4104-4206_4160.wav,4630,4365,265
6261,b-2_815-916_884.wav,VTTS_b-2_815-916_884.wav,4020,3924,96
6262,b-1_794-1009_899.wav,VTTS_b-1_794-1009_899.wav,3060,2798,262
6263,b-3_1666-1763_1691.wav,VTTS_b-3_1666-1763_1691.wav,5440,5642,-202
6264,b-2_1699-1800_1800.wav,VTTS_b-2_1699-1800_1800.wav,1840,2218,-378
6265,b-3_5533-5638_5622.wav,VTTS_b-3_5533-5638_5622.wav,3470,3193,277
6266,b-3_1666-1763_1729.wav,VTTS_b-3_1666-1763_1729.wav,10740,11227,-487
6267,b-3_2000-2088_2021.wav,VTTS_b-3_2000-2088_2021.wav,7660,11610,-3950
6268,b-4_2000-5164_2211.wav,VTTS_b-4_2000-5164_2211.wav,5210,5422,-212
6269,b-4_2000-5164_2095.wav,VTTS_b-4_2000-5164_2095.wav,3960,3750,210
6270,b-2_101-202_108.wav,VTTS_b-2_101-202_108.wav,4030,6107,-2077
6271,b-4_501-1014_501.wav,VTTS_b-4_501-1014_501.wav,5480,5979,-499
6272,b-4_1221-1300_1235.wav,VTTS_b-4_1221-1300_1235.wav,6150,5561,589
6273,b-2_1801-1902_1806.wav,VTTS_b-2_1801-1902_1806.wav,3170,3390,-220
6274,b-3_1-97_59.wav,VTTS_b-3_1-97_59.wav,3670,3622,48
6275,b-4_2000-5164_5017.wav,VTTS_b-4_2000-5164_5017.wav,3826,4331,-505
6276,b-3_4425-4497_4454.wav,VTTS_b-3_4425-4497_4454.wav,7480,7384,96
6277,b-4_2000-5164_3170.wav,VTTS_b-4_2000-5164_3170.wav,3875,3808,67
6278,b-3_501-930_598.wav,VTTS_b-3_501-930_598.wav,5040,5236,-196
6279,b-1_1717-1817_1747.wav,VTTS_b-1_1717-1817_1747.wav,1640,1591,49
6280,b-3_2524-2854_2773.wav,VTTS_b-3_2524-2854_2773.wav,1300,1324,-24
6281,b-3_5533-5638_5544.wav,VTTS_b-3_5533-5638_5544.wav,3420,3309,111
6282,b-4_2000-5164_5045.wav,VTTS_b-4_2000-5164_5045.wav,3001,2972,29
6283,b-4_2000-5164_4025.wav,VTTS_b-4_2000-5164_4025.wav,7463,7268,195
6284,b-4_2000-5164_3686.wav,VTTS_b-4_2000-5164_3686.wav,7337,9044,-1707
6285,b-3_4207-4314_4231.wav,VTTS_b-3_4207-4314_4231.wav,4770,4783,-13
6286,b-3_5009-5427_5250.wav,VTTS_b-3_5009-5427_5250.wav,11850,11529,321
6287,b-3_4607-5008_4672.wav,VTTS_b-3_4607-5008_4672.wav,5940,5155,785
6288,b-3_1862-1959_1886.wav,VTTS_b-3_1862-1959_1886.wav,2680,3053,-373
6289,b-1_4106-4141_4134.wav,VTTS_b-1_4106-4141_4134.wav,2230,2241,-11
6290,b-4_1101-1220_1180.wav,VTTS_b-4_1101-1220_1180.wav,1450,1463,-13
6291,b-3_2089-2176_2101.wav,VTTS_b-3_2089-2176_2101.wav,3520,3576,-56
6292,b-3_4315-4424_4374.wav,VTTS_b-3_4315-4424_4374.wav,6310,5712,598
6293,b-2_1801-1902_1868.wav,VTTS_b-2_1801-1902_1868.wav,2470,2705,-235
6294,b-2_815-916_821.wav,VTTS_b-2_815-916_821.wav,1250,1057,193
6295,b-4_2000-5164_3353.wav,VTTS_b-4_2000-5164_3353.wav,6303,6861,-558
6296,b-2_1019-1120_1099.wav,VTTS_b-2_1019-1120_1099.wav,1550,1254,296
6297,b-4_1221-1300_1291.wav,VTTS_b-4_1221-1300_1291.wav,5720,6142,-422
6298,b-3_3112-3197_3188.wav,VTTS_b-3_3112-3197_3188.wav,6200,6072,128
6299,b-3_2000-2088_2007.wav,VTTS_b-3_2000-2088_2007.wav,6560,5526,1034
6300,b-1_794-1009_911.wav,VTTS_b-1_794-1009_911.wav,2950,2810,140
6301,b-3_6801-6900_6893.wav,VTTS_b-3_6801-6900_6893.wav,8230,7384,846
6302,b-1_2725-2825_2795.wav,VTTS_b-1_2725-2825_2795.wav,2580,2241,339
6303,b-2_1223-1324_1225.wav,VTTS_b-2_1223-1324_1225.wav,4960,4911,49
6304,b-3_4607-5008_5009.wav,VTTS_b-3_4607-5008_5009.wav,3500,3715,-215
6305,b-3_2524-2854_2596.wav,VTTS_b-3_2524-2854_2596.wav,5860,6072,-212
6306,b-3_1321-1568_1546.wav,VTTS_b-3_1321-1568_1546.wav,5370,5422,-52
6307,b-4_501-1014_715.wav,VTTS_b-4_501-1014_715.wav,6290,7012,-722
6308,b-1_686-793_771.wav,VTTS_b-1_686-793_771.wav,4690,4865,-175
6309,b-1_1717-1817_1783.wav,VTTS_b-1_1717-1817_1783.wav,1690,1614,76
6310,b-2_1121-1222_1171.wav,VTTS_b-2_1121-1222_1171.wav,1190,1091,99
6311,b-3_3889-4000_3970.wav,VTTS_b-3_3889-4000_3970.wav,3800,3344,456
6312,b-3_1862-1959_1906.wav,VTTS_b-3_1862-1959_1906.wav,5330,6060,-730
6313,b-4_2000-5164_3800.wav,VTTS_b-4_2000-5164_3800.wav,4747,4400,347
6314,b-3_6801-6900_6851.wav,VTTS_b-3_6801-6900_6851.wav,6290,6525,-235
6315,b-4_501-1014_622.wav,VTTS_b-4_501-1014_622.wav,8580,9346,-766
6316,b-4_501-1014_921.wav,VTTS_b-4_501-1014_921.wav,1000,1033,-33
6317,b-4_2000-5164_4633.wav,VTTS_b-4_2000-5164_4633.wav,3010,5097,-2087
6318,b-1_1010-1110_1110.wav,VTTS_b-1_1010-1110_1110.wav,1490,1231,259
6319,b-4_2000-5164_3463.wav,VTTS_b-4_2000-5164_3463.wav,6760,7581,-821
6320,b-3_6601-6700_6676.wav,VTTS_b-3_6601-6700_6676.wav,4550,4354,196
6321,b-3_392-500_394.wav,VTTS_b-3_392-500_394.wav,9890,8766,1124
6322,b-4_2000-5164_3293.wav,VTTS_b-4_2000-5164_3293.wav,3240,3425,-185
6323,b-4_1301-1400_1373.wav,VTTS_b-4_1301-1400_1373.wav,3530,3448,82
6324,b-4_2000-5164_4598.wav,VTTS_b-4_2000-5164_4598.wav,1534,1393,141
6325,b-4_2000-5164_4942.wav,VTTS_b-4_2000-5164_4942.wav,1903,1823,80
6326,b-4_2000-5164_2840.wav,VTTS_b-4_2000-5164_2840.wav,6540,6060,480
6327,b-1_1717-1817_1762.wav,VTTS_b-1_1717-1817_1762.wav,1090,929,161
6328,b-2_1699-1800_1748.wav,VTTS_b-2_1699-1800_1748.wav,1020,1138,-118
6329,b-4_2000-5164_2425.wav,VTTS_b-4_2000-5164_2425.wav,3420,4481,-1061
6330,b-2_1019-1120_1103.wav,VTTS_b-2_1019-1120_1103.wav,5500,2972,2528
6331,b-1_1616-1716_1675.wav,VTTS_b-1_1616-1716_1675.wav,1750,1846,-96
6332,b-1_2927-3025_2970.wav,VTTS_b-1_2927-3025_2970.wav,2680,2647,33
6333,b-1_74-174_152.wav,VTTS_b-1_74-174_152.wav,2360,2601,-241
6334,b-4_501-1014_628.wav,VTTS_b-4_501-1014_628.wav,6490,6351,139
6335,b-3_1-97_21.wav,VTTS_b-3_1-97_21.wav,9370,10054,-684
6336,b-4_1901-2000_1949.wav,VTTS_b-4_1901-2000_1949.wav,2280,2043,237
6337,b-2_815-916_916.wav,VTTS_b-2_815-916_916.wav,2020,1997,23
6338,b-4_2000-5164_2195.wav,VTTS_b-4_2000-5164_2195.wav,2660,2995,-335
6339,b-4_1014-1100_1037.wav,VTTS_b-4_1014-1100_1037.wav,4080,3599,481
6340,b-3_501-930_671.wav,VTTS_b-3_501-930_671.wav,7320,7988,-668
6341,b-1_3026-3126_3058.wav,VTTS_b-1_3026-3126_3058.wav,4560,4238,322
6342,b-3_5009-5427_5023.wav,VTTS_b-3_5009-5427_5023.wav,4520,4122,398
6343,b-3_1-97_68.wav,VTTS_b-3_1-97_68.wav,2830,2763,67
6344,b-3_501-930_772.wav,VTTS_b-3_501-930_772.wav,9000,8615,385
6345,b-2_305-406_381.wav,VTTS_b-2_305-406_381.wav,2410,2334,76
6346,b-2_2040-2072_2068.wav,VTTS_b-2_2040-2072_2068.wav,990,1010,-20
6347,b-2_1-100_34.wav,VTTS_b-2_1-100_34.wav,3210,2705,505
6348,b-2_1-100_60.wav,VTTS_b-2_1-100_60.wav,3940,11610,-7670
6349,b-3_1079-1320_1174.wav,VTTS_b-3_1079-1320_1174.wav,6380,11331,-4951
6350,b-4_2000-5164_3238.wav,VTTS_b-4_2000-5164_3238.wav,3592,3193,399
6351,b-3_501-930_756.wav,VTTS_b-3_501-930_756.wav,3380,2902,478
6352,b-3_1568-1665_1593.wav,VTTS_b-3_1568-1665_1593.wav,3140,2984,156
6353,b-3_5639-5744_5736.wav,VTTS_b-3_5639-5744_5736.wav,3160,3135,25
6354,b-4_2000-5164_3736.wav,VTTS_b-4_2000-5164_3736.wav,6800,7326,-526
6355,b-3_3889-4000_3930.wav,VTTS_b-3_3889-4000_3930.wav,4610,4447,163
6356,b-2_1427-1562_1480.wav,VTTS_b-2_1427-1562_1480.wav,4190,3785,405
6357,b-4_2000-5164_2434.wav,VTTS_b-4_2000-5164_2434.wav,3640,3170,470
6358,b-3_2855-2942_2883.wav,VTTS_b-3_2855-2942_2883.wav,4500,5213,-713
6359,b-2_1801-1902_1888.wav,VTTS_b-2_1801-1902_1888.wav,5130,5097,33
6360,b-1_3026-3126_3049.wav,VTTS_b-1_3026-3126_3049.wav,2590,2426,164
6361,b-1_1414-1514_1506.wav,VTTS_b-1_1414-1514_1506.wav,5800,5782,18
6362,b-4_1301-1400_1359.wav,VTTS_b-4_1301-1400_1359.wav,5390,5236,154
6363,b-3_3628-3714_3671.wav,VTTS_b-3_3628-3714_3671.wav,3030,2844,186
6364,b-3_3364-3453_3439.wav,VTTS_b-3_3364-3453_3439.wav,4090,5306,-1216
6365,b-4_301-400_330.wav,VTTS_b-4_301-400_330.wav,3070,2902,168
6366,b-2_1903-2038_2026.wav,VTTS_b-2_1903-2038_2026.wav,3040,2067,973
6367,b-1_4430-4465_4435.wav,VTTS_b-1_4430-4465_4435.wav,4410,5074,-664
6368,b-3_6900-7016_6972.wav,VTTS_b-3_6900-7016_6972.wav,6330,7500,-1170
6369,b-3_6801-6900_6889.wav,VTTS_b-3_6801-6900_6889.wav,3940,3495,445
6370,b-1_3733-3833_3749.wav,VTTS_b-1_3733-3833_3749.wav,1590,1556,34
6371,b-1_1111-1211_1158.wav,VTTS_b-1_1111-1211_1158.wav,3430,3773,-343
6372,b-4_2000-5164_2436.wav,VTTS_b-4_2000-5164_2436.wav,5350,6072,-722
6373,b-1_4142-4177_4173.wav,VTTS_b-1_4142-4177_4173.wav,1520,1579,-59
6374,b-3_6900-7016_6982.wav,VTTS_b-3_6900-7016_6982.wav,6010,5619,391
6375,b-4_2000-5164_2224.wav,VTTS_b-4_2000-5164_2224.wav,3640,4261,-621
6376,b-2_1427-1562_1445.wav,VTTS_b-2_1427-1562_1445.wav,5950,11610,-5660
6377,b-2_1019-1120_1030.wav,VTTS_b-2_1019-1120_1030.wav,1160,1451,-291
6378,b-4_2000-5164_4194.wav,VTTS_b-4_2000-5164_4194.wav,2642,2543,99
6379,b-3_2350-2433_2414.wav,VTTS_b-3_2350-2433_2414.wav,7880,6966,914
6380,b-4_1601-1706_1640.wav,VTTS_b-4_1601-1706_1640.wav,3200,2589,611
6381,b-3_2524-2854_2748.wav,VTTS_b-3_2524-2854_2748.wav,3730,3274,456
6382,b-3_2267-2349_2304.wav,VTTS_b-3_2267-2349_2304.wav,3680,3448,232
6383,b-3_5745-5852_5839.wav,VTTS_b-3_5745-5852_5839.wav,7650,9613,-1963
6384,b-3_2524-2854_2725.wav,VTTS_b-3_2524-2854_2725.wav,5350,6467,-1117
6385,b-3_5533-5638_5598.wav,VTTS_b-3_5533-5638_5598.wav,3560,3379,181
6386,b-1_1010-1110_1038.wav,VTTS_b-1_1010-1110_1038.wav,2030,2009,21
6387,b-1_2523-2623_2603.wav,VTTS_b-1_2523-2623_2603.wav,1250,1138,112
6388,b-1_2119-2219_2172.wav,VTTS_b-1_2119-2219_2172.wav,1150,1184,-34
6389,b-4_2000-5164_3692.wav,VTTS_b-4_2000-5164_3692.wav,8104,7732,372
6390,b-2_1903-2038_2025.wav,VTTS_b-2_1903-2038_2025.wav,3430,1602,1828
6391,b-1_1818-1918_1893.wav,VTTS_b-1_1818-1918_1893.wav,1590,1463,127
6392,b-1_2523-2623_2576.wav,VTTS_b-1_2523-2623_2576.wav,1510,1521,-11
6393,b-3_501-930_505.wav,VTTS_b-3_501-930_505.wav,3520,3425,95
6394,b-2_1121-1222_1132.wav,VTTS_b-2_1121-1222_1132.wav,1410,1416,-6
6395,b-2_1427-1562_1546.wav,VTTS_b-2_1427-1562_1546.wav,1800,1858,-58
6396,b-1_794-1009_862.wav,VTTS_b-1_794-1009_862.wav,1890,2334,-444
6397,b-1_4430-4465_4458.wav,VTTS_b-1_4430-4465_4458.wav,2450,2682,-232
6398,b-1_2119-2219_2119.wav,VTTS_b-1_2119-2219_2119.wav,1130,1219,-89
6399,b-1_74-174_139.wav,VTTS_b-1_74-174_139.wav,1900,1672,228
6400,b-2_2107-2193_2181.wav,VTTS_b-2_2107-2193_2181.wav,1080,1149,-69
6401,b-3_5745-5852_5831.wav,VTTS_b-3_5745-5852_5831.wav,5150,4865,285
6402,b-3_2524-2854_2602.wav,VTTS_b-3_2524-2854_2602.wav,5200,4934,266
6403,b-4_401-500_449.wav,VTTS_b-4_401-500_449.wav,2410,2183,227
6404,b-3_6701-6800_6731.wav,VTTS_b-3_6701-6800_6731.wav,8230,8858,-628
6405,b-3_2524-2854_2618.wav,VTTS_b-3_2524-2854_2618.wav,7510,7245,265
6406,b-4_2000-5164_4480.wav,VTTS_b-4_2000-5164_4480.wav,3027,2368,659
6407,b-1_794-1009_841.wav,VTTS_b-1_794-1009_841.wav,2090,2183,-93
6408,b-4_2000-5164_3433.wav,VTTS_b-4_2000-5164_3433.wav,2063,1869,194
6409,b-1_1010-1110_1094.wav,VTTS_b-1_1010-1110_1094.wav,1990,1950,40
6410,b-2_1597-1698_1606.wav,VTTS_b-2_1597-1698_1606.wav,1330,1184,146
6411,b-2_1121-1222_1176.wav,VTTS_b-2_1121-1222_1176.wav,3220,3901,-681
6412,b-1_2725-2825_2766.wav,VTTS_b-1_2725-2825_2766.wav,1980,2612,-632
6413,b-4_1101-1220_1169.wav,VTTS_b-4_1101-1220_1169.wav,1880,1939,-59
6414,b-1_3935-4033_3982.wav,VTTS_b-1_3935-4033_3982.wav,1420,1498,-78
6415,b-1_276-376_307.wav,VTTS_b-1_276-376_307.wav,1640,1730,-90
6416,b-1_4214-4285_4229.wav,VTTS_b-1_4214-4285_4229.wav,4450,4238,212
6417,b-4_2000-5164_4940.wav,VTTS_b-4_2000-5164_4940.wav,3275,3053,222
6418,b-2_1019-1120_1074.wav,VTTS_b-2_1019-1120_1074.wav,2830,2717,113
6419,b-1_1111-1211_1202.wav,VTTS_b-1_1111-1211_1202.wav,5040,5155,-115
6420,b-3_1321-1568_1553.wav,VTTS_b-3_1321-1568_1553.wav,1890,1858,32
6421,b-3_2350-2433_2354.wav,VTTS_b-3_2350-2433_2354.wav,5850,5306,544
6422,b-3_4607-5008_4616.wav,VTTS_b-3_4607-5008_4616.wav,4810,4830,-20
6423,b-3_1-97_85.wav,VTTS_b-3_1-97_85.wav,3290,2752,538
6424,b-1_4214-4285_4225.wav,VTTS_b-1_4214-4285_4225.wav,2380,2299,81
6425,b-3_4607-5008_4857.wav,VTTS_b-3_4607-5008_4857.wav,2790,2125,665
6426,b-1_1717-1817_1763.wav,VTTS_b-1_1717-1817_1763.wav,1480,1393,87
6427,b-4_301-400_367.wav,VTTS_b-4_301-400_367.wav,4130,4272,-142
6428,b-3_2943-3024_2963.wav,VTTS_b-3_2943-3024_2963.wav,6780,7930,-1150
6429,b-1_2927-3025_2934.wav,VTTS_b-1_2927-3025_2934.wav,4130,3982,148
6430,b-4_1301-1400_1321.wav,VTTS_b-4_1301-1400_1321.wav,3110,3228,-118
6431,b-3_6701-6800_6796.wav,VTTS_b-3_6701-6800_6796.wav,4430,7198,-2768
6432,b-4_2000-5164_4520.wav,VTTS_b-4_2000-5164_4520.wav,3976,4017,-41
6433,b-3_4315-4424_4347.wav,VTTS_b-3_4315-4424_4347.wav,1300,1300,0
6434,b-2_1801-1902_1883.wav,VTTS_b-2_1801-1902_1883.wav,1290,1277,13
6435,b-3_2177-2266_2178.wav,VTTS_b-3_2177-2266_2178.wav,4790,4365,425
6436,b-4_2000-5164_3833.wav,VTTS_b-4_2000-5164_3833.wav,6253,5991,262
6437,b-4_2000-5164_3631.wav,VTTS_b-4_2000-5164_3631.wav,5857,5584,273
6438,b-2_713-814_794.wav,VTTS_b-2_713-814_794.wav,3290,2694,596
6439,b-1_3430-3530_3521.wav,VTTS_b-1_3430-3530_3521.wav,2820,3146,-326
6440,b-3_98-195_168.wav,VTTS_b-3_98-195_168.wav,5470,6235,-765
6441,b-3_5957-6015_5992.wav,VTTS_b-3_5957-6015_5992.wav,6160,6118,42
6442,b-4_2000-5164_3479.wav,VTTS_b-4_2000-5164_3479.wav,1899,2461,-562
6443,b-4_1014-1100_1055.wav,VTTS_b-4_1014-1100_1055.wav,6450,5828,622
6444,b-4_1101-1220_1187.wav,VTTS_b-4_1101-1220_1187.wav,2740,2647,93
6445,b-4_2000-5164_3852.wav,VTTS_b-4_2000-5164_3852.wav,4605,5050,-445
6446,b-4_2000-5164_5072.wav,VTTS_b-4_2000-5164_5072.wav,1747,1625,122
6447,b-2_1325-1426_1345.wav,VTTS_b-2_1325-1426_1345.wav,3400,3007,393
6448,b-1_2018-2118_2099.wav,VTTS_b-1_2018-2118_2099.wav,1090,1045,45
6449,b-4_301-400_317.wav,VTTS_b-4_301-400_317.wav,6090,6153,-63
6450,b-3_2177-2266_2260.wav,VTTS_b-3_2177-2266_2260.wav,4250,4540,-290
6451,b-3_2524-2854_2828.wav,VTTS_b-3_2524-2854_2828.wav,5330,5550,-220
6452,b-3_5639-5744_5671.wav,VTTS_b-3_5639-5744_5671.wav,10570,10205,365
6453,b-1_74-174_126.wav,VTTS_b-1_74-174_126.wav,1550,1788,-238
6454,b-1_4142-4177_4153.wav,VTTS_b-1_4142-4177_4153.wav,3650,3622,28
6455,b-1_2725-2825_2760.wav,VTTS_b-1_2725-2825_2760.wav,2110,1916,194
6456,b-1_3733-3833_3767.wav,VTTS_b-1_3733-3833_3767.wav,1100,1033,67
6457,b-3_5009-5427_5045.wav,VTTS_b-3_5009-5427_5045.wav,4770,4574,196
6458,b-4_2000-5164_2773.wav,VTTS_b-4_2000-5164_2773.wav,5905,5387,518
6459,b-4_501-1014_648.wav,VTTS_b-4_501-1014_648.wav,5750,6444,-694
6460,b-1_1111-1211_1212.wav,VTTS_b-1_1111-1211_1212.wav,2770,3320,-550
6461,b-3_3364-3453_3402.wav,VTTS_b-3_3364-3453_3402.wav,8810,10217,-1407
6462,b-4_1814-1900_1845.wav,VTTS_b-4_1814-1900_1845.wav,5540,5735,-195
6463,b-2_917-1018_996.wav,VTTS_b-2_917-1018_996.wav,1990,2589,-599
6464,b-1_276-376_328.wav,VTTS_b-1_276-376_328.wav,1250,1231,19
6465,b-1_794-1009_1001.wav,VTTS_b-1_794-1009_1001.wav,2660,2670,-10
6466,b-1_1-73_5.wav,VTTS_b-1_1-73_5.wav,2400,2252,148
6467,b-2_1699-1800_1754.wav,VTTS_b-2_1699-1800_1754.wav,7700,7465,235
6468,b-2_1223-1324_1284.wav,VTTS_b-2_1223-1324_1284.wav,7710,11610,-3900
6469,b-4_1101-1220_1163.wav,VTTS_b-4_1101-1220_1163.wav,2050,2009,41
6470,b-3_1079-1320_1244.wav,VTTS_b-3_1079-1320_1244.wav,7930,8382,-452
6471,b-4_2000-5164_3679.wav,VTTS_b-4_2000-5164_3679.wav,4901,5097,-196
6472,b-1_1010-1110_1093.wav,VTTS_b-1_1010-1110_1093.wav,4260,4261,-1
6473,b-1_3430-3530_3457.wav,VTTS_b-1_3430-3530_3457.wav,2370,2125,245
6474,b-4_2000-5164_2785.wav,VTTS_b-4_2000-5164_2785.wav,3520,3425,95
6475,b-2_1597-1698_1627.wav,VTTS_b-2_1597-1698_1627.wav,2080,2067,13
6476,b-4_1814-1900_1835.wav,VTTS_b-4_1814-1900_1835.wav,5180,5294,-114
6477,b-3_6701-6800_6790.wav,VTTS_b-3_6701-6800_6790.wav,8750,9033,-283
6478,b-4_1506-1600_1522.wav,VTTS_b-4_1506-1600_1522.wav,4970,4365,605
6479,b-3_6601-6700_6683.wav,VTTS_b-3_6601-6700_6683.wav,4910,5445,-535
6480,b-3_4607-5008_4813.wav,VTTS_b-3_4607-5008_4813.wav,4070,4214,-144
6481,b-4_501-1014_667.wav,VTTS_b-4_501-1014_667.wav,7720,11610,-3890
6482,b-1_3531-3631_3632.wav,VTTS_b-1_3531-3631_3632.wav,1570,1451,119
6483,b-1_3026-3126_3044.wav,VTTS_b-1_3026-3126_3044.wav,2580,2357,223
6484,b-1_3834-3934_3924.wav,VTTS_b-1_3834-3934_3924.wav,3540,4841,-1301
6485,b-3_5745-5852_5772.wav,VTTS_b-3_5745-5852_5772.wav,3780,3843,-63
6486,b-4_2000-5164_3701.wav,VTTS_b-4_2000-5164_3701.wav,5319,6815,-1496
6487,b-4_2000-5164_2871.wav,VTTS_b-4_2000-5164_2871.wav,10070,9950,120
6488,b-3_1321-1568_1463.wav,VTTS_b-3_1321-1568_1463.wav,4290,3762,528
6489,b-3_1079-1320_1096.wav,VTTS_b-3_1079-1320_1096.wav,7830,7465,365
6490,b-1_2725-2825_2782.wav,VTTS_b-1_2725-2825_2782.wav,1350,1324,26
6491,b-3_3803-3888_3828.wav,VTTS_b-3_3803-3888_3828.wav,7000,6780,220
6492,b-4_2000-5164_3181.wav,VTTS_b-4_2000-5164_3181.wav,5784,6060,-276
6493,b-4_2000-5164_3964.wav,VTTS_b-4_2000-5164_3964.wav,3434,3448,-14
6494,b-4_501-1014_806.wav,VTTS_b-4_501-1014_806.wav,6400,11389,-4989
6495,b-2_1597-1698_1610.wav,VTTS_b-2_1597-1698_1610.wav,1760,1324,436
6496,b-3_6116-6215_6138.wav,VTTS_b-3_6116-6215_6138.wav,8550,9799,-1249
6497,b-4_2000-5164_3424.wav,VTTS_b-4_2000-5164_3424.wav,2902,2694,208
6498,b-1_2018-2118_2019.wav,VTTS_b-1_2018-2118_2019.wav,1140,998,142
6499,b-1_650-685_674.wav,VTTS_b-1_650-685_674.wav,1240,1265,-25
6500,b-4_501-1014_822.wav,VTTS_b-4_501-1014_822.wav,6720,6316,404
6501,b-1_276-376_367.wav,VTTS_b-1_276-376_367.wav,1510,1277,233
6502,b-1_686-793_770.wav,VTTS_b-1_686-793_770.wav,1410,1695,-285
6503,b-4_1814-1900_1886.wav,VTTS_b-4_1814-1900_1886.wav,1940,1823,117
6504,b-4_2000-5164_4968.wav,VTTS_b-4_2000-5164_4968.wav,3705,2995,710
6505,b-2_713-814_743.wav,VTTS_b-2_713-814_743.wav,6200,5573,627
6506,b-3_5009-5427_5388.wav,VTTS_b-3_5009-5427_5388.wav,4780,4505,275
6507,b-3_196-293_278.wav,VTTS_b-3_196-293_278.wav,5110,5538,-428
6508,b-3_2524-2854_2765.wav,VTTS_b-3_2524-2854_2765.wav,5710,5352,358
6509,b-3_6801-6900_6890.wav,VTTS_b-3_6801-6900_6890.wav,6430,5515,915
6510,b-4_2000-5164_3187.wav,VTTS_b-4_2000-5164_3187.wav,5221,5457,-236
6511,b-4_2000-5164_3837.wav,VTTS_b-4_2000-5164_3837.wav,5284,5271,13
6512,b-1_175-275_213.wav,VTTS_b-1_175-275_213.wav,1960,1486,474
6513,b-3_1321-1568_1364.wav,VTTS_b-3_1321-1568_1364.wav,6230,7338,-1108
6514,b-1_4358-4393_4389.wav,VTTS_b-1_4358-4393_4389.wav,2060,2032,28
6515,b-4_2000-5164_4993.wav,VTTS_b-4_2000-5164_4993.wav,9452,11610,-2158
6516,b-3_3025-3111_3087.wav,VTTS_b-3_3025-3111_3087.wav,6490,5944,546
6517,b-1_1111-1211_1201.wav,VTTS_b-1_1111-1211_1201.wav,2940,3541,-601
6518,b-1_2422-2522_2463.wav,VTTS_b-1_2422-2522_2463.wav,2850,2566,284
6519,b-4_2000-5164_2949.wav,VTTS_b-4_2000-5164_2949.wav,3536,3402,134
6520,b-2_713-814_739.wav,VTTS_b-2_713-814_739.wav,1020,1010,10
6521,b-4_2000-5164_3910.wav,VTTS_b-4_2000-5164_3910.wav,7243,7001,242
6522,b-3_1764-1861_1797.wav,VTTS_b-3_1764-1861_1797.wav,4530,4598,-68
6523,b-3_5009-5427_5392.wav,VTTS_b-3_5009-5427_5392.wav,3370,5248,-1878
6524,b-1_2119-2219_2182.wav,VTTS_b-1_2119-2219_2182.wav,3530,4319,-789
6525,b-3_2089-2176_2102.wav,VTTS_b-3_2089-2176_2102.wav,3030,2786,244
6526,b-3_980-1077_1055.wav,VTTS_b-3_980-1077_1055.wav,6250,5909,341
6527,b-3_2855-2942_2866.wav,VTTS_b-3_2855-2942_2866.wav,5860,5933,-73
6528,b-4_301-400_303.wav,VTTS_b-4_301-400_303.wav,2280,2218,62
6529,b-3_1666-1763_1688.wav,VTTS_b-3_1666-1763_1688.wav,10720,10310,410
6530,b-1_3026-3126_3096.wav,VTTS_b-1_3026-3126_3096.wav,1730,3053,-1323
6531,b-3_1960-2000_1973.wav,VTTS_b-3_1960-2000_1973.wav,3950,3587,363
6532,b-1_579-649_628.wav,VTTS_b-1_579-649_628.wav,4130,4145,-15
6533,b-1_4430-4465_4454.wav,VTTS_b-1_4430-4465_4454.wav,3330,4458,-1128
6534,b-2_203-304_297.wav,VTTS_b-2_203-304_297.wav,2290,2508,-218
6535,b-3_5957-6015_5966.wav,VTTS_b-3_5957-6015_5966.wav,2610,2694,-84
6536,b-3_6217-6274_6227.wav,VTTS_b-3_6217-6274_6227.wav,1330,1393,-63
6537,b-3_2350-2433_2364.wav,VTTS_b-3_2350-2433_2364.wav,2860,2647,213
6538,b-3_3715-3802_3762.wav,VTTS_b-3_3715-3802_3762.wav,1640,2078,-438
6539,b-3_6016-6115_6068.wav,VTTS_b-3_6016-6115_6068.wav,3050,3007,43
6540,b-2_611-712_674.wav,VTTS_b-2_611-712_674.wav,2010,2241,-231
6541,b-3_1666-1763_1723.wav,VTTS_b-3_1666-1763_1723.wav,3300,3239,61
6542,b-4_2000-5164_4299.wav,VTTS_b-4_2000-5164_4299.wav,2717,2786,-69
6543,b-3_2267-2349_2333.wav,VTTS_b-3_2267-2349_2333.wav,5860,5921,-61
6544,b-4_2000-5164_2595.wav,VTTS_b-4_2000-5164_2595.wav,2305,2380,-75
6545,b-3_5009-5427_5195.wav,VTTS_b-3_5009-5427_5195.wav,9370,9961,-591
6546,b-3_6401-6500_6492.wav,VTTS_b-3_6401-6500_6492.wav,3280,3471,-191
6547,b-1_4286-4321_4320.wav,VTTS_b-1_4286-4321_4320.wav,4510,5259,-749
6548,b-3_5745-5852_5799.wav,VTTS_b-3_5745-5852_5799.wav,3340,3204,136
6549,b-2_203-304_216.wav,VTTS_b-2_203-304_216.wav,2630,2740,-110
6550,b-4_2000-5164_3626.wav,VTTS_b-4_2000-5164_3626.wav,5447,4876,571
6551,b-2_203-304_274.wav,VTTS_b-2_203-304_274.wav,4430,4342,88
6552,b-3_1079-1320_1219.wav,VTTS_b-3_1079-1320_1219.wav,3030,2647,383
6553,b-3_3454-3537_3493.wav,VTTS_b-3_3454-3537_3493.wav,5880,6339,-459
6554,b-3_3454-3537_3494.wav,VTTS_b-3_3454-3537_3494.wav,2620,2043,577
6555,b-1_3733-3833_3745.wav,VTTS_b-1_3733-3833_3745.wav,2210,2043,167
6556,b-4_1014-1100_1038.wav,VTTS_b-4_1014-1100_1038.wav,3900,7686,-3786
6557,b-4_2000-5164_2872.wav,VTTS_b-4_2000-5164_2872.wav,4865,4516,349
6558,b-4_1707-1813_1724.wav,VTTS_b-4_1707-1813_1724.wav,4580,4540,40
6559,b-3_4607-5008_4841.wav,VTTS_b-3_4607-5008_4841.wav,5730,5642,88
6560,b-4_1301-1400_1311.wav,VTTS_b-4_1301-1400_1311.wav,5230,5503,-273
6561,b-1_3228-3328_3289.wav,VTTS_b-1_3228-3328_3289.wav,2410,2566,-156
6562,b-3_2943-3024_2969.wav,VTTS_b-3_2943-3024_2969.wav,6510,6165,345
6563,b-4_2000-5164_4583.wav,VTTS_b-4_2000-5164_4583.wav,2722,3297,-575
6564,b-4_2000-5164_3685.wav,VTTS_b-4_2000-5164_3685.wav,7421,8533,-1112
6565,b-2_1801-1902_1874.wav,VTTS_b-2_1801-1902_1874.wav,3360,4516,-1156
6566,b-4_1901-2000_1928.wav,VTTS_b-4_1901-2000_1928.wav,5090,4911,179
6567,b-2_1801-1902_1827.wav,VTTS_b-2_1801-1902_1827.wav,2350,1683,667
6568,b-1_1111-1211_1184.wav,VTTS_b-1_1111-1211_1184.wav,860,789,71
6569,b-3_1079-1320_1183.wav,VTTS_b-3_1079-1320_1183.wav,5010,4690,320
6570,b-3_5639-5744_5742.wav,VTTS_b-3_5639-5744_5742.wav,3220,3646,-426
6571,b-3_4104-4206_4144.wav,VTTS_b-3_4104-4206_4144.wav,2770,3181,-411
6572,b-1_2927-3025_2945.wav,VTTS_b-1_2927-3025_2945.wav,1500,1579,-79
6573,b-3_1321-1568_1547.wav,VTTS_b-3_1321-1568_1547.wav,6920,6861,59
6574,b-4_2000-5164_4654.wav,VTTS_b-4_2000-5164_4654.wav,5750,5457,293
6575,b-3_196-293_207.wav,VTTS_b-3_196-293_207.wav,9650,11610,-1960
6576,b-4_2000-5164_4176.wav,VTTS_b-4_2000-5164_4176.wav,3473,3785,-312
6577,b-4_2000-5164_2795.wav,VTTS_b-4_2000-5164_2795.wav,4380,4609,-229
6578,b-1_579-649_638.wav,VTTS_b-1_579-649_638.wav,1520,2113,-593
6579,b-3_2434-2523_2449.wav,VTTS_b-3_2434-2523_2449.wav,2760,2844,-84
6580,b-1_2119-2219_2159.wav,VTTS_b-1_2119-2219_2159.wav,3130,3158,-28
6581,b-3_3628-3714_3692.wav,VTTS_b-3_3628-3714_3692.wav,2560,2786,-226
6582,b-1_2624-2724_2713.wav,VTTS_b-1_2624-2724_2713.wav,2670,2519,151
6583,b-1_1212-1312_1241.wav,VTTS_b-1_1212-1312_1241.wav,2160,1985,175
6584,b-3_1666-1763_1727.wav,VTTS_b-3_1666-1763_1727.wav,6350,6211,139
6585,b-3_501-930_770.wav,VTTS_b-3_501-930_770.wav,7120,6571,549
6586,b-4_2000-5164_4212.wav,VTTS_b-4_2000-5164_4212.wav,4405,5097,-692
6587,b-4_1401-1505_1433.wav,VTTS_b-4_1401-1505_1433.wav,9560,8649,911
6588,b-3_5009-5427_5231.wav,VTTS_b-3_5009-5427_5231.wav,4870,5433,-563
6589,b-2_1121-1222_1197.wav,VTTS_b-2_1121-1222_1197.wav,2070,2183,-113
6590,b-3_4207-4314_4259.wav,VTTS_b-3_4207-4314_4259.wav,5910,5433,477
6591,b-4_2000-5164_2839.wav,VTTS_b-4_2000-5164_2839.wav,2140,4772,-2632
6592,b-4_151-300_158.wav,VTTS_b-4_151-300_158.wav,4990,5886,-896
6593,b-1_3935-4033_4014.wav,VTTS_b-1_3935-4033_4014.wav,3350,3193,157
6594,b-3_2524-2854_2568.wav,VTTS_b-3_2524-2854_2568.wav,8730,9334,-604
6595,b-1_1616-1716_1711.wav,VTTS_b-1_1616-1716_1711.wav,2980,3704,-724
6596,b-2_1223-1324_1311.wav,VTTS_b-2_1223-1324_1311.wav,4440,4191,249
6597,b-3_3628-3714_3712.wav,VTTS_b-3_3628-3714_3712.wav,4740,3738,1002
6598,b-3_2089-2176_2122.wav,VTTS_b-3_2089-2176_2122.wav,4490,4063,427
6599,b-1_4430-4465_4438.wav,VTTS_b-1_4430-4465_4438.wav,4390,4447,-57
6600,b-4_2000-5164_3892.wav,VTTS_b-4_2000-5164_3892.wav,5307,4830,477
6601,b-3_4207-4314_4229.wav,VTTS_b-3_4207-4314_4229.wav,5040,5759,-719
6602,b-3_501-930_798.wav,VTTS_b-3_501-930_798.wav,4410,4261,149
6603,b-3_501-930_683.wav,VTTS_b-3_501-930_683.wav,5030,5143,-113
6604,b-4_2000-5164_4221.wav,VTTS_b-4_2000-5164_4221.wav,1584,1393,191
6605,b-2_917-1018_987.wav,VTTS_b-2_917-1018_987.wav,2750,3239,-489
6606,b-4_2000-5164_3398.wav,VTTS_b-4_2000-5164_3398.wav,5304,5480,-176
6607,b-4_501-1014_678.wav,VTTS_b-4_501-1014_678.wav,2510,2624,-114
6608,b-3_3025-3111_3110.wav,VTTS_b-3_3025-3111_3110.wav,8330,8800,-470
6609,b-3_4425-4497_4438.wav,VTTS_b-3_4425-4497_4438.wav,6580,7303,-723
6610,b-4_1707-1813_1791.wav,VTTS_b-4_1707-1813_1791.wav,2280,2276,4
6611,b-1_3632-3732_3643.wav,VTTS_b-1_3632-3732_3643.wav,2830,1916,914
6612,b-3_4607-5008_4644.wav,VTTS_b-3_4607-5008_4644.wav,3250,3042,208
6613,b-4_2000-5164_2162.wav,VTTS_b-4_2000-5164_2162.wav,2235,1974,261
6614,b-3_1079-1320_1188.wav,VTTS_b-3_1079-1320_1188.wav,6060,5979,81
6615,b-3_6116-6215_6168.wav,VTTS_b-3_6116-6215_6168.wav,4600,5468,-868
6616,b-3_3279-3363_3288.wav,VTTS_b-3_3279-3363_3288.wav,3570,3379,191
6617,b-1_1919-2017_1990.wav,VTTS_b-1_1919-2017_1990.wav,2700,2461,239
6618,b-4_2000-5164_2010.wav,VTTS_b-4_2000-5164_2010.wav,3672,3994,-322
6619,b-4_2000-5164_4282.wav,VTTS_b-4_2000-5164_4282.wav,3661,3437,224
6620,b-3_294-391_341.wav,VTTS_b-3_294-391_341.wav,3840,3843,-3
6621,b-1_3733-3833_3812.wav,VTTS_b-1_3733-3833_3812.wav,900,882,18
6622,b-3_3628-3714_3633.wav,VTTS_b-3_3628-3714_3633.wav,9760,11610,-1850
6623,b-3_2524-2854_2750.wav,VTTS_b-3_2524-2854_2750.wav,8110,7314,796
6624,b-1_3531-3631_3602.wav,VTTS_b-1_3531-3631_3602.wav,2580,2113,467
6625,b-3_1764-1861_1826.wav,VTTS_b-3_1764-1861_1826.wav,4860,5352,-492
6626,b-2_407-508_480.wav,VTTS_b-2_407-508_480.wav,3880,3820,60
6627,b-4_2000-5164_4052.wav,VTTS_b-4_2000-5164_4052.wav,4254,4087,167
6628,b-3_6900-7016_7011.wav,VTTS_b-3_6900-7016_7011.wav,3680,3471,209
6629,b-4_2000-5164_4540.wav,VTTS_b-4_2000-5164_4540.wav,5503,5631,-128
6630,b-3_4607-5008_4688.wav,VTTS_b-3_4607-5008_4688.wav,10650,10635,15
6631,b-1_4430-4465_4463.wav,VTTS_b-1_4430-4465_4463.wav,1600,1463,137
6632,b-3_4104-4206_4155.wav,VTTS_b-3_4104-4206_4155.wav,5200,4946,254
6633,b-3_6401-6500_6417.wav,VTTS_b-3_6401-6500_6417.wav,3940,3913,27
6634,b-4_2000-5164_4742.wav,VTTS_b-4_2000-5164_4742.wav,6886,6351,535
6635,b-4_151-300_204.wav,VTTS_b-4_151-300_204.wav,2260,2206,54
6636,b-1_4070-4105_4075.wav,VTTS_b-1_4070-4105_4075.wav,2280,2206,74
6637,b-3_392-500_396.wav,VTTS_b-3_392-500_396.wav,7950,9033,-1083
6638,b-1_3430-3530_3522.wav,VTTS_b-1_3430-3530_3522.wav,920,940,-20
6639,b-1_579-649_623.wav,VTTS_b-1_579-649_623.wav,3960,4888,-928
6640,b-3_5853-5956_5944.wav,VTTS_b-3_5853-5956_5944.wav,6210,6049,161
6641,b-2_815-916_848.wav,VTTS_b-2_815-916_848.wav,3580,3553,27
6642,b-2_2311-2412_2336.wav,VTTS_b-2_2311-2412_2336.wav,4770,4365,405
6643,b-3_3279-3363_3360.wav,VTTS_b-3_3279-3363_3360.wav,6060,6177,-117
6644,b-3_3025-3111_3038.wav,VTTS_b-3_3025-3111_3038.wav,5890,6246,-356
6645,b-3_1079-1320_1213.wav,VTTS_b-3_1079-1320_1213.wav,7520,8208,-688
6646,b-2_1801-1902_1860.wav,VTTS_b-2_1801-1902_1860.wav,2380,2705,-325
6647,b-1_2725-2825_2788.wav,VTTS_b-1_2725-2825_2788.wav,4690,4354,336
6648,b-4_2000-5164_2921.wav,VTTS_b-4_2000-5164_2921.wav,8045,8475,-430
6649,b-1_4214-4285_4227.wav,VTTS_b-1_4214-4285_4227.wav,4060,4365,-305
6650,b-1_1111-1211_1191.wav,VTTS_b-1_1111-1211_1191.wav,1740,1440,300
6651,b-3_2000-2088_2013.wav,VTTS_b-3_2000-2088_2013.wav,5060,4656,404
6652,b-4_2000-5164_3143.wav,VTTS_b-4_2000-5164_3143.wav,8072,8278,-206
6653,b-1_3228-3328_3243.wav,VTTS_b-1_3228-3328_3243.wav,1530,1625,-95
6654,b-1_3228-3328_3268.wav,VTTS_b-1_3228-3328_3268.wav,3570,4423,-853
6655,b-1_1010-1110_1031.wav,VTTS_b-1_1010-1110_1031.wav,3100,2740,360
6656,b-1_1414-1514_1512.wav,VTTS_b-1_1414-1514_1512.wav,1450,1405,45
6657,b-2_917-1018_988.wav,VTTS_b-2_917-1018_988.wav,2830,2659,171
6658,b-2_2311-2412_2413.wav,VTTS_b-2_2311-2412_2413.wav,770,836,-66
6659,b-4_2000-5164_4147.wav,VTTS_b-4_2000-5164_4147.wav,2934,2926,8
6660,b-4_2000-5164_4246.wav,VTTS_b-4_2000-5164_4246.wav,5448,9311,-3863
6661,b-4_301-400_364.wav,VTTS_b-4_301-400_364.wav,2390,2612,-222
6662,b-2_101-202_186.wav,VTTS_b-2_101-202_186.wav,3450,3564,-114
6663,b-3_3198-3278_3265.wav,VTTS_b-3_3198-3278_3265.wav,6550,6235,315
6664,b-4_1221-1300_1271.wav,VTTS_b-4_1221-1300_1271.wav,2900,2856,44
6665,b-3_6900-7016_6966.wav,VTTS_b-3_6900-7016_6966.wav,6170,6327,-157
6666,b-2_305-406_404.wav,VTTS_b-2_305-406_404.wav,2190,1730,460
6667,b-3_501-930_655.wav,VTTS_b-3_501-930_655.wav,9130,9044,86
6668,b-3_4498-4605_4574.wav,VTTS_b-3_4498-4605_4574.wav,3050,3251,-201
6669,b-4_2000-5164_3344.wav,VTTS_b-4_2000-5164_3344.wav,8370,8696,-326
6670,b-2_101-202_173.wav,VTTS_b-2_101-202_173.wav,1920,1904,16
6671,b-3_980-1077_1076.wav,VTTS_b-3_980-1077_1076.wav,3520,3135,385
6672,b-1_3834-3934_3891.wav,VTTS_b-1_3834-3934_3891.wav,1740,1753,-13
6673,b-4_2000-5164_3043.wav,VTTS_b-4_2000-5164_3043.wav,5108,4795,313
6674,b-3_1-97_96.wav,VTTS_b-3_1-97_96.wav,8490,8382,108
6675,b-3_5639-5744_5716.wav,VTTS_b-3_5639-5744_5716.wav,7530,7314,216
6676,b-3_6501-6600_6536.wav,VTTS_b-3_6501-6600_6536.wav,3700,3901,-201
6677,b-1_1919-2017_1948.wav,VTTS_b-1_1919-2017_1948.wav,1070,1103,-33
6678,b-3_1666-1763_1666.wav,VTTS_b-3_1666-1763_1666.wav,4230,4319,-89
6679,b-4_501-1014_1002.wav,VTTS_b-4_501-1014_1002.wav,4150,4272,-122
6680,b-4_2000-5164_2526.wav,VTTS_b-4_2000-5164_2526.wav,3900,3936,-36
6681,b-4_2000-5164_3331.wav,VTTS_b-4_2000-5164_3331.wav,5450,5178,272
6682,b-4_2000-5164_4619.wav,VTTS_b-4_2000-5164_4619.wav,1274,1173,101
6683,b-3_3198-3278_3217.wav,VTTS_b-3_3198-3278_3217.wav,4660,11610,-6950
6684,b-1_4286-4321_4316.wav,VTTS_b-1_4286-4321_4316.wav,3170,3448,-278
6685,b-3_196-293_218.wav,VTTS_b-3_196-293_218.wav,6490,6223,267
6686,b-3_5009-5427_5260.wav,VTTS_b-3_5009-5427_5260.wav,5710,5677,33
6687,b-4_2000-5164_2820.wav,VTTS_b-4_2000-5164_2820.wav,6000,6200,-200
6688,b-3_2434-2523_2441.wav,VTTS_b-3_2434-2523_2441.wav,5650,5573,77
6689,b-4_2000-5164_2757.wav,VTTS_b-4_2000-5164_2757.wav,4415,3936,479
6690,b-3_3198-3278_3226.wav,VTTS_b-3_3198-3278_3226.wav,4120,4075,45
6691,b-4_1101-1220_1106.wav,VTTS_b-4_1101-1220_1106.wav,5360,4760,600
6692,b-3_980-1077_982.wav,VTTS_b-3_980-1077_982.wav,4090,4191,-101
6693,b-4_2000-5164_2140.wav,VTTS_b-4_2000-5164_2140.wav,3925,7430,-3505
6694,b-3_6701-6800_6704.wav,VTTS_b-3_6701-6800_6704.wav,5410,5364,46
6695,b-2_407-508_415.wav,VTTS_b-2_407-508_415.wav,4130,3831,299
6696,b-3_1079-1320_1121.wav,VTTS_b-3_1079-1320_1121.wav,1780,1788,-8
6697,b-1_1212-1312_1302.wav,VTTS_b-1_1212-1312_1302.wav,2830,2798,32
6698,b-2_1121-1222_1186.wav,VTTS_b-2_1121-1222_1186.wav,1940,1614,326
6699,b-4_2000-5164_2806.wav,VTTS_b-4_2000-5164_2806.wav,4200,3994,206
6700,b-3_501-930_584.wav,VTTS_b-3_501-930_584.wav,5840,5306,534
6701,b-2_509-610_514.wav,VTTS_b-2_509-610_514.wav,4690,3843,847
6702,b-4_2000-5164_3803.wav,VTTS_b-4_2000-5164_3803.wav,3751,3634,117
6703,b-3_2524-2854_2751.wav,VTTS_b-3_2524-2854_2751.wav,9800,9625,175
6704,b-2_713-814_730.wav,VTTS_b-2_713-814_730.wav,1960,964,996
6705,b-4_401-500_407.wav,VTTS_b-4_401-500_407.wav,5470,5283,187
6706,b-1_1313-1413_1318.wav,VTTS_b-1_1313-1413_1318.wav,860,859,1
6707,b-1_478-578_576.wav,VTTS_b-1_478-578_576.wav,2200,1916,284
6708,b-3_1321-1568_1344.wav,VTTS_b-3_1321-1568_1344.wav,3860,3680,180
6709,b-2_1699-1800_1711.wav,VTTS_b-2_1699-1800_1711.wav,1780,1660,120
6710,b-4_1014-1100_1065.wav,VTTS_b-4_1014-1100_1065.wav,2720,2543,177
6711,b-1_2018-2118_2071.wav,VTTS_b-1_2018-2118_2071.wav,3250,2473,777
6712,b-3_1568-1665_1587.wav,VTTS_b-3_1568-1665_1587.wav,3640,3309,331
6713,b-2_1699-1800_1719.wav,VTTS_b-2_1699-1800_1719.wav,4320,4389,-69
6714,b-4_2000-5164_2869.wav,VTTS_b-4_2000-5164_2869.wav,5610,5805,-195
6715,b-4_2000-5164_3430.wav,VTTS_b-4_2000-5164_3430.wav,2836,2717,119
6716,b-4_2000-5164_3267.wav,VTTS_b-4_2000-5164_3267.wav,3512,3390,122
6717,b-2_305-406_318.wav,VTTS_b-2_305-406_318.wav,2540,2473,67
6718,b-3_931-979_956.wav,VTTS_b-3_931-979_956.wav,3810,3773,37
6719,b-3_5745-5852_5760.wav,VTTS_b-3_5745-5852_5760.wav,4130,3762,368
6720,b-3_5745-5852_5804.wav,VTTS_b-3_5745-5852_5804.wav,8640,8115,525
6721,b-1_74-174_95.wav,VTTS_b-1_74-174_95.wav,5760,4156,1604
6722,b-3_5533-5638_5621.wav,VTTS_b-3_5533-5638_5621.wav,1060,940,120
6723,b-3_5009-5427_5334.wav,VTTS_b-3_5009-5427_5334.wav,2950,2194,756
6724,b-3_1862-1959_1914.wav,VTTS_b-3_1862-1959_1914.wav,3210,3053,157
6725,b-4_1901-2000_1902.wav,VTTS_b-4_1901-2000_1902.wav,7890,6943,947
6726,b-3_2524-2854_2609.wav,VTTS_b-3_2524-2854_2609.wav,7940,7454,486
6727,b-3_5745-5852_5845.wav,VTTS_b-3_5745-5852_5845.wav,3390,3820,-430
6728,b-1_377-477_471.wav,VTTS_b-1_377-477_471.wav,1290,1811,-521
6729,b-3_4207-4314_4312.wav,VTTS_b-3_4207-4314_4312.wav,3280,3576,-296
6730,b-1_3026-3126_3031.wav,VTTS_b-1_3026-3126_3031.wav,1400,1219,181
6731,b-3_4001-4103_4105.wav,VTTS_b-3_4001-4103_4105.wav,6360,5666,694
6732,b-3_6801-6900_6835.wav,VTTS_b-3_6801-6900_6835.wav,7250,6153,1097
6733,b-3_5957-6015_5999.wav,VTTS_b-3_5957-6015_5999.wav,4120,2868,1252
6734,b-1_3632-3732_3636.wav,VTTS_b-1_3632-3732_3636.wav,1770,1800,-30
6735,b-4_2000-5164_4444.wav,VTTS_b-4_2000-5164_4444.wav,5565,5224,341
6736,b-2_305-406_361.wav,VTTS_b-2_305-406_361.wav,2430,2844,-414
6737,b-3_5009-5427_5148.wav,VTTS_b-3_5009-5427_5148.wav,5150,4911,239
6738,b-1_3834-3934_3890.wav,VTTS_b-1_3834-3934_3890.wav,2400,2450,-50
6739,b-3_1321-1568_1335.wav,VTTS_b-3_1321-1568_1335.wav,7690,7500,190
6740,b-2_713-814_718.wav,VTTS_b-2_713-814_718.wav,2940,2728,212
6741,b-1_3531-3631_3556.wav,VTTS_b-1_3531-3631_3556.wav,1140,1057,83
6742,b-4_2000-5164_4501.wav,VTTS_b-4_2000-5164_4501.wav,3133,3274,-141
6743,b-1_1313-1413_1343.wav,VTTS_b-1_1313-1413_1343.wav,3600,3216,384
6744,b-3_4001-4103_4023.wav,VTTS_b-3_4001-4103_4023.wav,4520,3680,840
6745,b-2_509-610_547.wav,VTTS_b-2_509-610_547.wav,1240,1602,-362
6746,b-1_3329-3429_3413.wav,VTTS_b-1_3329-3429_3413.wav,2030,2125,-95
6747,b-1_2119-2219_2144.wav,VTTS_b-1_2119-2219_2144.wav,3290,3367,-77
6748,b-3_3889-4000_3958.wav,VTTS_b-3_3889-4000_3958.wav,4060,4818,-758
6749,b-4_2000-5164_3961.wav,VTTS_b-4_2000-5164_3961.wav,2434,2485,-51
6750,b-4_2000-5164_3291.wav,VTTS_b-4_2000-5164_3291.wav,7830,7279,551
6751,b-3_980-1077_1027.wav,VTTS_b-3_980-1077_1027.wav,3600,3286,314
6752,b-4_2000-5164_2088.wav,VTTS_b-4_2000-5164_2088.wav,2920,3320,-400
6753,b-2_509-610_602.wav,VTTS_b-2_509-610_602.wav,4020,4087,-67
6754,b-3_3112-3197_3144.wav,VTTS_b-3_3112-3197_3144.wav,2050,1892,158
6755,b-1_1515-1615_1519.wav,VTTS_b-1_1515-1615_1519.wav,2490,2252,238
6756,b-1_2624-2724_2681.wav,VTTS_b-1_2624-2724_2681.wav,4400,6130,-1730
6757,b-4_2000-5164_5013.wav,VTTS_b-4_2000-5164_5013.wav,2250,2206,44
6758,b-1_1717-1817_1750.wav,VTTS_b-1_1717-1817_1750.wav,2060,1776,284
6759,b-4_2000-5164_3764.wav,VTTS_b-4_2000-5164_3764.wav,3720,3448,272
6760,b-3_392-500_456.wav,VTTS_b-3_392-500_456.wav,11600,11610,-10
6761,b-4_2000-5164_3875.wav,VTTS_b-4_2000-5164_3875.wav,3267,4307,-1040
6762,b-1_1-73_35.wav,VTTS_b-1_1-73_35.wav,1120,1149,-29
6763,b-4_2000-5164_4899.wav,VTTS_b-4_2000-5164_4899.wav,11680,10890,790
6764,b-1_3329-3429_3420.wav,VTTS_b-1_3329-3429_3420.wav,2740,2450,290
6765,b-4_501-1014_991.wav,VTTS_b-4_501-1014_991.wav,3850,4029,-179
6766,b-2_815-916_849.wav,VTTS_b-2_815-916_849.wav,1550,1683,-133
6767,b-1_3531-3631_3612.wav,VTTS_b-1_3531-3631_3612.wav,2640,2786,-146
6768,b-4_1401-1505_1471.wav,VTTS_b-4_1401-1505_1471.wav,6330,7721,-1391
6769,b-1_2725-2825_2785.wav,VTTS_b-1_2725-2825_2785.wav,5400,4737,663
6770,b-4_1301-1400_1376.wav,VTTS_b-4_1301-1400_1376.wav,5260,5248,12
6771,b-3_2524-2854_2827.wav,VTTS_b-3_2524-2854_2827.wav,2550,2531,19
6772,b-1_794-1009_920.wav,VTTS_b-1_794-1009_920.wav,1940,1846,94
6773,b-4_2000-5164_4257.wav,VTTS_b-4_2000-5164_4257.wav,3173,3878,-705
6774,b-4_2000-5164_4142.wav,VTTS_b-4_2000-5164_4142.wav,2631,2775,-144
6775,b-4_2000-5164_3569.wav,VTTS_b-4_2000-5164_3569.wav,8866,9125,-259
6776,b-3_5639-5744_5650.wav,VTTS_b-3_5639-5744_5650.wav,2110,2113,-3
6777,b-4_501-1014_943.wav,VTTS_b-4_501-1014_943.wav,2410,2415,-5
6778,b-4_1221-1300_1268.wav,VTTS_b-4_1221-1300_1268.wav,8520,8243,277
6779,b-1_1010-1110_1022.wav,VTTS_b-1_1010-1110_1022.wav,1900,1544,356
6780,b-2_1223-1324_1291.wav,VTTS_b-2_1223-1324_1291.wav,2410,2276,134
6781,b-2_1903-2038_2036.wav,VTTS_b-2_1903-2038_2036.wav,1450,1533,-83
6782,b-3_6601-6700_6698.wav,VTTS_b-3_6601-6700_6698.wav,5640,4946,694
6783,b-3_5009-5427_5426.wav,VTTS_b-3_5009-5427_5426.wav,6500,6467,33
6784,b-3_501-930_873.wav,VTTS_b-3_501-930_873.wav,8010,7976,34
6785,b-4_2000-5164_2246.wav,VTTS_b-4_2000-5164_2246.wav,1730,1660,70
6786,b-3_4607-5008_4679.wav,VTTS_b-3_4607-5008_4679.wav,5790,6130,-340
6787,b-3_6501-6600_6579.wav,VTTS_b-3_6501-6600_6579.wav,2090,2589,-499
6788,b-3_6217-6274_6219.wav,VTTS_b-3_6217-6274_6219.wav,4710,4667,43
6789,b-1_3329-3429_3402.wav,VTTS_b-1_3329-3429_3402.wav,3260,3053,207
6790,b-3_6601-6700_6658.wav,VTTS_b-3_6601-6700_6658.wav,2000,1997,3
6791,b-3_2524-2854_2781.wav,VTTS_b-3_2524-2854_2781.wav,5130,5213,-83
6792,b-4_2000-5164_4941.wav,VTTS_b-4_2000-5164_4941.wav,12830,11610,1220
6793,b-1_377-477_466.wav,VTTS_b-1_377-477_466.wav,1750,1753,-3
6794,b-4_1814-1900_1844.wav,VTTS_b-4_1814-1900_1844.wav,3150,3320,-170
6795,b-3_3112-3197_3118.wav,VTTS_b-3_3112-3197_3118.wav,3570,3413,157
6796,b-3_1-97_29.wav,VTTS_b-3_1-97_29.wav,3080,2879,201
6797,b-4_2000-5164_3636.wav,VTTS_b-4_2000-5164_3636.wav,7215,7663,-448
6798,b-3_3889-4000_3964.wav,VTTS_b-3_3889-4000_3964.wav,6810,6432,378
6799,b-1_4142-4177_4172.wav,VTTS_b-1_4142-4177_4172.wav,2190,2148,42
6800,b-1_1515-1615_1566.wav,VTTS_b-1_1515-1615_1566.wav,3750,3959,-209
6801,b-2_1-100_27.wav,VTTS_b-2_1-100_27.wav,3090,3947,-857
6802,b-3_5428-5533_5470.wav,VTTS_b-3_5428-5533_5470.wav,3380,2937,443
6803,b-2_305-406_386.wav,VTTS_b-2_305-406_386.wav,1430,1463,-33
6804,b-3_980-1077_1004.wav,VTTS_b-3_980-1077_1004.wav,4180,3994,186
6805,b-3_501-930_926.wav,VTTS_b-3_501-930_926.wav,5680,7407,-1727
6806,b-1_1717-1817_1785.wav,VTTS_b-1_1717-1817_1785.wav,1660,1707,-47
6807,b-3_1-97_91.wav,VTTS_b-3_1-97_91.wav,3600,3576,24
6808,b-4_2000-5164_3050.wav,VTTS_b-4_2000-5164_3050.wav,3794,3750,44
6809,b-2_2311-2412_2381.wav,VTTS_b-2_2311-2412_2381.wav,5350,4656,694
6810,b-1_3329-3429_3355.wav,VTTS_b-1_3329-3429_3355.wav,920,894,26
6811,b-2_815-916_900.wav,VTTS_b-2_815-916_900.wav,3900,4191,-291
6812,b-1_1717-1817_1749.wav,VTTS_b-1_1717-1817_1749.wav,2730,2589,141
6813,b-3_2000-2088_2078.wav,VTTS_b-3_2000-2088_2078.wav,6360,7082,-722
6814,b-4_501-1014_828.wav,VTTS_b-4_501-1014_828.wav,5180,5375,-195
6815,b-4_2000-5164_2496.wav,VTTS_b-4_2000-5164_2496.wav,8075,7918,157
6816,b-1_4034-4069_4054.wav,VTTS_b-1_4034-4069_4054.wav,1610,1788,-178
6817,b-3_4315-4424_4328.wav,VTTS_b-3_4315-4424_4328.wav,3740,3320,420
6818,b-2_2107-2193_2163.wav,VTTS_b-2_2107-2193_2163.wav,1540,1393,147
6819,b-2_1427-1562_1518.wav,VTTS_b-2_1427-1562_1518.wav,2830,2415,415
6820,b-3_4607-5008_4713.wav,VTTS_b-3_4607-5008_4713.wav,4930,4934,-4
6821,b-2_1699-1800_1773.wav,VTTS_b-2_1699-1800_1773.wav,3630,5584,-1954
6822,b-3_4607-5008_4929.wav,VTTS_b-3_4607-5008_4929.wav,6380,6827,-447
6823,b-3_4207-4314_4252.wav,VTTS_b-3_4207-4314_4252.wav,4560,4110,450
6824,b-3_6301-6400_6334.wav,VTTS_b-3_6301-6400_6334.wav,6170,6490,-320
6825,b-3_2267-2349_2320.wav,VTTS_b-3_2267-2349_2320.wav,5020,6409,-1389
6826,b-2_1699-1800_1736.wav,VTTS_b-2_1699-1800_1736.wav,4320,3587,733
6827,b-2_101-202_124.wav,VTTS_b-2_101-202_124.wav,2000,2380,-380
6828,b-4_2000-5164_4681.wav,VTTS_b-4_2000-5164_4681.wav,2871,2821,50
6829,b-3_196-293_260.wav,VTTS_b-3_196-293_260.wav,7180,6316,864
6830,b-3_4104-4206_4158.wav,VTTS_b-3_4104-4206_4158.wav,9020,9207,-187
6831,b-2_509-610_523.wav,VTTS_b-2_509-610_523.wav,2890,2949,-59
6832,b-4_1707-1813_1769.wav,VTTS_b-4_1707-1813_1769.wav,4890,4807,83
6833,b-3_6116-6215_6201.wav,VTTS_b-3_6116-6215_6201.wav,4400,4423,-23
6834,b-3_3025-3111_3098.wav,VTTS_b-3_3025-3111_3098.wav,4470,4296,174
6835,b-3_6701-6800_6789.wav,VTTS_b-3_6701-6800_6789.wav,9060,6200,2860
6836,b-3_6601-6700_6612.wav,VTTS_b-3_6601-6700_6612.wav,1630,1544,86
6837,b-1_3935-4033_4007.wav,VTTS_b-1_3935-4033_4007.wav,1220,1138,82
6838,b-3_4104-4206_4164.wav,VTTS_b-3_4104-4206_4164.wav,6930,7012,-82
6839,b-3_6501-6600_6522.wav,VTTS_b-3_6501-6600_6522.wav,1360,1382,-22
6840,b-1_3228-3328_3276.wav,VTTS_b-1_3228-3328_3276.wav,1940,1730,210
6841,b-4_2000-5164_2179.wav,VTTS_b-4_2000-5164_2179.wav,4475,4412,63
6842,b-2_1223-1324_1294.wav,VTTS_b-2_1223-1324_1294.wav,3610,11610,-8000
6843,b-1_175-275_214.wav,VTTS_b-1_175-275_214.wav,1270,1219,51
6844,b-4_501-1014_780.wav,VTTS_b-4_501-1014_780.wav,920,789,131
6845,b-3_2089-2176_2114.wav,VTTS_b-3_2089-2176_2114.wav,3370,2647,723
6846,b-1_1010-1110_1062.wav,VTTS_b-1_1010-1110_1062.wav,5230,4853,377
6847,b-4_2000-5164_3245.wav,VTTS_b-4_2000-5164_3245.wav,2753,2752,1
6848,b-4_2000-5164_3660.wav,VTTS_b-4_2000-5164_3660.wav,5644,5399,245
6849,b-1_4286-4321_4306.wav,VTTS_b-1_4286-4321_4306.wav,4410,4551,-141
6850,b-4_2000-5164_3633.wav,VTTS_b-4_2000-5164_3633.wav,6077,6722,-645
6851,b-3_5009-5427_5094.wav,VTTS_b-3_5009-5427_5094.wav,5090,4760,330
6852,b-3_1079-1320_1211.wav,VTTS_b-3_1079-1320_1211.wav,850,685,165
6853,b-1_4106-4141_4131.wav,VTTS_b-1_4106-4141_4131.wav,2720,2473,247
6854,b-2_2073-2106_2074.wav,VTTS_b-2_2073-2106_2074.wav,2270,2113,157
6855,b-1_4286-4321_4317.wav,VTTS_b-1_4286-4321_4317.wav,1630,1335,295
6856,b-4_2000-5164_3871.wav,VTTS_b-4_2000-5164_3871.wav,2315,2844,-529
6857,b-4_2000-5164_3915.wav,VTTS_b-4_2000-5164_3915.wav,16681,11610,5071
6858,b-4_2000-5164_2915.wav,VTTS_b-4_2000-5164_2915.wav,7538,6792,746
6859,b-4_2000-5164_2001.wav,VTTS_b-4_2000-5164_2001.wav,6570,8034,-1464
6860,b-1_3935-4033_4012.wav,VTTS_b-1_3935-4033_4012.wav,2650,2902,-252
6861,b-1_2422-2522_2446.wav,VTTS_b-1_2422-2522_2446.wav,1770,1707,63
6862,b-4_2000-5164_4835.wav,VTTS_b-4_2000-5164_4835.wav,5085,8115,-3030
6863,b-3_6601-6700_6661.wav,VTTS_b-3_6601-6700_6661.wav,4740,4737,3
6864,b-3_2000-2088_2010.wav,VTTS_b-3_2000-2088_2010.wav,4800,5004,-204
6865,b-3_5957-6015_5977.wav,VTTS_b-3_5957-6015_5977.wav,6140,6478,-338
6866,b-3_1960-2000_1989.wav,VTTS_b-3_1960-2000_1989.wav,3930,4679,-749
6867,b-1_1414-1514_1465.wav,VTTS_b-1_1414-1514_1465.wav,2830,2136,694
6868,b-1_3531-3631_3561.wav,VTTS_b-1_3531-3631_3561.wav,820,940,-120
6869,b-3_392-500_442.wav,VTTS_b-3_392-500_442.wav,10280,9834,446
6870,b-1_794-1009_868.wav,VTTS_b-1_794-1009_868.wav,1890,1602,288
6871,b-4_1506-1600_1585.wav,VTTS_b-4_1506-1600_1585.wav,5150,5851,-701
6872,b-3_1321-1568_1353.wav,VTTS_b-3_1321-1568_1353.wav,2030,1881,149
6873,b-3_3364-3453_3391.wav,VTTS_b-3_3364-3453_3391.wav,3660,3193,467
6874,b-1_2725-2825_2756.wav,VTTS_b-1_2725-2825_2756.wav,3460,4423,-963
6875,b-4_1601-1706_1661.wav,VTTS_b-4_1601-1706_1661.wav,7220,6653,567
6876,b-2_1903-2038_1912.wav,VTTS_b-2_1903-2038_1912.wav,2290,3170,-880
6877,b-4_2000-5164_3016.wav,VTTS_b-4_2000-5164_3016.wav,2450,2531,-81
6878,b-4_2000-5164_3379.wav,VTTS_b-4_2000-5164_3379.wav,3172,2902,270
6879,b-1_1212-1312_1216.wav,VTTS_b-1_1212-1312_1216.wav,2000,2136,-136
6880,b-1_3834-3934_3927.wav,VTTS_b-1_3834-3934_3927.wav,2530,2473,57
6881,b-1_3026-3126_3065.wav,VTTS_b-1_3026-3126_3065.wav,4160,4702,-542
6882,b-3_4498-4605_4551.wav,VTTS_b-3_4498-4605_4551.wav,3690,3460,230
6883,b-4_2000-5164_2815.wav,VTTS_b-4_2000-5164_2815.wav,5890,6060,-170
6884,b-2_1801-1902_1845.wav,VTTS_b-2_1801-1902_1845.wav,1870,1672,198
6885,b-3_4104-4206_4175.wav,VTTS_b-3_4104-4206_4175.wav,7030,6664,366
6886,b-3_2855-2942_2898.wav,VTTS_b-3_2855-2942_2898.wav,4110,3750,360
6887,b-4_1-52_23.wav,VTTS_b-4_1-52_23.wav,6060,5666,394
6888,b-3_501-930_535.wav,VTTS_b-3_501-930_535.wav,3750,3622,128
6889,b-2_305-406_311.wav,VTTS_b-2_305-406_311.wav,3660,3994,-334
6890,b-2_1801-1902_1832.wav,VTTS_b-2_1801-1902_1832.wav,5720,5979,-259
6891,b-3_4207-4314_4291.wav,VTTS_b-3_4207-4314_4291.wav,3210,3053,157
6892,b-4_501-1014_502.wav,VTTS_b-4_501-1014_502.wav,5720,6246,-526
6893,b-3_2267-2349_2300.wav,VTTS_b-3_2267-2349_2300.wav,6170,9520,-3350
6894,b-1_1919-2017_1998.wav,VTTS_b-1_1919-2017_1998.wav,2680,3878,-1198
6895,b-3_5009-5427_5416.wav,VTTS_b-3_5009-5427_5416.wav,3040,2949,91
6896,b-4_2000-5164_3816.wav,VTTS_b-4_2000-5164_3816.wav,3850,4690,-840
6897,b-2_1699-1800_1712.wav,VTTS_b-2_1699-1800_1712.wav,2540,2334,206
6898,b-3_2267-2349_2335.wav,VTTS_b-3_2267-2349_2335.wav,4530,4063,467
6899,b-4_1707-1813_1754.wav,VTTS_b-4_1707-1813_1754.wav,1190,1161,29
6900,b-3_2267-2349_2268.wav,VTTS_b-3_2267-2349_2268.wav,3760,11610,-7850
6901,b-1_1-73_65.wav,VTTS_b-1_1-73_65.wav,1460,1765,-305
6902,b-1_2018-2118_2038.wav,VTTS_b-1_2018-2118_2038.wav,2360,2229,131
6903,b-3_2000-2088_2054.wav,VTTS_b-3_2000-2088_2054.wav,9230,9300,-70
6904,b-2_407-508_464.wav,VTTS_b-2_407-508_464.wav,1500,1382,118
6905,b-3_6217-6274_6222.wav,VTTS_b-3_6217-6274_6222.wav,4880,4865,15
6906,b-4_501-1014_603.wav,VTTS_b-4_501-1014_603.wav,3700,3820,-120
6907,b-1_3329-3429_3419.wav,VTTS_b-1_3329-3429_3419.wav,2750,2403,347
6908,b-4_2000-5164_5110.wav,VTTS_b-4_2000-5164_5110.wav,3045,3529,-484
6909,b-4_2000-5164_3276.wav,VTTS_b-4_2000-5164_3276.wav,3803,3355,448
6910,b-3_501-930_680.wav,VTTS_b-3_501-930_680.wav,5510,5550,-40
6911,b-3_6900-7016_6920.wav,VTTS_b-3_6900-7016_6920.wav,6760,6502,258
6912,b-1_2725-2825_2769.wav,VTTS_b-1_2725-2825_2769.wav,2240,2670,-430
6913,b-3_501-930_749.wav,VTTS_b-3_501-930_749.wav,5730,5294,436
6914,b-1_1-73_40.wav,VTTS_b-1_1-73_40.wav,5380,5933,-553
6915,b-1_2725-2825_2777.wav,VTTS_b-1_2725-2825_2777.wav,3230,3529,-299
6916,b-4_2000-5164_2208.wav,VTTS_b-4_2000-5164_2208.wav,5350,5317,33
6917,b-2_713-814_733.wav,VTTS_b-2_713-814_733.wav,1590,1358,232
6918,b-4_2000-5164_4484.wav,VTTS_b-4_2000-5164_4484.wav,3639,3262,377
6919,b-4_2000-5164_2834.wav,VTTS_b-4_2000-5164_2834.wav,2840,2577,263
6920,b-4_1506-1600_1576.wav,VTTS_b-4_1506-1600_1576.wav,7350,8998,-1648
6921,b-3_5639-5744_5665.wav,VTTS_b-3_5639-5744_5665.wav,8490,9056,-566
6922,b-1_3834-3934_3848.wav,VTTS_b-1_3834-3934_3848.wav,3970,3843,127
6923,b-3_501-930_718.wav,VTTS_b-3_501-930_718.wav,5190,5608,-418
6924,b-3_4607-5008_4799.wav,VTTS_b-3_4607-5008_4799.wav,5080,5236,-156
6925,b-3_980-1077_990.wav,VTTS_b-3_980-1077_990.wav,2440,2426,14
6926,b-2_407-508_443.wav,VTTS_b-2_407-508_443.wav,2030,2577,-547
6927,b-3_501-930_832.wav,VTTS_b-3_501-930_832.wav,5410,5074,336
6928,b-3_2177-2266_2181.wav,VTTS_b-3_2177-2266_2181.wav,6810,6420,390
6929,b-4_2000-5164_4406.wav,VTTS_b-4_2000-5164_4406.wav,5100,7906,-2806
6930,b-4_501-1014_830.wav,VTTS_b-4_501-1014_830.wav,2660,2554,106
6931,b-1_276-376_294.wav,VTTS_b-1_276-376_294.wav,1030,1033,-3
6932,b-3_1568-1665_1641.wav,VTTS_b-3_1568-1665_1641.wav,5930,5050,880
6933,b-3_3454-3537_3477.wav,VTTS_b-3_3454-3537_3477.wav,7010,7709,-699
6934,b-1_276-376_362.wav,VTTS_b-1_276-376_362.wav,6070,4899,1171
6935,b-4_501-1014_652.wav,VTTS_b-4_501-1014_652.wav,5550,5027,523
6936,b-3_6401-6500_6495.wav,VTTS_b-3_6401-6500_6495.wav,3580,4598,-1018
6937,b-3_5009-5427_5049.wav,VTTS_b-3_5009-5427_5049.wav,5310,4795,515
6938,b-3_98-195_129.wav,VTTS_b-3_98-195_129.wav,4990,4389,601
6939,b-2_1019-1120_1055.wav,VTTS_b-2_1019-1120_1055.wav,5670,5433,237
6940,b-1_1010-1110_1017.wav,VTTS_b-1_1010-1110_1017.wav,3600,5468,-1868
6941,b-3_3112-3197_3177.wav,VTTS_b-3_3112-3197_3177.wav,3410,3286,124
6942,b-1_3834-3934_3920.wav,VTTS_b-1_3834-3934_3920.wav,2430,2299,131
6943,b-1_276-376_323.wav,VTTS_b-1_276-376_323.wav,4180,4307,-127
6944,b-4_501-1014_592.wav,VTTS_b-4_501-1014_592.wav,2830,2450,380
6945,b-4_2000-5164_3364.wav,VTTS_b-4_2000-5164_3364.wav,4810,4818,-8
6946,b-4_2000-5164_2893.wav,VTTS_b-4_2000-5164_2893.wav,4310,5294,-984
6947,b-1_3228-3328_3266.wav,VTTS_b-1_3228-3328_3266.wav,4760,5329,-569
6948,b-1_4106-4141_4135.wav,VTTS_b-1_4106-4141_4135.wav,2000,2020,-20
6949,b-2_1563-1596_1571.wav,VTTS_b-2_1563-1596_1571.wav,2220,1985,235
6950,b-4_2000-5164_2203.wav,VTTS_b-4_2000-5164_2203.wav,2580,2531,49
6951,b-1_3733-3833_3754.wav,VTTS_b-1_3733-3833_3754.wav,2570,2624,-54
6952,b-1_74-174_133.wav,VTTS_b-1_74-174_133.wav,1520,1602,-82
6953,b-4_2000-5164_2633.wav,VTTS_b-4_2000-5164_2633.wav,5560,5480,80
6954,b-4_2000-5164_2694.wav,VTTS_b-4_2000-5164_2694.wav,8595,9532,-937
6955,b-1_3834-3934_3840.wav,VTTS_b-1_3834-3934_3840.wav,2010,2067,-57
6956,b-4_501-1014_865.wav,VTTS_b-4_501-1014_865.wav,3740,3587,153
6957,b-4_501-1014_957.wav,VTTS_b-4_501-1014_957.wav,3890,2798,1092
6958,b-4_501-1014_621.wav,VTTS_b-4_501-1014_621.wav,9620,9369,251
6959,b-4_2000-5164_3843.wav,VTTS_b-4_2000-5164_3843.wav,7082,7221,-139
6960,b-1_2523-2623_2567.wav,VTTS_b-1_2523-2623_2567.wav,2000,2009,-9
6961,b-1_377-477_465.wav,VTTS_b-1_377-477_465.wav,2840,3065,-225
6962,b-2_611-712_704.wav,VTTS_b-2_611-712_704.wav,2820,1556,1264
6963,b-3_6501-6600_6586.wav,VTTS_b-3_6501-6600_6586.wav,2480,2136,344
6964,b-1_1-73_34.wav,VTTS_b-1_1-73_34.wav,1600,1591,9
6965,b-3_1079-1320_1092.wav,VTTS_b-3_1079-1320_1092.wav,5760,5677,83
6966,b-3_4207-4314_4228.wav,VTTS_b-3_4207-4314_4228.wav,9500,11157,-1657
6967,b-4_1707-1813_1744.wav,VTTS_b-4_1707-1813_1744.wav,8700,9253,-553
6968,b-4_2000-5164_2587.wav,VTTS_b-4_2000-5164_2587.wav,4380,5236,-856
6969,b-2_305-406_388.wav,VTTS_b-2_305-406_388.wav,2270,4168,-1898
6970,b-3_1-97_52.wav,VTTS_b-3_1-97_52.wav,4950,4760,190
6971,b-3_4607-5008_4675.wav,VTTS_b-3_4607-5008_4675.wav,5900,5608,292
6972,b-3_3364-3453_3374.wav,VTTS_b-3_3364-3453_3374.wav,3220,3135,85
6973,b-4_2000-5164_2549.wav,VTTS_b-4_2000-5164_2549.wav,1600,1265,335
6974,b-3_6116-6215_6149.wav,VTTS_b-3_6116-6215_6149.wav,1930,1881,49
6975,b-3_4207-4314_4310.wav,VTTS_b-3_4207-4314_4310.wav,3820,3564,256
6976,b-3_2000-2088_2068.wav,VTTS_b-3_2000-2088_2068.wav,3790,3866,-76
6977,b-1_1616-1716_1624.wav,VTTS_b-1_1616-1716_1624.wav,1940,2009,-69
6978,b-1_3026-3126_3095.wav,VTTS_b-1_3026-3126_3095.wav,1660,1579,81
6979,b-3_6501-6600_6544.wav,VTTS_b-3_6501-6600_6544.wav,8780,8394,386
6980,b-3_3025-3111_3105.wav,VTTS_b-3_3025-3111_3105.wav,6470,6211,259
6981,b-3_6401-6500_6419.wav,VTTS_b-3_6401-6500_6419.wav,5690,5294,396
6982,b-3_5533-5638_5542.wav,VTTS_b-3_5533-5638_5542.wav,8680,7964,716
6983,b-2_2040-2072_2063.wav,VTTS_b-2_2040-2072_2063.wav,1340,1440,-100
6984,b-3_392-500_493.wav,VTTS_b-3_392-500_493.wav,7130,7349,-219
6985,b-1_3935-4033_4016.wav,VTTS_b-1_3935-4033_4016.wav,4300,5677,-1377
6986,b-3_1321-1568_1347.wav,VTTS_b-3_1321-1568_1347.wav,9120,8266,854
6987,b-1_794-1009_886.wav,VTTS_b-1_794-1009_886.wav,3390,5433,-2043
6988,b-2_917-1018_968.wav,VTTS_b-2_917-1018_968.wav,4570,4458,112
6989,b-1_1-73_63.wav,VTTS_b-1_1-73_63.wav,2050,2194,-144
6990,b-3_1666-1763_1740.wav,VTTS_b-3_1666-1763_1740.wav,3680,3646,34
6991,b-3_6801-6900_6876.wav,VTTS_b-3_6801-6900_6876.wav,3560,3483,77
6992,b-3_5745-5852_5774.wav,VTTS_b-3_5745-5852_5774.wav,7640,7082,558
6993,b-1_3733-3833_3744.wav,VTTS_b-1_3733-3833_3744.wav,2550,2345,205
6994,b-1_3935-4033_4032.wav,VTTS_b-1_3935-4033_4032.wav,2220,2531,-311
6995,b-3_2267-2349_2288.wav,VTTS_b-3_2267-2349_2288.wav,10500,10403,97
6996,b-2_1019-1120_1062.wav,VTTS_b-2_1019-1120_1062.wav,4870,10855,-5985
6997,b-2_509-610_574.wav,VTTS_b-2_509-610_574.wav,2240,2310,-70
6998,b-3_4607-5008_4733.wav,VTTS_b-3_4607-5008_4733.wav,2910,3123,-213
6999,b-4_2000-5164_2052.wav,VTTS_b-4_2000-5164_2052.wav,2550,2508,42
7000,b-1_1616-1716_1634.wav,VTTS_b-1_1616-1716_1634.wav,1340,1347,-7
7001,b-4_501-1014_545.wav,VTTS_b-4_501-1014_545.wav,2320,2206,114
7002,b-4_2000-5164_4315.wav,VTTS_b-4_2000-5164_4315.wav,3519,11029,-7510
7003,b-3_6301-6400_6368.wav,VTTS_b-3_6301-6400_6368.wav,870,882,-12
7004,b-4_501-1014_802.wav,VTTS_b-4_501-1014_802.wav,5760,5840,-80
7005,b-1_276-376_334.wav,VTTS_b-1_276-376_334.wav,2410,2752,-342
7006,b-3_501-930_585.wav,VTTS_b-3_501-930_585.wav,5780,4272,1508
7007,b-4_2000-5164_4011.wav,VTTS_b-4_2000-5164_4011.wav,5622,5399,223
7008,b-3_2350-2433_2373.wav,VTTS_b-3_2350-2433_2373.wav,5190,6002,-812
7009,b-1_2119-2219_2126.wav,VTTS_b-1_2119-2219_2126.wav,3100,3042,58
7010,b-1_175-275_208.wav,VTTS_b-1_175-275_208.wav,1120,1115,5
7011,b-3_6701-6800_6715.wav,VTTS_b-3_6701-6800_6715.wav,5870,5016,854
7012,b-4_1101-1220_1134.wav,VTTS_b-4_1101-1220_1134.wav,7230,7094,136
7013,b-1_3430-3530_3495.wav,VTTS_b-1_3430-3530_3495.wav,1470,1474,-4
7014,b-2_917-1018_976.wav,VTTS_b-2_917-1018_976.wav,2370,3355,-985
7015,b-1_4070-4105_4102.wav,VTTS_b-1_4070-4105_4102.wav,3480,3936,-456
7016,b-1_3228-3328_3306.wav,VTTS_b-1_3228-3328_3306.wav,1800,2426,-626
7017,b-4_1707-1813_1742.wav,VTTS_b-4_1707-1813_1742.wav,4550,5259,-709
7018,b-3_1862-1959_1931.wav,VTTS_b-3_1862-1959_1931.wav,7360,6467,893
7019,b-2_509-610_592.wav,VTTS_b-2_509-610_592.wav,3890,2705,1185
7020,b-2_1-100_76.wav,VTTS_b-2_1-100_76.wav,1800,2171,-371
7021,b-4_2000-5164_3797.wav,VTTS_b-4_2000-5164_3797.wav,6830,7152,-322
7022,b-4_2000-5164_3673.wav,VTTS_b-4_2000-5164_3673.wav,5067,4725,342
7023,b-2_713-814_766.wav,VTTS_b-2_713-814_766.wav,4320,3088,1232
7024,b-1_1919-2017_1944.wav,VTTS_b-1_1919-2017_1944.wav,2190,2705,-515
7025,b-4_151-300_197.wav,VTTS_b-4_151-300_197.wav,6540,6049,491
7026,b-4_401-500_411.wav,VTTS_b-4_401-500_411.wav,8240,8208,32
7027,b-3_2089-2176_2163.wav,VTTS_b-3_2089-2176_2163.wav,5790,5933,-143
7028,b-3_6016-6115_6042.wav,VTTS_b-3_6016-6115_6042.wav,4160,3471,689
7029,b-2_2107-2193_2115.wav,VTTS_b-2_2107-2193_2115.wav,1610,1277,333
7030,b-4_2000-5164_4445.wav,VTTS_b-4_2000-5164_4445.wav,4255,4574,-319
7031,b-4_1707-1813_1749.wav,VTTS_b-4_1707-1813_1749.wav,7680,7546,134
7032,b-3_6501-6600_6529.wav,VTTS_b-3_6501-6600_6529.wav,2990,3170,-180
7033,b-2_713-814_741.wav,VTTS_b-2_713-814_741.wav,3000,2879,121
7034,b-3_6401-6500_6489.wav,VTTS_b-3_6401-6500_6489.wav,12510,11610,900
7035,b-4_2000-5164_2584.wav,VTTS_b-4_2000-5164_2584.wav,4760,11610,-6850
7036,b-3_2350-2433_2391.wav,VTTS_b-3_2350-2433_2391.wav,7830,7732,98
7037,b-3_501-930_883.wav,VTTS_b-3_501-930_883.wav,2350,2624,-274
7038,b-1_2725-2825_2807.wav,VTTS_b-1_2725-2825_2807.wav,1460,1416,44
7039,b-3_5009-5427_5206.wav,VTTS_b-3_5009-5427_5206.wav,4860,4876,-16
7040,b-3_5957-6015_5997.wav,VTTS_b-3_5957-6015_5997.wav,4860,4423,437
7041,b-1_794-1009_850.wav,VTTS_b-1_794-1009_850.wav,3030,2961,69
7042,b-1_2927-3025_2963.wav,VTTS_b-1_2927-3025_2963.wav,2520,2368,152
7043,b-1_74-174_90.wav,VTTS_b-1_74-174_90.wav,1700,1800,-100
7044,b-1_794-1009_857.wav,VTTS_b-1_794-1009_857.wav,1870,1567,303
7045,b-1_1010-1110_1047.wav,VTTS_b-1_1010-1110_1047.wav,2570,2159,411
7046,b-3_3364-3453_3434.wav,VTTS_b-3_3364-3453_3434.wav,4660,4296,364
7047,b-4_2000-5164_3366.wav,VTTS_b-4_2000-5164_3366.wav,6735,6687,48
7048,b-1_3329-3429_3422.wav,VTTS_b-1_3329-3429_3422.wav,4700,8173,-3473
7049,b-1_3834-3934_3878.wav,VTTS_b-1_3834-3934_3878.wav,1220,1115,105
7050,b-4_1301-1400_1371.wav,VTTS_b-4_1301-1400_1371.wav,3160,3367,-207
7051,b-2_1019-1120_1023.wav,VTTS_b-2_1019-1120_1023.wav,2040,2218,-178
7052,b-1_3228-3328_3252.wav,VTTS_b-1_3228-3328_3252.wav,4670,4493,177
7053,b-4_2000-5164_4269.wav,VTTS_b-4_2000-5164_4269.wav,5395,5747,-352
7054,b-3_3715-3802_3754.wav,VTTS_b-3_3715-3802_3754.wav,7960,7616,344
7055,b-1_3531-3631_3546.wav,VTTS_b-1_3531-3631_3546.wav,920,998,-78
7056,b-2_713-814_720.wav,VTTS_b-2_713-814_720.wav,4690,5991,-1301
7057,b-1_3026-3126_3108.wav,VTTS_b-1_3026-3126_3108.wav,3360,2647,713
7058,b-4_1601-1706_1638.wav,VTTS_b-4_1601-1706_1638.wav,5560,5283,277
7059,b-1_794-1009_891.wav,VTTS_b-1_794-1009_891.wav,1220,1207,13
7060,b-1_1414-1514_1445.wav,VTTS_b-1_1414-1514_1445.wav,1460,2148,-688
7061,b-3_4607-5008_4729.wav,VTTS_b-3_4607-5008_4729.wav,3400,3286,114
7062,b-3_1764-1861_1860.wav,VTTS_b-3_1764-1861_1860.wav,3710,3971,-261
7063,b-4_2000-5164_4713.wav,VTTS_b-4_2000-5164_4713.wav,4863,4284,579
7064,b-3_5639-5744_5644.wav,VTTS_b-3_5639-5744_5644.wav,6000,7338,-1338
7065,b-3_501-930_708.wav,VTTS_b-3_501-930_708.wav,2350,2334,16
7066,b-2_917-1018_981.wav,VTTS_b-2_917-1018_981.wav,4030,8545,-4515
7067,b-2_1699-1800_1772.wav,VTTS_b-2_1699-1800_1772.wav,1660,1393,267
7068,b-4_2000-5164_2491.wav,VTTS_b-4_2000-5164_2491.wav,1485,1556,-71
7069,b-1_4142-4177_4177.wav,VTTS_b-1_4142-4177_4177.wav,2570,2763,-193
7070,b-1_2927-3025_3022.wav,VTTS_b-1_2927-3025_3022.wav,1620,1556,64
7071,b-3_1862-1959_1950.wav,VTTS_b-3_1862-1959_1950.wav,3920,3738,182
7072,b-3_2089-2176_2092.wav,VTTS_b-3_2089-2176_2092.wav,6810,7605,-795
7073,b-4_53-150_107.wav,VTTS_b-4_53-150_107.wav,9390,8766,624
7074,b-3_2524-2854_2815.wav,VTTS_b-3_2524-2854_2815.wav,4430,4005,425
7075,b-3_4607-5008_4643.wav,VTTS_b-3_4607-5008_4643.wav,7930,8139,-209
7076,b-1_650-685_661.wav,VTTS_b-1_650-685_661.wav,2010,1776,234
7077,b-2_305-406_395.wav,VTTS_b-2_305-406_395.wav,3650,4075,-425
7078,b-2_1121-1222_1222.wav,VTTS_b-2_1121-1222_1222.wav,7390,7651,-261
7079,b-3_3889-4000_3988.wav,VTTS_b-3_3889-4000_3988.wav,3930,4969,-1039
7080,b-4_1-52_40.wav,VTTS_b-4_1-52_40.wav,8110,6966,1144
7081,b-4_301-400_302.wav,VTTS_b-4_301-400_302.wav,7780,7105,675
7082,b-4_2000-5164_2999.wav,VTTS_b-4_2000-5164_2999.wav,4911,6002,-1091
7083,b-3_6501-6600_6587.wav,VTTS_b-3_6501-6600_6587.wav,4840,4005,835
7084,b-1_686-793_738.wav,VTTS_b-1_686-793_738.wav,2360,2334,26
7085,b-1_1717-1817_1744.wav,VTTS_b-1_1717-1817_1744.wav,7010,5770,1240
7086,b-4_53-150_71.wav,VTTS_b-4_53-150_71.wav,7870,6931,939
7087,b-4_2000-5164_2198.wav,VTTS_b-4_2000-5164_2198.wav,10640,11610,-970
7088,b-4_2000-5164_3579.wav,VTTS_b-4_2000-5164_3579.wav,4660,5329,-669
7089,b-3_1079-1320_1275.wav,VTTS_b-3_1079-1320_1275.wav,9870,11610,-1740
7090,b-3_4104-4206_4116.wav,VTTS_b-3_4104-4206_4116.wav,7250,10426,-3176
7091,b-3_3715-3802_3719.wav,VTTS_b-3_3715-3802_3719.wav,4820,5062,-242
7092,b-1_2422-2522_2510.wav,VTTS_b-1_2422-2522_2510.wav,960,998,-38
7093,b-2_101-202_185.wav,VTTS_b-2_101-202_185.wav,1800,1765,35
7094,b-2_203-304_272.wav,VTTS_b-2_203-304_272.wav,2760,3111,-351
7095,b-3_1079-1320_1251.wav,VTTS_b-3_1079-1320_1251.wav,2720,2554,166
7096,b-4_501-1014_843.wav,VTTS_b-4_501-1014_843.wav,12260,10844,1416
7097,b-4_1014-1100_1061.wav,VTTS_b-4_1014-1100_1061.wav,6550,6896,-346
7098,b-4_301-400_306.wav,VTTS_b-4_301-400_306.wav,5940,5201,739
7099,b-3_3198-3278_3274.wav,VTTS_b-3_3198-3278_3274.wav,7150,6954,196
7100,b-4_2000-5164_3556.wav,VTTS_b-4_2000-5164_3556.wav,1830,1695,135
7101,b-1_4466-4498_4482.wav,VTTS_b-1_4466-4498_4482.wav,3960,4493,-533
7102,b-3_6016-6115_6056.wav,VTTS_b-3_6016-6115_6056.wav,3830,3750,80
7103,b-3_1321-1568_1398.wav,VTTS_b-3_1321-1568_1398.wav,6700,8626,-1926
7104,b-1_3026-3126_3067.wav,VTTS_b-1_3026-3126_3067.wav,4950,5329,-379
7105,b-3_2089-2176_2135.wav,VTTS_b-3_2089-2176_2135.wav,2680,2914,-234
7106,b-3_3112-3197_3194.wav,VTTS_b-3_3112-3197_3194.wav,5540,6792,-1252
7107,b-1_3026-3126_3083.wav,VTTS_b-1_3026-3126_3083.wav,5180,5248,-68
7108,b-2_203-304_300.wav,VTTS_b-2_203-304_300.wav,3400,3553,-153
7109,b-4_2000-5164_4383.wav,VTTS_b-4_2000-5164_4383.wav,7249,7686,-437
7110,b-4_1-52_30.wav,VTTS_b-4_1-52_30.wav,5860,4795,1065
7111,b-4_2000-5164_2658.wav,VTTS_b-4_2000-5164_2658.wav,2520,2183,337
7112,b-1_2927-3025_2978.wav,VTTS_b-1_2927-3025_2978.wav,1390,1358,32
7113,b-1_3632-3732_3635.wav,VTTS_b-1_3632-3732_3635.wav,1080,1138,-58
7114,b-4_2000-5164_3665.wav,VTTS_b-4_2000-5164_3665.wav,2370,2252,118
7115,b-3_1079-1320_1105.wav,VTTS_b-3_1079-1320_1105.wav,2580,2264,316
7116,b-3_2524-2854_2838.wav,VTTS_b-3_2524-2854_2838.wav,8640,11610,-2970
7117,b-2_1223-1324_1224.wav,VTTS_b-2_1223-1324_1224.wav,7330,7477,-147
7118,b-2_1325-1426_1367.wav,VTTS_b-2_1325-1426_1367.wav,1830,1602,228
7119,b-3_5009-5427_5020.wav,VTTS_b-3_5009-5427_5020.wav,10840,9660,1180
7120,b-4_2000-5164_3578.wav,VTTS_b-4_2000-5164_3578.wav,2932,3564,-632
7121,b-3_3198-3278_3243.wav,VTTS_b-3_3198-3278_3243.wav,7910,9636,-1726
7122,b-2_611-712_645.wav,VTTS_b-2_611-712_645.wav,2530,2879,-349
7123,b-1_3834-3934_3899.wav,VTTS_b-1_3834-3934_3899.wav,3680,4528,-848
7124,b-2_2073-2106_2100.wav,VTTS_b-2_2073-2106_2100.wav,1090,1161,-71
7125,b-4_2000-5164_3690.wav,VTTS_b-4_2000-5164_3690.wav,7523,8510,-987
7126,b-3_2524-2854_2591.wav,VTTS_b-3_2524-2854_2591.wav,4330,4470,-140
7127,b-2_407-508_430.wav,VTTS_b-2_407-508_430.wav,1120,1138,-18
7128,b-4_2000-5164_3447.wav,VTTS_b-4_2000-5164_3447.wav,2116,2287,-171
7129,b-2_1223-1324_1243.wav,VTTS_b-2_1223-1324_1243.wav,4130,5039,-909
7130,b-1_2119-2219_2131.wav,VTTS_b-1_2119-2219_2131.wav,950,1010,-60
7131,b-3_4104-4206_4147.wav,VTTS_b-3_4104-4206_4147.wav,8170,7140,1030
7132,b-2_1427-1562_1507.wav,VTTS_b-2_1427-1562_1507.wav,4530,6188,-1658
7133,b-4_1601-1706_1623.wav,VTTS_b-4_1601-1706_1623.wav,3580,3750,-170
7134,b-1_3531-3631_3531.wav,VTTS_b-1_3531-3631_3531.wav,990,987,3
7135,b-2_2311-2412_2346.wav,VTTS_b-2_2311-2412_2346.wav,4030,5596,-1566
7136,b-1_175-275_250.wav,VTTS_b-1_175-275_250.wav,1220,1486,-266
7137,b-3_4207-4314_4239.wav,VTTS_b-3_4207-4314_4239.wav,5070,4737,333
7138,b-1_1919-2017_2015.wav,VTTS_b-1_1919-2017_2015.wav,2630,2403,227
7139,b-4_2000-5164_3469.wav,VTTS_b-4_2000-5164_3469.wav,4823,5039,-216
7140,b-3_3112-3197_3178.wav,VTTS_b-3_3112-3197_3178.wav,3660,3773,-113
7141,b-3_6301-6400_6352.wav,VTTS_b-3_6301-6400_6352.wav,3970,4005,-35
7142,b-4_301-400_301.wav,VTTS_b-4_301-400_301.wav,1600,1509,91
7143,b-3_1321-1568_1518.wav,VTTS_b-3_1321-1568_1518.wav,6700,6165,535
7144,b-1_3228-3328_3229.wav,VTTS_b-1_3228-3328_3229.wav,2910,2752,158
7145,b-1_3430-3530_3496.wav,VTTS_b-1_3430-3530_3496.wav,2270,2334,-64
7146,b-4_2000-5164_2242.wav,VTTS_b-4_2000-5164_2242.wav,1330,1149,181
7147,b-3_1960-2000_1987.wav,VTTS_b-3_1960-2000_1987.wav,4340,4725,-385
7148,b-4_2000-5164_3995.wav,VTTS_b-4_2000-5164_3995.wav,5371,4934,437
7149,b-2_2209-2310_2273.wav,VTTS_b-2_2209-2310_2273.wav,2930,2833,97
7150,b-4_2000-5164_2925.wav,VTTS_b-4_2000-5164_2925.wav,8876,7964,912
7151,b-2_2413-2500_2490.wav,VTTS_b-2_2413-2500_2490.wav,1460,1498,-38
7152,b-3_1321-1568_1447.wav,VTTS_b-3_1321-1568_1447.wav,9160,8742,418
7153,b-2_305-406_387.wav,VTTS_b-2_305-406_387.wav,1640,1730,-90
7154,b-3_501-930_540.wav,VTTS_b-3_501-930_540.wav,6200,5886,314
7155,b-1_2826-2926_2850.wav,VTTS_b-1_2826-2926_2850.wav,2020,2043,-23
7156,b-3_3025-3111_3109.wav,VTTS_b-3_3025-3111_3109.wav,10260,10275,-15
7157,b-1_2624-2724_2678.wav,VTTS_b-1_2624-2724_2678.wav,1610,1614,-4
7158,b-1_3430-3530_3512.wav,VTTS_b-1_3430-3530_3512.wav,4730,5387,-657
7159,b-3_4315-4424_4398.wav,VTTS_b-3_4315-4424_4398.wav,7920,9207,-1287
7160,b-3_2524-2854_2611.wav,VTTS_b-3_2524-2854_2611.wav,3630,4516,-886
7161,b-4_2000-5164_2266.wav,VTTS_b-4_2000-5164_2266.wav,12380,11610,770
7162,b-1_1010-1110_1039.wav,VTTS_b-1_1010-1110_1039.wav,3260,2566,694
7163,b-4_2000-5164_2237.wav,VTTS_b-4_2000-5164_2237.wav,4020,4180,-160
7164,b-3_6301-6400_6385.wav,VTTS_b-3_6301-6400_6385.wav,8090,6269,1821
7165,b-1_3834-3934_3906.wav,VTTS_b-1_3834-3934_3906.wav,6130,6606,-476
7166,b-3_5745-5852_5825.wav,VTTS_b-3_5745-5852_5825.wav,5320,5074,246
7167,b-3_4001-4103_4040.wav,VTTS_b-3_4001-4103_4040.wav,2920,3019,-99
7168,b-4_151-300_155.wav,VTTS_b-4_151-300_155.wav,4550,4087,463
7169,b-4_2000-5164_4310.wav,VTTS_b-4_2000-5164_4310.wav,2487,2995,-508
7170,b-3_5745-5852_5767.wav,VTTS_b-3_5745-5852_5767.wav,2980,2879,101
7171,b-4_2000-5164_3834.wav,VTTS_b-4_2000-5164_3834.wav,5946,6931,-985
7172,b-3_4607-5008_4982.wav,VTTS_b-3_4607-5008_4982.wav,4590,4052,538
7173,b-2_1597-1698_1608.wav,VTTS_b-2_1597-1698_1608.wav,3020,3204,-184
7174,b-3_6016-6115_6064.wav,VTTS_b-3_6016-6115_6064.wav,2630,2473,157
7175,b-2_1597-1698_1651.wav,VTTS_b-2_1597-1698_1651.wav,4660,5503,-843
7176,b-1_4322-4357_4335.wav,VTTS_b-1_4322-4357_4335.wav,3730,5166,-1436
7177,b-4_2000-5164_3168.wav,VTTS_b-4_2000-5164_3168.wav,6051,6072,-21
7178,b-2_815-916_917.wav,VTTS_b-2_815-916_917.wav,3340,4191,-851
7179,b-1_478-578_486.wav,VTTS_b-1_478-578_486.wav,4110,3808,302
7180,b-1_2119-2219_2174.wav,VTTS_b-1_2119-2219_2174.wav,2270,2043,227
7181,b-1_3228-3328_3265.wav,VTTS_b-1_3228-3328_3265.wav,5480,6258,-778
7182,b-4_1014-1100_1069.wav,VTTS_b-4_1014-1100_1069.wav,2380,3030,-650
7183,b-1_276-376_360.wav,VTTS_b-1_276-376_360.wav,2210,3204,-994
7184,b-4_2000-5164_3212.wav,VTTS_b-4_2000-5164_3212.wav,3980,3982,-2
7185,b-3_980-1077_1057.wav,VTTS_b-3_980-1077_1057.wav,4900,4168,732
7186,b-1_4394-4429_4416.wav,VTTS_b-1_4394-4429_4416.wav,1470,2101,-631
7187,b-3_3364-3453_3416.wav,VTTS_b-3_3364-3453_3416.wav,4870,5004,-134
7188,b-3_6401-6500_6430.wav,VTTS_b-3_6401-6500_6430.wav,3880,4435,-555
7189,b-2_1427-1562_1468.wav,VTTS_b-2_1427-1562_1468.wav,2300,2334,-34
7190,b-3_2089-2176_2133.wav,VTTS_b-3_2089-2176_2133.wav,5850,6745,-895
7191,b-1_1414-1514_1517.wav,VTTS_b-1_1414-1514_1517.wav,2490,2136,354
7192,b-3_2434-2523_2436.wav,VTTS_b-3_2434-2523_2436.wav,5290,5259,31
7193,b-4_2000-5164_2717.wav,VTTS_b-4_2000-5164_2717.wav,2000,1800,200
7194,b-1_4214-4285_4256.wav,VTTS_b-1_4214-4285_4256.wav,1940,1846,94
7195,b-3_1666-1763_1716.wav,VTTS_b-3_1666-1763_1716.wav,2780,2786,-6
7196,b-3_501-930_894.wav,VTTS_b-3_501-930_894.wav,7790,8545,-755
7197,b-4_2000-5164_2352.wav,VTTS_b-4_2000-5164_2352.wav,4640,4447,193
7198,b-4_1601-1706_1668.wav,VTTS_b-4_1601-1706_1668.wav,2060,2009,51
7199,b-3_4207-4314_4240.wav,VTTS_b-3_4207-4314_4240.wav,6530,5445,1085
7200,b-1_1515-1615_1562.wav,VTTS_b-1_1515-1615_1562.wav,4420,4772,-352
7201,b-2_1903-2038_1985.wav,VTTS_b-2_1903-2038_1985.wav,2760,3262,-502
7202,b-4_2000-5164_2829.wav,VTTS_b-4_2000-5164_2829.wav,6285,6629,-344
7203,b-3_1321-1568_1361.wav,VTTS_b-3_1321-1568_1361.wav,3550,3669,-119
7204,b-4_1707-1813_1804.wav,VTTS_b-4_1707-1813_1804.wav,7940,8069,-129
7205,b-4_501-1014_892.wav,VTTS_b-4_501-1014_892.wav,3320,2810,510
7206,b-3_5009-5427_5116.wav,VTTS_b-3_5009-5427_5116.wav,5300,5201,99
7207,b-3_4425-4497_4432.wav,VTTS_b-3_4425-4497_4432.wav,3420,2798,622
7208,b-2_2311-2412_2334.wav,VTTS_b-2_2311-2412_2334.wav,2790,3100,-310
7209,b-3_501-930_567.wav,VTTS_b-3_501-930_567.wav,3150,2763,387
7210,b-4_2000-5164_5078.wav,VTTS_b-4_2000-5164_5078.wav,8646,8173,473
7211,b-1_4322-4357_4332.wav,VTTS_b-1_4322-4357_4332.wav,3640,4690,-1050
7212,b-4_2000-5164_2768.wav,VTTS_b-4_2000-5164_2768.wav,2010,1950,60
7213,b-2_1597-1698_1621.wav,VTTS_b-2_1597-1698_1621.wav,2030,1823,207
7214,b-4_2000-5164_3775.wav,VTTS_b-4_2000-5164_3775.wav,6400,6269,131
7215,b-4_1401-1505_1430.wav,VTTS_b-4_1401-1505_1430.wav,1600,1602,-2
7216,b-3_6900-7016_6975.wav,VTTS_b-3_6900-7016_6975.wav,5830,5642,188
7217,b-4_2000-5164_3613.wav,VTTS_b-4_2000-5164_3613.wav,8271,7883,388
7218,b-2_1903-2038_2021.wav,VTTS_b-2_1903-2038_2021.wav,2830,3901,-1071
7219,b-3_196-293_270.wav,VTTS_b-3_196-293_270.wav,4830,4598,232
7220,b-1_1515-1615_1518.wav,VTTS_b-1_1515-1615_1518.wav,2080,1811,269
7221,b-1_1616-1716_1695.wav,VTTS_b-1_1616-1716_1695.wav,3150,3355,-205
7222,b-3_4104-4206_4196.wav,VTTS_b-3_4104-4206_4196.wav,2190,2148,42
7223,b-2_1427-1562_1463.wav,VTTS_b-2_1427-1562_1463.wav,2610,2810,-200
7224,b-1_3632-3732_3719.wav,VTTS_b-1_3632-3732_3719.wav,3590,4180,-590
7225,b-4_1401-1505_1460.wav,VTTS_b-4_1401-1505_1460.wav,5950,5317,633
7226,b-3_2524-2854_2662.wav,VTTS_b-3_2524-2854_2662.wav,5910,5840,70
7227,b-3_1321-1568_1560.wav,VTTS_b-3_1321-1568_1560.wav,2890,2856,34
7228,b-1_3430-3530_3484.wav,VTTS_b-1_3430-3530_3484.wav,1500,1451,49
7229,b-3_196-293_202.wav,VTTS_b-3_196-293_202.wav,4820,4168,652
7230,b-1_3531-3631_3622.wav,VTTS_b-1_3531-3631_3622.wav,2440,2403,37
7231,b-3_501-930_768.wav,VTTS_b-3_501-930_768.wav,6620,6281,339
7232,b-4_2000-5164_4121.wav,VTTS_b-4_2000-5164_4121.wav,8541,7686,855
7233,b-4_1221-1300_1247.wav,VTTS_b-4_1221-1300_1247.wav,5360,4876,484
7234,b-3_2177-2266_2216.wav,VTTS_b-3_2177-2266_2216.wav,7120,7407,-287
7235,b-3_501-930_619.wav,VTTS_b-3_501-930_619.wav,2950,3007,-57
7236,b-3_6401-6500_6453.wav,VTTS_b-3_6401-6500_6453.wav,4000,3831,169
7237,b-4_53-150_100.wav,VTTS_b-4_53-150_100.wav,9240,9218,22
7238,b-3_6401-6500_6437.wav,VTTS_b-3_6401-6500_6437.wav,3770,3564,206
7239,b-3_6301-6400_6333.wav,VTTS_b-3_6301-6400_6333.wav,2170,1753,417
7240,b-1_2321-2421_2351.wav,VTTS_b-1_2321-2421_2351.wav,4440,3947,493
7241,b-1_2624-2724_2712.wav,VTTS_b-1_2624-2724_2712.wav,1850,1881,-31
7242,b-1_3733-3833_3796.wav,VTTS_b-1_3733-3833_3796.wav,3350,3866,-516
7243,b-4_2000-5164_3001.wav,VTTS_b-4_2000-5164_3001.wav,2929,3158,-229
7244,b-1_1717-1817_1725.wav,VTTS_b-1_1717-1817_1725.wav,2300,2670,-370
7245,b-1_2927-3025_3018.wav,VTTS_b-1_2927-3025_3018.wav,3700,3831,-131
7246,b-4_2000-5164_4238.wav,VTTS_b-4_2000-5164_4238.wav,5201,5004,197
7247,b-1_74-174_91.wav,VTTS_b-1_74-174_91.wav,2730,4052,-1322
7248,b-3_4498-4605_4595.wav,VTTS_b-3_4498-4605_4595.wav,2710,3878,-1168
7249,b-4_2000-5164_2560.wav,VTTS_b-4_2000-5164_2560.wav,2740,2961,-221
7250,b-1_3834-3934_3854.wav,VTTS_b-1_3834-3934_3854.wav,3000,2624,376
7251,b-4_151-300_249.wav,VTTS_b-4_151-300_249.wav,1280,975,305
7252,b-2_917-1018_969.wav,VTTS_b-2_917-1018_969.wav,3920,3936,-16
7253,b-3_3364-3453_3380.wav,VTTS_b-3_3364-3453_3380.wav,5360,5492,-132
7254,b-3_6801-6900_6818.wav,VTTS_b-3_6801-6900_6818.wav,2360,2101,259
7255,b-4_2000-5164_3358.wav,VTTS_b-4_2000-5164_3358.wav,5978,5399,579
7256,b-2_611-712_616.wav,VTTS_b-2_611-712_616.wav,3110,3448,-338
7257,b-4_1101-1220_1186.wav,VTTS_b-4_1101-1220_1186.wav,7330,7175,155
7258,b-3_1764-1861_1810.wav,VTTS_b-3_1764-1861_1810.wav,2880,2833,47
7259,b-2_1597-1698_1693.wav,VTTS_b-2_1597-1698_1693.wav,1830,1602,228
7260,b-3_3628-3714_3632.wav,VTTS_b-3_3628-3714_3632.wav,5110,5445,-335
7261,b-1_1111-1211_1120.wav,VTTS_b-1_1111-1211_1120.wav,1530,1811,-281
7262,b-3_501-930_811.wav,VTTS_b-3_501-930_811.wav,1760,1823,-63
7263,b-1_3329-3429_3351.wav,VTTS_b-1_3329-3429_3351.wav,1600,1567,33
7264,b-3_4607-5008_4752.wav,VTTS_b-3_4607-5008_4752.wav,3790,3831,-41
7265,b-3_4607-5008_4730.wav,VTTS_b-3_4607-5008_4730.wav,3910,3808,102
7266,b-1_1616-1716_1660.wav,VTTS_b-1_1616-1716_1660.wav,1790,1683,107
7267,b-3_6601-6700_6641.wav,VTTS_b-3_6601-6700_6641.wav,5180,5190,-10
7268,b-1_377-477_450.wav,VTTS_b-1_377-477_450.wav,1340,1231,109
7269,b-1_2321-2421_2384.wav,VTTS_b-1_2321-2421_2384.wav,3330,3390,-60
7270,b-4_2000-5164_4002.wav,VTTS_b-4_2000-5164_4002.wav,1904,1765,139
7271,b-3_4607-5008_4940.wav,VTTS_b-3_4607-5008_4940.wav,3070,3262,-192
7272,b-1_3329-3429_3354.wav,VTTS_b-1_3329-3429_3354.wav,3800,3878,-78
7273,b-3_5009-5427_5022.wav,VTTS_b-3_5009-5427_5022.wav,4150,5236,-1086
7274,b-4_301-400_393.wav,VTTS_b-4_301-400_393.wav,9600,8858,742
7275,b-4_2000-5164_3399.wav,VTTS_b-4_2000-5164_3399.wav,2850,2043,807
7276,b-3_5009-5427_5248.wav,VTTS_b-3_5009-5427_5248.wav,6120,5387,733
7277,b-4_151-300_153.wav,VTTS_b-4_151-300_153.wav,2720,2821,-101
7278,b-2_509-610_581.wav,VTTS_b-2_509-610_581.wav,2430,3042,-612
7279,b-3_98-195_140.wav,VTTS_b-3_98-195_140.wav,4910,4377,533
7280,b-1_3531-3631_3539.wav,VTTS_b-1_3531-3631_3539.wav,2110,2090,20
7281,b-1_4178-4213_4210.wav,VTTS_b-1_4178-4213_4210.wav,1060,1057,3
7282,b-4_2000-5164_2765.wav,VTTS_b-4_2000-5164_2765.wav,10060,10379,-319
7283,b-1_2725-2825_2779.wav,VTTS_b-1_2725-2825_2779.wav,2850,3239,-389
7284,b-1_4142-4177_4152.wav,VTTS_b-1_4142-4177_4152.wav,1970,1950,20
7285,b-4_1014-1100_1036.wav,VTTS_b-4_1014-1100_1036.wav,1960,1741,219
7286,b-3_196-293_230.wav,VTTS_b-3_196-293_230.wav,2970,2856,114
7287,b-3_6301-6400_6323.wav,VTTS_b-3_6301-6400_6323.wav,6920,7674,-754
7288,b-3_6016-6115_6018.wav,VTTS_b-3_6016-6115_6018.wav,2610,2403,207
7289,b-4_501-1014_587.wav,VTTS_b-4_501-1014_587.wav,9490,9404,86
7290,b-2_1223-1324_1286.wav,VTTS_b-2_1223-1324_1286.wav,5620,4180,1440
7291,b-4_501-1014_947.wav,VTTS_b-4_501-1014_947.wav,4620,5782,-1162
7292,b-1_3733-3833_3748.wav,VTTS_b-1_3733-3833_3748.wav,2570,3947,-1377
7293,b-4_2000-5164_2859.wav,VTTS_b-4_2000-5164_2859.wav,7050,6629,421
7294,b-4_1101-1220_1109.wav,VTTS_b-4_1101-1220_1109.wav,10420,9567,853
7295,b-2_611-712_630.wav,VTTS_b-2_611-712_630.wav,3420,3123,297
7296,b-3_5853-5956_5880.wav,VTTS_b-3_5853-5956_5880.wav,13370,11610,1760
7297,b-3_3025-3111_3099.wav,VTTS_b-3_3025-3111_3099.wav,3310,3228,82
7298,b-1_1212-1312_1297.wav,VTTS_b-1_1212-1312_1297.wav,3180,2786,394
7299,b-3_5009-5427_5345.wav,VTTS_b-3_5009-5427_5345.wav,4020,4052,-32
7300,b-2_1903-2038_2022.wav,VTTS_b-2_1903-2038_2022.wav,4840,5735,-895
7301,b-4_1601-1706_1697.wav,VTTS_b-4_1601-1706_1697.wav,3410,3413,-3
7302,b-4_2000-5164_2885.wav,VTTS_b-4_2000-5164_2885.wav,7800,7697,103
7303,b-4_1014-1100_1060.wav,VTTS_b-4_1014-1100_1060.wav,6380,5956,424
7304,b-1_579-649_622.wav,VTTS_b-1_579-649_622.wav,1630,1602,28
7305,b-4_1-52_39.wav,VTTS_b-4_1-52_39.wav,8060,7721,339
7306,b-3_3025-3111_3067.wav,VTTS_b-3_3025-3111_3067.wav,3230,3065,165
7307,b-1_1-73_53.wav,VTTS_b-1_1-73_53.wav,1610,1428,182
7308,b-1_2018-2118_2027.wav,VTTS_b-1_2018-2118_2027.wav,5050,4331,719
7309,b-4_501-1014_611.wav,VTTS_b-4_501-1014_611.wav,1520,1382,138
7310,b-1_794-1009_990.wav,VTTS_b-1_794-1009_990.wav,2210,1997,213
7311,b-3_5009-5427_5237.wav,VTTS_b-3_5009-5427_5237.wav,4140,4063,77
7312,b-4_2000-5164_3414.wav,VTTS_b-4_2000-5164_3414.wav,3080,3692,-612
7313,b-1_276-376_283.wav,VTTS_b-1_276-376_283.wav,1870,1869,1
7314,b-1_1313-1413_1353.wav,VTTS_b-1_1313-1413_1353.wav,2010,1962,48
7315,b-3_6016-6115_6106.wav,VTTS_b-3_6016-6115_6106.wav,1160,1161,-1
7316,b-2_101-202_161.wav,VTTS_b-2_101-202_161.wav,1550,1765,-215
7317,b-1_2220-2320_2271.wav,VTTS_b-1_2220-2320_2271.wav,1460,1683,-223
7318,b-3_6116-6215_6142.wav,VTTS_b-3_6116-6215_6142.wav,6420,6432,-12
7319,b-3_4104-4206_4142.wav,VTTS_b-3_4104-4206_4142.wav,4400,4133,267
7320,b-4_501-1014_952.wav,VTTS_b-4_501-1014_952.wav,3830,4389,-559
7321,b-4_2000-5164_4490.wav,VTTS_b-4_2000-5164_4490.wav,3629,3924,-295
7322,b-2_2107-2193_2150.wav,VTTS_b-2_2107-2193_2150.wav,1660,1579,81
7323,b-4_2000-5164_4174.wav,VTTS_b-4_2000-5164_4174.wav,2347,2194,153
7324,b-3_2524-2854_2713.wav,VTTS_b-3_2524-2854_2713.wav,4060,3982,78
7325,b-4_301-400_335.wav,VTTS_b-4_301-400_335.wav,1460,1300,160
7326,b-3_5533-5638_5543.wav,VTTS_b-3_5533-5638_5543.wav,3580,3599,-19
7327,b-4_2000-5164_3552.wav,VTTS_b-4_2000-5164_3552.wav,3490,3425,65
7328,b-3_2089-2176_2139.wav,VTTS_b-3_2089-2176_2139.wav,2810,2775,35
7329,b-3_1079-1320_1231.wav,VTTS_b-3_1079-1320_1231.wav,7830,7581,249
7330,b-3_2177-2266_2258.wav,VTTS_b-3_2177-2266_2258.wav,6390,6246,144
7331,b-3_4104-4206_4161.wav,VTTS_b-3_4104-4206_4161.wav,6870,6664,206
7332,b-4_53-150_70.wav,VTTS_b-4_53-150_70.wav,7880,8290,-410
7333,b-1_3430-3530_3469.wav,VTTS_b-1_3430-3530_3469.wav,1800,2647,-847
7334,b-1_794-1009_936.wav,VTTS_b-1_794-1009_936.wav,2670,2995,-325
7335,b-3_6801-6900_6847.wav,VTTS_b-3_6801-6900_6847.wav,2010,2810,-800
7336,b-3_3889-4000_3931.wav,VTTS_b-3_3889-4000_3931.wav,3830,3831,-1
7337,b-1_3531-3631_3548.wav,VTTS_b-1_3531-3631_3548.wav,2050,2241,-191
7338,b-3_5009-5427_5130.wav,VTTS_b-3_5009-5427_5130.wav,6880,7651,-771
7339,b-4_501-1014_647.wav,VTTS_b-4_501-1014_647.wav,6480,5422,1058
7340,b-3_1666-1763_1751.wav,VTTS_b-3_1666-1763_1751.wav,2400,2682,-282
7341,b-1_1212-1312_1224.wav,VTTS_b-1_1212-1312_1224.wav,5740,11610,-5870
7342,b-4_2000-5164_2024.wav,VTTS_b-4_2000-5164_2024.wav,4165,3924,241
7343,b-2_1699-1800_1746.wav,VTTS_b-2_1699-1800_1746.wav,1210,1138,72
7344,b-3_2524-2854_2745.wav,VTTS_b-3_2524-2854_2745.wav,4540,4702,-162
7345,b-3_3628-3714_3638.wav,VTTS_b-3_3628-3714_3638.wav,2100,2136,-36
7346,b-3_5009-5427_5369.wav,VTTS_b-3_5009-5427_5369.wav,4950,5039,-89
7347,b-3_6401-6500_6424.wav,VTTS_b-3_6401-6500_6424.wav,4020,3878,142
7348,b-3_2434-2523_2438.wav,VTTS_b-3_2434-2523_2438.wav,3960,3332,628
7349,b-3_98-195_189.wav,VTTS_b-3_98-195_189.wav,6220,6432,-212
7350,b-3_501-930_645.wav,VTTS_b-3_501-930_645.wav,6630,5805,825
7351,b-3_3025-3111_3081.wav,VTTS_b-3_3025-3111_3081.wav,2470,2264,206
7352,b-3_6401-6500_6460.wav,VTTS_b-3_6401-6500_6460.wav,3210,2961,249
7353,b-4_401-500_481.wav,VTTS_b-4_401-500_481.wav,4390,4029,361
7354,b-3_98-195_159.wav,VTTS_b-3_98-195_159.wav,2830,2972,-142
7355,b-4_401-500_452.wav,VTTS_b-4_401-500_452.wav,4040,5538,-1498
7356,b-4_53-150_74.wav,VTTS_b-4_53-150_74.wav,10610,9276,1334
7357,b-1_3228-3328_3307.wav,VTTS_b-1_3228-3328_3307.wav,1370,1358,12
7358,b-4_2000-5164_4217.wav,VTTS_b-4_2000-5164_4217.wav,3864,4017,-153
7359,b-1_175-275_272.wav,VTTS_b-1_175-275_272.wav,2080,2728,-648
7360,b-4_2000-5164_4956.wav,VTTS_b-4_2000-5164_4956.wav,1877,1788,89
7361,b-1_2523-2623_2584.wav,VTTS_b-1_2523-2623_2584.wav,1330,1207,123
7362,b-2_713-814_736.wav,VTTS_b-2_713-814_736.wav,7220,7233,-13
7363,b-2_1223-1324_1302.wav,VTTS_b-2_1223-1324_1302.wav,6590,7999,-1409
7364,b-3_501-930_750.wav,VTTS_b-3_501-930_750.wav,3210,3135,75
7365,b-4_2000-5164_4563.wav,VTTS_b-4_2000-5164_4563.wav,2945,4412,-1467
7366,b-3_5639-5744_5707.wav,VTTS_b-3_5639-5744_5707.wav,2710,2508,202
7367,b-3_5853-5956_5915.wav,VTTS_b-3_5853-5956_5915.wav,5190,4748,442
7368,b-3_6900-7016_6943.wav,VTTS_b-3_6900-7016_6943.wav,3300,3344,-44
7369,b-3_2089-2176_2141.wav,VTTS_b-3_2089-2176_2141.wav,3640,3216,424
7370,b-2_305-406_365.wav,VTTS_b-2_305-406_365.wav,1670,1834,-164
7371,b-2_611-712_629.wav,VTTS_b-2_611-712_629.wav,1360,1312,48
7372,b-1_175-275_273.wav,VTTS_b-1_175-275_273.wav,1470,1428,42
7373,b-3_2177-2266_2229.wav,VTTS_b-3_2177-2266_2229.wav,4780,4400,380
7374,b-2_917-1018_937.wav,VTTS_b-2_917-1018_937.wav,2740,3030,-290
7375,b-1_794-1009_938.wav,VTTS_b-1_794-1009_938.wav,3410,4319,-909
7376,b-3_5639-5744_5682.wav,VTTS_b-3_5639-5744_5682.wav,6640,7256,-616
7377,b-1_1010-1110_1021.wav,VTTS_b-1_1010-1110_1021.wav,1100,964,136
7378,b-2_2040-2072_2071.wav,VTTS_b-2_2040-2072_2071.wav,1290,1347,-57
7379,b-4_1014-1100_1082.wav,VTTS_b-4_1014-1100_1082.wav,5670,4748,922
7380,b-4_2000-5164_2042.wav,VTTS_b-4_2000-5164_2042.wav,7815,9392,-1577
7381,b-3_2089-2176_2169.wav,VTTS_b-3_2089-2176_2169.wav,5510,5259,251
7382,b-4_1014-1100_1085.wav,VTTS_b-4_1014-1100_1085.wav,2540,2543,-3
7383,b-1_1010-1110_1049.wav,VTTS_b-1_1010-1110_1049.wav,3410,3262,148
7384,b-4_1301-1400_1355.wav,VTTS_b-4_1301-1400_1355.wav,9980,10588,-608
7385,b-1_2220-2320_2276.wav,VTTS_b-1_2220-2320_2276.wav,1540,1567,-27
7386,b-3_98-195_112.wav,VTTS_b-3_98-195_112.wav,10810,11610,-800
7387,b-3_5009-5427_5028.wav,VTTS_b-3_5009-5427_5028.wav,3260,3216,44
7388,b-3_3628-3714_3664.wav,VTTS_b-3_3628-3714_3664.wav,4070,3901,169
7389,b-4_501-1014_990.wav,VTTS_b-4_501-1014_990.wav,3190,11610,-8420
7390,b-2_611-712_682.wav,VTTS_b-2_611-712_682.wav,1520,1509,11
7391,b-1_3935-4033_3990.wav,VTTS_b-1_3935-4033_3990.wav,3120,2821,299
7392,b-3_1321-1568_1408.wav,VTTS_b-3_1321-1568_1408.wav,9190,10426,-1236
7393,b-4_501-1014_513.wav,VTTS_b-4_501-1014_513.wav,2740,3437,-697
7394,b-1_2826-2926_2908.wav,VTTS_b-1_2826-2926_2908.wav,5180,4690,490
7395,b-2_1597-1698_1647.wav,VTTS_b-2_1597-1698_1647.wav,2010,1962,48
7396,b-3_2434-2523_2463.wav,VTTS_b-3_2434-2523_2463.wav,4290,3936,354
7397,b-3_3112-3197_3165.wav,VTTS_b-3_3112-3197_3165.wav,3520,3135,385
7398,b-4_2000-5164_4970.wav,VTTS_b-4_2000-5164_4970.wav,5056,4725,331
7399,b-1_3834-3934_3919.wav,VTTS_b-1_3834-3934_3919.wav,1750,1823,-73
7400,b-4_1506-1600_1507.wav,VTTS_b-4_1506-1600_1507.wav,5000,6142,-1142
7401,b-4_2000-5164_4640.wav,VTTS_b-4_2000-5164_4640.wav,6145,6107,38
7402,b-3_3112-3197_3173.wav,VTTS_b-3_3112-3197_3173.wav,9930,11204,-1274
7403,b-4_401-500_494.wav,VTTS_b-4_401-500_494.wav,2780,2844,-64
7404,b-3_1862-1959_1882.wav,VTTS_b-3_1862-1959_1882.wav,5300,6246,-946
7405,b-4_1506-1600_1527.wav,VTTS_b-4_1506-1600_1527.wav,1620,1498,122
7406,b-1_686-793_688.wav,VTTS_b-1_686-793_688.wav,900,720,180
7407,b-3_5009-5427_5168.wav,VTTS_b-3_5009-5427_5168.wav,3680,3913,-233
7408,b-1_175-275_271.wav,VTTS_b-1_175-275_271.wav,1970,1974,-4
7409,b-1_794-1009_872.wav,VTTS_b-1_794-1009_872.wav,1820,1579,241
7410,b-3_1666-1763_1738.wav,VTTS_b-3_1666-1763_1738.wav,5160,4714,446
7411,b-4_1-52_32.wav,VTTS_b-4_1-52_32.wav,7320,6281,1039
7412,b-1_2321-2421_2388.wav,VTTS_b-1_2321-2421_2388.wav,1390,1416,-26
7413,b-3_501-930_741.wav,VTTS_b-3_501-930_741.wav,6270,6908,-638
7414,b-1_1414-1514_1469.wav,VTTS_b-1_1414-1514_1469.wav,1300,1219,81
7415,b-4_2000-5164_3534.wav,VTTS_b-4_2000-5164_3534.wav,3177,3077,100
7416,b-3_4607-5008_4867.wav,VTTS_b-3_4607-5008_4867.wav,6600,6873,-273
7417,b-4_1221-1300_1259.wav,VTTS_b-4_1221-1300_1259.wav,4160,3379,781
7418,b-1_1919-2017_1967.wav,VTTS_b-1_1919-2017_1967.wav,4200,3402,798
7419,b-1_377-477_473.wav,VTTS_b-1_377-477_473.wav,2330,2299,31
7420,b-3_2524-2854_2650.wav,VTTS_b-3_2524-2854_2650.wav,3570,3216,354
7421,b-2_2209-2310_2257.wav,VTTS_b-2_2209-2310_2257.wav,1520,1579,-59
7422,b-4_2000-5164_4009.wav,VTTS_b-4_2000-5164_4009.wav,7352,7558,-206
7423,b-4_2000-5164_3536.wav,VTTS_b-4_2000-5164_3536.wav,1726,1591,135
7424,b-1_74-174_134.wav,VTTS_b-1_74-174_134.wav,2510,2287,223
7425,b-4_501-1014_700.wav,VTTS_b-4_501-1014_700.wav,2510,2357,153
7426,b-3_6217-6274_6242.wav,VTTS_b-3_6217-6274_6242.wav,3930,3843,87
7427,b-3_5428-5533_5527.wav,VTTS_b-3_5428-5533_5527.wav,8090,8638,-548
7428,b-1_1212-1312_1285.wav,VTTS_b-1_1212-1312_1285.wav,2440,2252,188
7429,b-4_2000-5164_5076.wav,VTTS_b-4_2000-5164_5076.wav,3318,2926,392
7430,b-2_2107-2193_2114.wav,VTTS_b-2_2107-2193_2114.wav,2030,2032,-2
7431,b-2_1699-1800_1796.wav,VTTS_b-2_1699-1800_1796.wav,1930,2937,-1007
7432,b-4_2000-5164_2383.wav,VTTS_b-4_2000-5164_2383.wav,1540,1370,170
7433,b-3_4498-4605_4558.wav,VTTS_b-3_4498-4605_4558.wav,7500,6966,534
7434,b-2_305-406_345.wav,VTTS_b-2_305-406_345.wav,1510,1358,152
7435,b-2_2073-2106_2073.wav,VTTS_b-2_2073-2106_2073.wav,1440,1800,-360
7436,b-4_1101-1220_1182.wav,VTTS_b-4_1101-1220_1182.wav,2100,1788,312
7437,b-2_1903-2038_1905.wav,VTTS_b-2_1903-2038_1905.wav,2390,1892,498
7438,b-4_1601-1706_1637.wav,VTTS_b-4_1601-1706_1637.wav,2190,1718,472
7439,b-4_2000-5164_4965.wav,VTTS_b-4_2000-5164_4965.wav,5669,5770,-101
7440,b-2_1121-1222_1126.wav,VTTS_b-2_1121-1222_1126.wav,1470,1962,-492
7441,b-3_931-979_960.wav,VTTS_b-3_931-979_960.wav,4560,5468,-908
7442,b-2_1325-1426_1406.wav,VTTS_b-2_1325-1426_1406.wav,1340,1358,-18
7443,b-1_3531-3631_3586.wav,VTTS_b-1_3531-3631_3586.wav,3060,2752,308
7444,b-1_2826-2926_2868.wav,VTTS_b-1_2826-2926_2868.wav,1640,1741,-101
7445,b-2_2209-2310_2239.wav,VTTS_b-2_2209-2310_2239.wav,1290,1161,129
7446,b-4_151-300_233.wav,VTTS_b-4_151-300_233.wav,1820,1521,299
7447,b-3_4001-4103_4078.wav,VTTS_b-3_4001-4103_4078.wav,1870,1846,24
7448,b-4_2000-5164_3151.wav,VTTS_b-4_2000-5164_3151.wav,6762,6873,-111
7449,b-4_2000-5164_4555.wav,VTTS_b-4_2000-5164_4555.wav,1723,1823,-100
7450,b-3_3538-3627_3607.wav,VTTS_b-3_3538-3627_3607.wav,5050,5166,-116
7451,b-2_917-1018_951.wav,VTTS_b-2_917-1018_951.wav,1890,2113,-223
7452,b-1_3531-3631_3631.wav,VTTS_b-1_3531-3631_3631.wav,1720,2055,-335
7453,b-2_1-100_17.wav,VTTS_b-2_1-100_17.wav,1290,1451,-161
7454,b-3_2177-2266_2198.wav,VTTS_b-3_2177-2266_2198.wav,3410,3994,-584
7455,b-4_2000-5164_4168.wav,VTTS_b-4_2000-5164_4168.wav,2821,4145,-1324
7456,b-4_301-400_336.wav,VTTS_b-4_301-400_336.wav,4950,4830,120
7457,b-3_2267-2349_2336.wav,VTTS_b-3_2267-2349_2336.wav,5000,5004,-4
7458,b-3_6801-6900_6855.wav,VTTS_b-3_6801-6900_6855.wav,2790,2612,178
7459,b-3_2350-2433_2383.wav,VTTS_b-3_2350-2433_2383.wav,4990,4528,462
7460,b-1_4142-4177_4163.wav,VTTS_b-1_4142-4177_4163.wav,2920,3564,-644
7461,b-4_501-1014_691.wav,VTTS_b-4_501-1014_691.wav,1600,1428,172
7462,b-3_294-391_352.wav,VTTS_b-3_294-391_352.wav,3670,3704,-34
7463,b-1_794-1009_818.wav,VTTS_b-1_794-1009_818.wav,2790,2868,-78
7464,b-1_2422-2522_2474.wav,VTTS_b-1_2422-2522_2474.wav,960,1057,-97
7465,b-1_276-376_338.wav,VTTS_b-1_276-376_338.wav,1380,1324,56
7466,b-2_1427-1562_1488.wav,VTTS_b-2_1427-1562_1488.wav,1390,1370,20
7467,b-1_3127-3227_3172.wav,VTTS_b-1_3127-3227_3172.wav,3130,3518,-388
7468,b-2_2311-2412_2343.wav,VTTS_b-2_2311-2412_2343.wav,2340,2752,-412
7469,b-1_2725-2825_2798.wav,VTTS_b-1_2725-2825_2798.wav,4290,4029,261
7470,b-3_2000-2088_2034.wav,VTTS_b-3_2000-2088_2034.wav,4040,3146,894
7471,b-1_4394-4429_4410.wav,VTTS_b-1_4394-4429_4410.wav,2490,2415,75
7472,b-4_2000-5164_2788.wav,VTTS_b-4_2000-5164_2788.wav,2810,2078,732
7473,b-1_3228-3328_3288.wav,VTTS_b-1_3228-3328_3288.wav,5600,5480,120
7474,b-4_2000-5164_2133.wav,VTTS_b-4_2000-5164_2133.wav,6890,7430,-540
7475,b-3_98-195_104.wav,VTTS_b-3_98-195_104.wav,5890,8510,-2620
7476,b-2_2413-2500_2461.wav,VTTS_b-2_2413-2500_2461.wav,2130,1579,551
7477,b-1_1-73_11.wav,VTTS_b-1_1-73_11.wav,2590,2856,-266
7478,b-2_1427-1562_1446.wav,VTTS_b-2_1427-1562_1446.wav,4710,4586,124
7479,b-2_713-814_780.wav,VTTS_b-2_713-814_780.wav,1370,1463,-93
7480,b-1_2422-2522_2490.wav,VTTS_b-1_2422-2522_2490.wav,5360,4969,391
7481,b-3_2943-3024_2991.wav,VTTS_b-3_2943-3024_2991.wav,5440,5457,-17
7482,b-1_2927-3025_2987.wav,VTTS_b-1_2927-3025_2987.wav,5500,5166,334
7483,b-2_1223-1324_1256.wav,VTTS_b-2_1223-1324_1256.wav,4910,4075,835
7484,b-4_1401-1505_1468.wav,VTTS_b-4_1401-1505_1468.wav,10220,9404,816
7485,b-3_5533-5638_5565.wav,VTTS_b-3_5533-5638_5565.wav,6500,6153,347
7486,b-3_2350-2433_2394.wav,VTTS_b-3_2350-2433_2394.wav,9620,8324,1296
7487,b-3_3803-3888_3881.wav,VTTS_b-3_3803-3888_3881.wav,5080,4946,134
7488,b-2_1223-1324_1261.wav,VTTS_b-2_1223-1324_1261.wav,7990,9056,-1066
7489,b-3_4315-4424_4340.wav,VTTS_b-3_4315-4424_4340.wav,3270,3251,19
7490,b-4_53-150_98.wav,VTTS_b-4_53-150_98.wav,10130,8231,1899
7491,b-2_509-610_534.wav,VTTS_b-2_509-610_534.wav,4540,3692,848
7492,b-3_2855-2942_2903.wav,VTTS_b-3_2855-2942_2903.wav,2880,2926,-46
7493,b-3_2524-2854_2741.wav,VTTS_b-3_2524-2854_2741.wav,8020,8568,-548
7494,b-4_2000-5164_2456.wav,VTTS_b-4_2000-5164_2456.wav,2490,3158,-668
7495,b-1_1313-1413_1324.wav,VTTS_b-1_1313-1413_1324.wav,2380,2194,186
7496,b-4_2000-5164_4738.wav,VTTS_b-4_2000-5164_4738.wav,4771,4679,92
7497,b-1_4106-4141_4125.wav,VTTS_b-1_4106-4141_4125.wav,1050,1080,-30
7498,b-1_4466-4498_4493.wav,VTTS_b-1_4466-4498_4493.wav,1990,2148,-158
7499,b-3_501-930_559.wav,VTTS_b-3_501-930_559.wav,6630,5863,767
7500,b-3_2089-2176_2121.wav,VTTS_b-3_2089-2176_2121.wav,2440,2717,-277
7501,b-4_2000-5164_2276.wav,VTTS_b-4_2000-5164_2276.wav,6140,8998,-2858
7502,b-4_2000-5164_4010.wav,VTTS_b-4_2000-5164_4010.wav,4044,4284,-240
7503,b-3_98-195_161.wav,VTTS_b-3_98-195_161.wav,5060,5909,-849
7504,b-3_1079-1320_1142.wav,VTTS_b-3_1079-1320_1142.wav,6680,6896,-216
7505,b-1_1818-1918_1845.wav,VTTS_b-1_1818-1918_1845.wav,3280,5375,-2095
7506,b-3_4607-5008_4935.wav,VTTS_b-3_4607-5008_4935.wav,3210,3274,-64
7507,b-3_2177-2266_2263.wav,VTTS_b-3_2177-2266_2263.wav,5470,4807,663
7508,b-4_2000-5164_4326.wav,VTTS_b-4_2000-5164_4326.wav,3575,3077,498
7509,b-4_1301-1400_1390.wav,VTTS_b-4_1301-1400_1390.wav,2470,2879,-409
7510,b-3_2855-2942_2857.wav,VTTS_b-3_2855-2942_2857.wav,6220,8208,-1988
7511,b-1_3127-3227_3208.wav,VTTS_b-1_3127-3227_3208.wav,5630,5805,-175
7512,b-1_377-477_413.wav,VTTS_b-1_377-477_413.wav,2720,2879,-159
7513,b-1_2018-2118_2057.wav,VTTS_b-1_2018-2118_2057.wav,2110,1950,160
7514,b-3_294-391_358.wav,VTTS_b-3_294-391_358.wav,7300,7477,-177
7515,b-1_4322-4357_4341.wav,VTTS_b-1_4322-4357_4341.wav,5020,5631,-611
7516,b-1_1717-1817_1793.wav,VTTS_b-1_1717-1817_1793.wav,2280,1997,283
7517,b-3_6217-6274_6246.wav,VTTS_b-3_6217-6274_6246.wav,3230,3204,26
7518,b-3_4607-5008_4977.wav,VTTS_b-3_4607-5008_4977.wav,3520,4203,-683
7519,b-4_2000-5164_2008.wav,VTTS_b-4_2000-5164_2008.wav,9981,11610,-1629
7520,b-4_1101-1220_1203.wav,VTTS_b-4_1101-1220_1203.wav,3830,3889,-59
7521,b-3_294-391_314.wav,VTTS_b-3_294-391_314.wav,4820,4876,-56
7522,b-3_6116-6215_6124.wav,VTTS_b-3_6116-6215_6124.wav,4020,3831,189
7523,b-4_2000-5164_4312.wav,VTTS_b-4_2000-5164_4312.wav,2261,2159,102
7524,b-2_1903-2038_1969.wav,VTTS_b-2_1903-2038_1969.wav,1360,1405,-45
7525,b-4_2000-5164_2577.wav,VTTS_b-4_2000-5164_2577.wav,4950,4574,376
7526,b-4_2000-5164_2356.wav,VTTS_b-4_2000-5164_2356.wav,6000,5608,392
7527,b-3_4607-5008_4850.wav,VTTS_b-3_4607-5008_4850.wav,2050,1997,53
7528,b-2_2311-2412_2322.wav,VTTS_b-2_2311-2412_2322.wav,1670,1788,-118
7529,b-3_5009-5427_5236.wav,VTTS_b-3_5009-5427_5236.wav,3630,3913,-283
7530,b-4_2000-5164_4875.wav,VTTS_b-4_2000-5164_4875.wav,7777,7616,161
7531,b-2_1903-2038_2006.wav,VTTS_b-2_1903-2038_2006.wav,2400,1800,600
7532,b-2_1801-1902_1834.wav,VTTS_b-2_1801-1902_1834.wav,5310,4969,341
7533,b-4_1301-1400_1347.wav,VTTS_b-4_1301-1400_1347.wav,3930,3959,-29
7534,b-4_1-52_6.wav,VTTS_b-4_1-52_6.wav,6100,6385,-285
7535,b-1_2725-2825_2735.wav,VTTS_b-1_2725-2825_2735.wav,1420,1486,-66
7536,b-2_1427-1562_1533.wav,VTTS_b-2_1427-1562_1533.wav,1700,1614,86
7537,b-3_3538-3627_3558.wav,VTTS_b-3_3538-3627_3558.wav,3920,3309,611
7538,b-1_3329-3429_3401.wav,VTTS_b-1_3329-3429_3401.wav,2340,2450,-110
7539,b-4_2000-5164_2641.wav,VTTS_b-4_2000-5164_2641.wav,2090,1950,140
7540,b-1_2220-2320_2273.wav,VTTS_b-1_2220-2320_2273.wav,1560,1196,364
7541,b-4_2000-5164_4394.wav,VTTS_b-4_2000-5164_4394.wav,3967,4528,-561
7542,b-3_6116-6215_6127.wav,VTTS_b-3_6116-6215_6127.wav,2820,3262,-442
7543,b-4_2000-5164_4124.wav,VTTS_b-4_2000-5164_4124.wav,5503,5793,-290
7544,b-4_2000-5164_4433.wav,VTTS_b-4_2000-5164_4433.wav,2995,2937,58
7545,b-1_3733-3833_3751.wav,VTTS_b-1_3733-3833_3751.wav,1770,1834,-64
7546,b-3_4001-4103_4052.wav,VTTS_b-3_4001-4103_4052.wav,7940,8290,-350
7547,b-4_501-1014_573.wav,VTTS_b-4_501-1014_573.wav,7170,8034,-864
7548,b-2_2107-2193_2192.wav,VTTS_b-2_2107-2193_2192.wav,6630,6722,-92
7549,b-3_2524-2854_2685.wav,VTTS_b-3_2524-2854_2685.wav,6710,5201,1509
7550,b-3_3279-3363_3314.wav,VTTS_b-3_3279-3363_3314.wav,3160,3065,95
7551,b-4_401-500_445.wav,VTTS_b-4_401-500_445.wav,5430,4807,623
7552,b-3_2524-2854_2712.wav,VTTS_b-3_2524-2854_2712.wav,6500,6676,-176
7553,b-2_1597-1698_1636.wav,VTTS_b-2_1597-1698_1636.wav,670,685,-15
7554,b-3_6501-6600_6580.wav,VTTS_b-3_6501-6600_6580.wav,3250,3413,-163
7555,b-3_2524-2854_2680.wav,VTTS_b-3_2524-2854_2680.wav,4850,5886,-1036
7556,b-4_1301-1400_1336.wav,VTTS_b-4_1301-1400_1336.wav,14600,11610,2990
7557,b-4_1707-1813_1728.wav,VTTS_b-4_1707-1813_1728.wav,4150,3065,1085
7558,b-3_4607-5008_4746.wav,VTTS_b-3_4607-5008_4746.wav,7410,7721,-311
7559,b-3_2350-2433_2400.wav,VTTS_b-3_2350-2433_2400.wav,2510,4296,-1786
7560,b-4_2000-5164_3926.wav,VTTS_b-4_2000-5164_3926.wav,3327,3564,-237
7561,b-4_2000-5164_3659.wav,VTTS_b-4_2000-5164_3659.wav,4005,5375,-1370
7562,b-4_2000-5164_2650.wav,VTTS_b-4_2000-5164_2650.wav,5640,5166,474
7563,b-4_2000-5164_4915.wav,VTTS_b-4_2000-5164_4915.wav,4842,4551,291
7564,b-1_3531-3631_3600.wav,VTTS_b-1_3531-3631_3600.wav,2960,3506,-546
7565,b-3_1764-1861_1856.wav,VTTS_b-3_1764-1861_1856.wav,6800,8139,-1339
7566,b-1_3733-3833_3770.wav,VTTS_b-1_3733-3833_3770.wav,2080,2125,-45
7567,b-3_3889-4000_3899.wav,VTTS_b-3_3889-4000_3899.wav,7980,8266,-286
7568,b-1_2624-2724_2696.wav,VTTS_b-1_2624-2724_2696.wav,2830,3216,-386
7569,b-1_3733-3833_3777.wav,VTTS_b-1_3733-3833_3777.wav,3470,3913,-443
7570,b-4_2000-5164_3271.wav,VTTS_b-4_2000-5164_3271.wav,4732,5700,-968
7571,b-3_4207-4314_4273.wav,VTTS_b-3_4207-4314_4273.wav,3100,3634,-534
7572,b-2_2040-2072_2056.wav,VTTS_b-2_2040-2072_2056.wav,2790,2508,282
7573,b-4_2000-5164_2412.wav,VTTS_b-4_2000-5164_2412.wav,3240,3262,-22
7574,b-4_2000-5164_5098.wav,VTTS_b-4_2000-5164_5098.wav,4547,4876,-329
7575,b-3_1862-1959_1899.wav,VTTS_b-3_1862-1959_1899.wav,6500,4748,1752
7576,b-2_1801-1902_1890.wav,VTTS_b-2_1801-1902_1890.wav,1610,1498,112
7577,b-4_53-150_135.wav,VTTS_b-4_53-150_135.wav,7750,8777,-1027
7578,b-1_1414-1514_1476.wav,VTTS_b-1_1414-1514_1476.wav,2250,2368,-118
7579,b-3_3715-3802_3741.wav,VTTS_b-3_3715-3802_3741.wav,6590,8545,-1955
7580,b-3_1-97_65.wav,VTTS_b-3_1-97_65.wav,6640,6455,185
7581,b-1_1212-1312_1222.wav,VTTS_b-1_1212-1312_1222.wav,1350,1277,73
7582,b-4_2000-5164_4867.wav,VTTS_b-4_2000-5164_4867.wav,5054,5317,-263
7583,b-4_2000-5164_3140.wav,VTTS_b-4_2000-5164_3140.wav,3872,4029,-157
7584,b-3_4425-4497_4468.wav,VTTS_b-3_4425-4497_4468.wav,8490,8255,235
7585,b-4_53-150_116.wav,VTTS_b-4_53-150_116.wav,7520,7895,-375
7586,b-3_2177-2266_2223.wav,VTTS_b-3_2177-2266_2223.wav,5020,5317,-297
7587,b-3_2524-2854_2716.wav,VTTS_b-3_2524-2854_2716.wav,4100,4098,2
7588,b-4_53-150_93.wav,VTTS_b-4_53-150_93.wav,8960,7616,1344
7589,b-4_2000-5164_2532.wav,VTTS_b-4_2000-5164_2532.wav,7100,7581,-481
7590,b-1_3531-3631_3549.wav,VTTS_b-1_3531-3631_3549.wav,1270,1242,28
7591,b-3_5745-5852_5835.wav,VTTS_b-3_5745-5852_5835.wav,9580,10136,-556
7592,b-4_2000-5164_2899.wav,VTTS_b-4_2000-5164_2899.wav,5275,5515,-240
7593,b-3_501-930_775.wav,VTTS_b-3_501-930_775.wav,3310,3425,-115
7594,b-2_1903-2038_2013.wav,VTTS_b-2_1903-2038_2013.wav,3860,4969,-1109
7595,b-4_2000-5164_3866.wav,VTTS_b-4_2000-5164_3866.wav,2341,2357,-16
7596,b-4_2000-5164_3347.wav,VTTS_b-4_2000-5164_3347.wav,5827,6583,-756
7597,b-1_1111-1211_1149.wav,VTTS_b-1_1111-1211_1149.wav,2150,2090,60
7598,b-3_6601-6700_6693.wav,VTTS_b-3_6601-6700_6693.wav,4910,5921,-1011
7599,b-3_6016-6115_6082.wav,VTTS_b-3_6016-6115_6082.wav,3760,3599,161
7600,b-4_2000-5164_3164.wav,VTTS_b-4_2000-5164_3164.wav,5145,5492,-347
7601,b-1_3834-3934_3923.wav,VTTS_b-1_3834-3934_3923.wav,2230,2786,-556
7602,b-1_794-1009_799.wav,VTTS_b-1_794-1009_799.wav,3080,2810,270
7603,b-4_151-300_152.wav,VTTS_b-4_151-300_152.wav,6020,4969,1051
7604,b-2_1121-1222_1201.wav,VTTS_b-2_1121-1222_1201.wav,3250,3622,-372
7605,b-1_1313-1413_1346.wav,VTTS_b-1_1313-1413_1346.wav,1110,1126,-16
7606,b-1_650-685_651.wav,VTTS_b-1_650-685_651.wav,1460,1370,90
7607,b-2_1-100_90.wav,VTTS_b-2_1-100_90.wav,3030,3820,-790
7608,b-3_6116-6215_6147.wav,VTTS_b-3_6116-6215_6147.wav,2910,3193,-283
7609,b-3_1079-1320_1093.wav,VTTS_b-3_1079-1320_1093.wav,4470,4400,70
7610,b-3_392-500_476.wav,VTTS_b-3_392-500_476.wav,12160,11610,550
7611,b-4_2000-5164_2547.wav,VTTS_b-4_2000-5164_2547.wav,1400,1370,30
7612,b-1_2523-2623_2574.wav,VTTS_b-1_2523-2623_2574.wav,4110,4377,-267
7613,b-3_1079-1320_1112.wav,VTTS_b-3_1079-1320_1112.wav,2830,2891,-61
7614,b-4_2000-5164_4088.wav,VTTS_b-4_2000-5164_4088.wav,5664,5956,-292
7615,b-3_1666-1763_1762.wav,VTTS_b-3_1666-1763_1762.wav,4350,4818,-468
7616,b-1_1313-1413_1376.wav,VTTS_b-1_1313-1413_1376.wav,2190,2171,19
7617,b-3_3803-3888_3835.wav,VTTS_b-3_3803-3888_3835.wav,6380,7744,-1364
7618,b-3_1568-1665_1665.wav,VTTS_b-3_1568-1665_1665.wav,3940,3750,190
7619,b-1_2624-2724_2629.wav,VTTS_b-1_2624-2724_2629.wav,5850,10484,-4634
7620,b-3_4425-4497_4485.wav,VTTS_b-3_4425-4497_4485.wav,7870,8394,-524
7621,b-1_2927-3025_2979.wav,VTTS_b-1_2927-3025_2979.wav,5200,5283,-83
7622,b-3_6217-6274_6230.wav,VTTS_b-3_6217-6274_6230.wav,6010,5979,31
7623,b-1_175-275_198.wav,VTTS_b-1_175-275_198.wav,1490,1834,-344
7624,b-3_1079-1320_1181.wav,VTTS_b-3_1079-1320_1181.wav,2190,2577,-387
7625,b-3_3715-3802_3771.wav,VTTS_b-3_3715-3802_3771.wav,6080,6060,20
7626,b-3_1862-1959_1948.wav,VTTS_b-3_1862-1959_1948.wav,8360,7024,1336
7627,b-3_501-930_746.wav,VTTS_b-3_501-930_746.wav,6710,6792,-82
7628,b-4_1707-1813_1709.wav,VTTS_b-4_1707-1813_1709.wav,4080,4168,-88
7629,b-1_478-578_503.wav,VTTS_b-1_478-578_503.wav,1220,1300,-80
7630,b-4_1101-1220_1181.wav,VTTS_b-4_1101-1220_1181.wav,9510,9752,-242
7631,b-1_2220-2320_2250.wav,VTTS_b-1_2220-2320_2250.wav,1420,1370,50
7632,b-1_1010-1110_1103.wav,VTTS_b-1_1010-1110_1103.wav,2840,2961,-121
7633,b-4_2000-5164_3089.wav,VTTS_b-4_2000-5164_3089.wav,3115,2902,213
7634,b-3_5745-5852_5783.wav,VTTS_b-3_5745-5852_5783.wav,3370,3437,-67
7635,b-4_2000-5164_4035.wav,VTTS_b-4_2000-5164_4035.wav,6958,7605,-647
7636,b-3_2524-2854_2686.wav,VTTS_b-3_2524-2854_2686.wav,2990,2485,505
7637,b-3_501-930_574.wav,VTTS_b-3_501-930_574.wav,5990,5805,185
7638,b-1_3228-3328_3287.wav,VTTS_b-1_3228-3328_3287.wav,3920,4238,-318
7639,b-3_392-500_451.wav,VTTS_b-3_392-500_451.wav,8170,7012,1158
7640,b-4_501-1014_970.wav,VTTS_b-4_501-1014_970.wav,6860,8139,-1279
7641,b-4_2000-5164_4814.wav,VTTS_b-4_2000-5164_4814.wav,8859,9439,-580
7642,b-4_501-1014_730.wav,VTTS_b-4_501-1014_730.wav,7400,5805,1595
7643,b-4_2000-5164_2230.wav,VTTS_b-4_2000-5164_2230.wav,4410,5120,-710
7644,b-2_305-406_364.wav,VTTS_b-2_305-406_364.wav,1280,1382,-102
7645,b-4_2000-5164_4634.wav,VTTS_b-4_2000-5164_4634.wav,1689,1521,168
7646,b-3_2177-2266_2246.wav,VTTS_b-3_2177-2266_2246.wav,3480,5573,-2093
7647,b-4_501-1014_709.wav,VTTS_b-4_501-1014_709.wav,6040,5201,839
7648,b-1_175-275_185.wav,VTTS_b-1_175-275_185.wav,1860,1602,258
7649,b-3_3715-3802_3765.wav,VTTS_b-3_3715-3802_3765.wav,7450,7465,-15
7650,b-3_5009-5427_5333.wav,VTTS_b-3_5009-5427_5333.wav,5470,6478,-1008
7651,b-3_392-500_420.wav,VTTS_b-3_392-500_420.wav,4900,4830,70
7652,b-3_4104-4206_4113.wav,VTTS_b-3_4104-4206_4113.wav,4800,5027,-227
7653,b-4_2000-5164_2495.wav,VTTS_b-4_2000-5164_2495.wav,4030,4911,-881
7654,b-1_4214-4285_4240.wav,VTTS_b-1_4214-4285_4240.wav,1160,1091,69
7655,b-1_2119-2219_2181.wav,VTTS_b-1_2119-2219_2181.wav,1530,1451,79
7656,b-4_2000-5164_2221.wav,VTTS_b-4_2000-5164_2221.wav,2860,3100,-240
7657,b-3_4607-5008_4828.wav,VTTS_b-3_4607-5008_4828.wav,4170,3820,350
7658,b-4_2000-5164_3550.wav,VTTS_b-4_2000-5164_3550.wav,3082,3529,-447
7659,b-2_2209-2310_2268.wav,VTTS_b-2_2209-2310_2268.wav,1890,1811,79
7660,b-4_1707-1813_1748.wav,VTTS_b-4_1707-1813_1748.wav,5080,4992,88
7661,b-4_2000-5164_2225.wav,VTTS_b-4_2000-5164_2225.wav,5240,5422,-182
7662,b-3_5745-5852_5770.wav,VTTS_b-3_5745-5852_5770.wav,6020,6432,-412
7663,b-3_501-930_737.wav,VTTS_b-3_501-930_737.wav,6550,6711,-161
7664,b-3_5009-5427_5405.wav,VTTS_b-3_5009-5427_5405.wav,2560,2984,-424
7665,b-1_3430-3530_3502.wav,VTTS_b-1_3430-3530_3502.wav,1290,1335,-45
7666,b-4_2000-5164_4832.wav,VTTS_b-4_2000-5164_4832.wav,4430,4005,425
7667,b-1_1919-2017_2011.wav,VTTS_b-1_1919-2017_2011.wav,3220,3297,-77
7668,b-3_1-97_47.wav,VTTS_b-3_1-97_47.wav,6050,5283,767
7669,b-1_2220-2320_2220.wav,VTTS_b-1_2220-2320_2220.wav,1050,987,63
7670,b-1_1212-1312_1251.wav,VTTS_b-1_1212-1312_1251.wav,3370,3216,154
7671,b-1_2523-2623_2575.wav,VTTS_b-1_2523-2623_2575.wav,3970,4621,-651
7672,b-4_2000-5164_3412.wav,VTTS_b-4_2000-5164_3412.wav,5871,7454,-1583
7673,b-1_3733-3833_3788.wav,VTTS_b-1_3733-3833_3788.wav,2030,2473,-443
7674,b-3_1079-1320_1305.wav,VTTS_b-3_1079-1320_1305.wav,6130,6536,-406
7675,b-1_175-275_241.wav,VTTS_b-1_175-275_241.wav,2720,2659,61
7676,b-1_4070-4105_4094.wav,VTTS_b-1_4070-4105_4094.wav,4800,5004,-204
7677,b-1_1111-1211_1206.wav,VTTS_b-1_1111-1211_1206.wav,5340,5770,-430
7678,b-1_2119-2219_2173.wav,VTTS_b-1_2119-2219_2173.wav,2050,1974,76
7679,b-1_2927-3025_2932.wav,VTTS_b-1_2927-3025_2932.wav,1420,1242,178
7680,b-4_501-1014_948.wav,VTTS_b-4_501-1014_948.wav,2870,2682,188
7681,b-2_1325-1426_1327.wav,VTTS_b-2_1325-1426_1327.wav,2210,2043,167
7682,b-1_1919-2017_1988.wav,VTTS_b-1_1919-2017_1988.wav,1910,2844,-934
7683,b-3_5009-5427_5292.wav,VTTS_b-3_5009-5427_5292.wav,7720,7372,348
7684,b-1_3733-3833_3763.wav,VTTS_b-1_3733-3833_3763.wav,2300,2473,-173
7685,b-3_6501-6600_6504.wav,VTTS_b-3_6501-6600_6504.wav,5130,8591,-3461
7686,b-4_151-300_240.wav,VTTS_b-4_151-300_240.wav,2340,2218,122
7687,b-4_2000-5164_2543.wav,VTTS_b-4_2000-5164_2543.wav,2340,2276,64
7688,b-3_392-500_477.wav,VTTS_b-3_392-500_477.wav,3140,2635,505
7689,b-4_53-150_104.wav,VTTS_b-4_53-150_104.wav,9370,8046,1324
7690,b-1_3733-3833_3738.wav,VTTS_b-1_3733-3833_3738.wav,2690,3007,-317
7691,b-1_4070-4105_4078.wav,VTTS_b-1_4070-4105_4078.wav,4770,5364,-594
7692,b-1_3733-3833_3775.wav,VTTS_b-1_3733-3833_3775.wav,2160,2508,-348
7693,b-3_3889-4000_3933.wav,VTTS_b-3_3889-4000_3933.wav,8580,8475,105
7694,b-3_4315-4424_4415.wav,VTTS_b-3_4315-4424_4415.wav,3610,3576,34
7695,b-3_2434-2523_2512.wav,VTTS_b-3_2434-2523_2512.wav,3390,3878,-488
7696,b-3_6274-6300_6295.wav,VTTS_b-3_6274-6300_6295.wav,16340,11610,4730
7697,b-4_501-1014_645.wav,VTTS_b-4_501-1014_645.wav,5310,4307,1003
7698,b-3_4207-4314_4304.wav,VTTS_b-3_4207-4314_4304.wav,9610,10124,-514
7699,b-3_1764-1861_1779.wav,VTTS_b-3_1764-1861_1779.wav,2310,2485,-175
7700,b-3_1862-1959_1885.wav,VTTS_b-3_1862-1959_1885.wav,5710,3344,2366
7701,b-4_1601-1706_1671.wav,VTTS_b-4_1601-1706_1671.wav,2990,3785,-795
7702,b-3_501-930_815.wav,VTTS_b-3_501-930_815.wav,3300,2566,734
7703,b-3_98-195_193.wav,VTTS_b-3_98-195_193.wav,4240,4226,14
7704,b-3_2524-2854_2694.wav,VTTS_b-3_2524-2854_2694.wav,4550,4586,-36
7705,b-3_98-195_179.wav,VTTS_b-3_98-195_179.wav,4110,3855,255
7706,b-3_294-391_390.wav,VTTS_b-3_294-391_390.wav,3260,3193,67
7707,b-1_3430-3530_3510.wav,VTTS_b-1_3430-3530_3510.wav,2710,2531,179
7708,b-3_1568-1665_1592.wav,VTTS_b-3_1568-1665_1592.wav,4830,6409,-1579
7709,b-1_478-578_492.wav,VTTS_b-1_478-578_492.wav,5070,4261,809
7710,b-4_2000-5164_3940.wav,VTTS_b-4_2000-5164_3940.wav,7772,8278,-506
7711,b-3_4001-4103_4047.wav,VTTS_b-3_4001-4103_4047.wav,9160,10635,-1475
7712,b-1_478-578_493.wav,VTTS_b-1_478-578_493.wav,2390,2496,-106
7713,b-3_392-500_465.wav,VTTS_b-3_392-500_465.wav,2680,7616,-4936
7714,b-3_1321-1568_1427.wav,VTTS_b-3_1321-1568_1427.wav,9110,11610,-2500
7715,b-2_407-508_438.wav,VTTS_b-2_407-508_438.wav,4240,4644,-404
7716,b-4_2000-5164_3650.wav,VTTS_b-4_2000-5164_3650.wav,2678,2032,646
7717,b-4_1014-1100_1091.wav,VTTS_b-4_1014-1100_1091.wav,4490,4319,171
7718,b-3_1079-1320_1116.wav,VTTS_b-3_1079-1320_1116.wav,1190,1219,-29
7719,b-1_2826-2926_2922.wav,VTTS_b-1_2826-2926_2922.wav,1460,1370,90
7720,b-4_2000-5164_2530.wav,VTTS_b-4_2000-5164_2530.wav,5020,5480,-460
7721,b-3_2524-2854_2771.wav,VTTS_b-3_2524-2854_2771.wav,7540,7198,342
7722,b-1_1-73_57.wav,VTTS_b-1_1-73_57.wav,1170,1242,-72
7723,b-3_2350-2433_2396.wav,VTTS_b-3_2350-2433_2396.wav,7920,7697,223
7724,b-4_501-1014_774.wav,VTTS_b-4_501-1014_774.wav,5320,4934,386
7725,b-3_501-930_512.wav,VTTS_b-3_501-930_512.wav,3180,3019,161
7726,b-2_1121-1222_1162.wav,VTTS_b-2_1121-1222_1162.wav,5630,4098,1532
7727,b-4_2000-5164_4762.wav,VTTS_b-4_2000-5164_4762.wav,3458,3762,-304
7728,b-4_1506-1600_1513.wav,VTTS_b-4_1506-1600_1513.wav,1570,1591,-21
7729,b-4_2000-5164_3933.wav,VTTS_b-4_2000-5164_3933.wav,4939,4656,283
7730,b-1_1-73_52.wav,VTTS_b-1_1-73_52.wav,2110,2717,-607
7731,b-2_203-304_258.wav,VTTS_b-2_203-304_258.wav,2860,3286,-426
7732,b-3_2524-2854_2736.wav,VTTS_b-3_2524-2854_2736.wav,5090,5608,-518
7733,b-2_203-304_228.wav,VTTS_b-2_203-304_228.wav,1360,2032,-672
7734,b-4_1401-1505_1401.wav,VTTS_b-4_1401-1505_1401.wav,2650,2368,282
7735,b-2_1427-1562_1532.wav,VTTS_b-2_1427-1562_1532.wav,2550,2218,332
7736,b-3_4607-5008_4913.wav,VTTS_b-3_4607-5008_4913.wav,5740,5677,63
7737,b-3_3454-3537_3521.wav,VTTS_b-3_3454-3537_3521.wav,7090,7117,-27
7738,b-2_1699-1800_1787.wav,VTTS_b-2_1699-1800_1787.wav,3410,3367,43
7739,b-1_1414-1514_1504.wav,VTTS_b-1_1414-1514_1504.wav,4550,3889,661
7740,b-1_650-685_676.wav,VTTS_b-1_650-685_676.wav,1130,1358,-228
7741,b-3_3628-3714_3628.wav,VTTS_b-3_3628-3714_3628.wav,8600,8545,55
7742,b-3_3538-3627_3542.wav,VTTS_b-3_3538-3627_3542.wav,3180,3855,-675
7743,b-2_305-406_324.wav,VTTS_b-2_305-406_324.wav,5620,5782,-162
7744,b-3_4607-5008_4762.wav,VTTS_b-3_4607-5008_4762.wav,3370,4888,-1518
7745,b-3_98-195_153.wav,VTTS_b-3_98-195_153.wav,6100,5735,365
7746,b-2_917-1018_971.wav,VTTS_b-2_917-1018_971.wav,1700,1823,-123
7747,b-3_2350-2433_2379.wav,VTTS_b-3_2350-2433_2379.wav,6260,6339,-79
7748,b-4_2000-5164_2322.wav,VTTS_b-4_2000-5164_2322.wav,1930,1718,212
7749,b-1_1010-1110_1105.wav,VTTS_b-1_1010-1110_1105.wav,1820,1718,102
7750,b-1_4214-4285_4262.wav,VTTS_b-1_4214-4285_4262.wav,1720,2519,-799
7751,b-4_401-500_426.wav,VTTS_b-4_401-500_426.wav,4010,4005,5
7752,b-3_501-930_570.wav,VTTS_b-3_501-930_570.wav,2620,2403,217
7753,b-3_5009-5427_5313.wav,VTTS_b-3_5009-5427_5313.wav,1460,1022,438
7754,b-3_1862-1959_1903.wav,VTTS_b-3_1862-1959_1903.wav,5520,5898,-378
7755,b-1_2725-2825_2819.wav,VTTS_b-1_2725-2825_2819.wav,1190,1254,-64
7756,b-4_2000-5164_2762.wav,VTTS_b-4_2000-5164_2762.wav,4110,3669,441
7757,b-1_794-1009_952.wav,VTTS_b-1_794-1009_952.wav,1510,1974,-464
7758,b-4_2000-5164_3178.wav,VTTS_b-4_2000-5164_3178.wav,9766,11401,-1635
7759,b-3_1-97_70.wav,VTTS_b-3_1-97_70.wav,2160,3796,-1636
7760,b-1_3430-3530_3486.wav,VTTS_b-1_3430-3530_3486.wav,3210,6908,-3698
7761,b-1_2018-2118_2056.wav,VTTS_b-1_2018-2118_2056.wav,3300,2902,398
7762,b-3_2524-2854_2693.wav,VTTS_b-3_2524-2854_2693.wav,3220,3007,213
7763,b-4_2000-5164_4220.wav,VTTS_b-4_2000-5164_4220.wav,3721,3866,-145
7764,b-4_151-300_194.wav,VTTS_b-4_151-300_194.wav,6110,11610,-5500
7765,b-4_501-1014_704.wav,VTTS_b-4_501-1014_704.wav,3850,3460,390
7766,b-4_1814-1900_1847.wav,VTTS_b-4_1814-1900_1847.wav,3500,3367,133
7767,b-3_4001-4103_4038.wav,VTTS_b-3_4001-4103_4038.wav,4250,6142,-1892
7768,b-4_2000-5164_3039.wav,VTTS_b-4_2000-5164_3039.wav,5031,4853,178
7769,b-2_1903-2038_2023.wav,VTTS_b-2_1903-2038_2023.wav,4940,5654,-714
7770,b-4_2000-5164_3720.wav,VTTS_b-4_2000-5164_3720.wav,2900,3019,-119
7771,b-2_1223-1324_1236.wav,VTTS_b-2_1223-1324_1236.wav,1440,1788,-348
7772,b-1_175-275_218.wav,VTTS_b-1_175-275_218.wav,2110,1695,415
7773,b-3_6501-6600_6589.wav,VTTS_b-3_6501-6600_6589.wav,5690,5445,245
7774,b-2_1699-1800_1760.wav,VTTS_b-2_1699-1800_1760.wav,2300,3170,-870
7775,b-3_6900-7016_6907.wav,VTTS_b-3_6900-7016_6907.wav,3170,3007,163
7776,b-3_3628-3714_3685.wav,VTTS_b-3_3628-3714_3685.wav,8400,8487,-87
7777,b-3_4315-4424_4315.wav,VTTS_b-3_4315-4424_4315.wav,3480,3286,194
7778,b-4_2000-5164_3946.wav,VTTS_b-4_2000-5164_3946.wav,4904,5085,-181
7779,b-3_5639-5744_5706.wav,VTTS_b-3_5639-5744_5706.wav,4330,4911,-581
7780,b-1_1111-1211_1199.wav,VTTS_b-1_1111-1211_1199.wav,2450,2554,-104
7781,b-1_1-73_26.wav,VTTS_b-1_1-73_26.wav,3010,4516,-1506
7782,b-3_4498-4605_4552.wav,VTTS_b-3_4498-4605_4552.wav,6980,6467,513
7783,b-3_5639-5744_5718.wav,VTTS_b-3_5639-5744_5718.wav,9810,10391,-581
7784,b-3_1321-1568_1492.wav,VTTS_b-3_1321-1568_1492.wav,4200,3738,462
7785,b-1_3935-4033_3968.wav,VTTS_b-1_3935-4033_3968.wav,2830,2659,171
7786,b-3_4315-4424_4370.wav,VTTS_b-3_4315-4424_4370.wav,3140,3111,29
7787,b-4_1601-1706_1604.wav,VTTS_b-4_1601-1706_1604.wav,12330,11610,720
7788,b-4_2000-5164_3280.wav,VTTS_b-4_2000-5164_3280.wav,3993,3669,324
7789,b-3_2000-2088_2076.wav,VTTS_b-3_2000-2088_2076.wav,4700,3843,857
7790,b-1_3834-3934_3858.wav,VTTS_b-1_3834-3934_3858.wav,3060,3239,-179
7791,b-2_407-508_439.wav,VTTS_b-2_407-508_439.wav,4060,3692,368
7792,b-4_2000-5164_3513.wav,VTTS_b-4_2000-5164_3513.wav,4994,5666,-672
7793,b-1_3632-3732_3714.wav,VTTS_b-1_3632-3732_3714.wav,2430,2566,-136
7794,b-4_501-1014_605.wav,VTTS_b-4_501-1014_605.wav,2740,2717,23
7795,b-3_501-930_884.wav,VTTS_b-3_501-930_884.wav,6140,6281,-141
7796,b-1_2119-2219_2210.wav,VTTS_b-1_2119-2219_2210.wav,2680,2682,-2
7797,b-4_2000-5164_2917.wav,VTTS_b-4_2000-5164_2917.wav,4668,4714,-46
7798,b-1_1515-1615_1552.wav,VTTS_b-1_1515-1615_1552.wav,2650,2473,177
7799,b-1_4034-4069_4046.wav,VTTS_b-1_4034-4069_4046.wav,5280,5596,-316
7800,b-2_2311-2412_2389.wav,VTTS_b-2_2311-2412_2389.wav,1290,1254,36
7801,b-4_501-1014_761.wav,VTTS_b-4_501-1014_761.wav,6300,6606,-306
7802,b-4_2000-5164_4232.wav,VTTS_b-4_2000-5164_4232.wav,7052,8371,-1319
7803,b-2_611-712_636.wav,VTTS_b-2_611-712_636.wav,1090,1068,22
7804,b-3_5009-5427_5133.wav,VTTS_b-3_5009-5427_5133.wav,6130,7001,-871
7805,b-4_53-150_138.wav,VTTS_b-4_53-150_138.wav,8170,8591,-421
7806,b-3_1079-1320_1166.wav,VTTS_b-3_1079-1320_1166.wav,4220,4679,-459
7807,b-3_3112-3197_3115.wav,VTTS_b-3_3112-3197_3115.wav,6360,4946,1414
7808,b-3_501-930_656.wav,VTTS_b-3_501-930_656.wav,9260,10391,-1131
7809,b-3_6016-6115_6104.wav,VTTS_b-3_6016-6115_6104.wav,1190,1149,41
7810,b-4_2000-5164_2888.wav,VTTS_b-4_2000-5164_2888.wav,2845,2601,244
7811,b-4_2000-5164_5036.wav,VTTS_b-4_2000-5164_5036.wav,3872,3622,250
7812,b-3_1568-1665_1602.wav,VTTS_b-3_1568-1665_1602.wav,1280,1277,3
7813,b-4_2000-5164_4027.wav,VTTS_b-4_2000-5164_4027.wav,6358,6188,170
7814,b-1_4214-4285_4283.wav,VTTS_b-1_4214-4285_4283.wav,2850,2914,-64
7815,b-1_4178-4213_4184.wav,VTTS_b-1_4178-4213_4184.wav,2470,2403,67
7816,b-3_4207-4314_4274.wav,VTTS_b-3_4207-4314_4274.wav,5170,7744,-2574
7817,b-4_1707-1813_1726.wav,VTTS_b-4_1707-1813_1726.wav,4680,4087,593
7818,b-1_1313-1413_1342.wav,VTTS_b-1_1313-1413_1342.wav,2440,2461,-21
7819,b-3_1862-1959_1919.wav,VTTS_b-3_1862-1959_1919.wav,4740,5283,-543
7820,b-1_3834-3934_3868.wav,VTTS_b-1_3834-3934_3868.wav,1190,1277,-87
7821,b-3_4607-5008_4919.wav,VTTS_b-3_4607-5008_4919.wav,4480,4331,149
7822,b-1_3026-3126_3103.wav,VTTS_b-1_3026-3126_3103.wav,1920,1649,271
7823,b-4_1814-1900_1820.wav,VTTS_b-4_1814-1900_1820.wav,2520,3170,-650
7824,b-1_1818-1918_1889.wav,VTTS_b-1_1818-1918_1889.wav,1870,2183,-313
7825,b-3_980-1077_1044.wav,VTTS_b-3_980-1077_1044.wav,2540,2763,-223
7826,b-4_501-1014_582.wav,VTTS_b-4_501-1014_582.wav,6020,5329,691
7827,b-3_501-930_554.wav,VTTS_b-3_501-930_554.wav,8390,8789,-399
7828,b-2_2107-2193_2149.wav,VTTS_b-2_2107-2193_2149.wav,1410,1312,98
7829,b-1_3026-3126_3099.wav,VTTS_b-1_3026-3126_3099.wav,4950,4992,-42
7830,b-1_2422-2522_2458.wav,VTTS_b-1_2422-2522_2458.wav,1850,2868,-1018
7831,b-3_980-1077_1063.wav,VTTS_b-3_980-1077_1063.wav,7360,8499,-1139
7832,b-3_4001-4103_4042.wav,VTTS_b-3_4001-4103_4042.wav,2850,3053,-203
7833,b-3_5009-5427_5294.wav,VTTS_b-3_5009-5427_5294.wav,5610,5155,455
7834,b-2_1325-1426_1376.wav,VTTS_b-2_1325-1426_1376.wav,3850,4133,-283
7835,b-1_686-793_785.wav,VTTS_b-1_686-793_785.wav,1330,1161,169
7836,b-4_501-1014_773.wav,VTTS_b-4_501-1014_773.wav,2530,2380,150
7837,b-3_6116-6215_6126.wav,VTTS_b-3_6116-6215_6126.wav,3250,3228,22
7838,b-4_1814-1900_1846.wav,VTTS_b-4_1814-1900_1846.wav,4430,3982,448
7839,b-2_713-814_781.wav,VTTS_b-2_713-814_781.wav,4900,3843,1057
7840,b-1_3531-3631_3585.wav,VTTS_b-1_3531-3631_3585.wav,2580,3100,-520
7841,b-3_3803-3888_3830.wav,VTTS_b-3_3803-3888_3830.wav,7270,6815,455
7842,b-4_2000-5164_4773.wav,VTTS_b-4_2000-5164_4773.wav,3703,3471,232
7843,b-3_2000-2088_2025.wav,VTTS_b-3_2000-2088_2025.wav,2850,2833,17
7844,b-2_1597-1698_1661.wav,VTTS_b-2_1597-1698_1661.wav,3910,5933,-2023
7845,b-1_3531-3631_3568.wav,VTTS_b-1_3531-3631_3568.wav,4780,5468,-688
7846,b-4_501-1014_608.wav,VTTS_b-4_501-1014_608.wav,4800,4423,377
7847,b-1_794-1009_912.wav,VTTS_b-1_794-1009_912.wav,3970,4052,-82
7848,b-3_980-1077_1050.wav,VTTS_b-3_980-1077_1050.wav,6240,5863,377
7849,b-1_4106-4141_4132.wav,VTTS_b-1_4106-4141_4132.wav,3610,4110,-500
7850,b-3_6601-6700_6642.wav,VTTS_b-3_6601-6700_6642.wav,3310,4447,-1137
7851,b-1_4142-4177_4158.wav,VTTS_b-1_4142-4177_4158.wav,3530,3855,-325
7852,b-4_2000-5164_4455.wav,VTTS_b-4_2000-5164_4455.wav,6989,8139,-1150
7853,b-4_501-1014_889.wav,VTTS_b-4_501-1014_889.wav,5000,5224,-224
7854,b-2_2413-2500_2492.wav,VTTS_b-2_2413-2500_2492.wav,1690,1463,227
7855,b-4_501-1014_789.wav,VTTS_b-4_501-1014_789.wav,2430,2647,-217
7856,b-4_2000-5164_2096.wav,VTTS_b-4_2000-5164_2096.wav,5420,5863,-443
7857,b-3_1568-1665_1634.wav,VTTS_b-3_1568-1665_1634.wav,5730,5236,494
7858,b-3_1568-1665_1611.wav,VTTS_b-3_1568-1665_1611.wav,2350,2392,-42
7859,b-3_2350-2433_2377.wav,VTTS_b-3_2350-2433_2377.wav,6320,6594,-274
7860,b-3_3803-3888_3876.wav,VTTS_b-3_3803-3888_3876.wav,1170,1033,137
7861,b-1_2018-2118_2048.wav,VTTS_b-1_2018-2118_2048.wav,1800,1718,82
7862,b-1_1414-1514_1494.wav,VTTS_b-1_1414-1514_1494.wav,2370,2368,2
7863,b-4_2000-5164_4722.wav,VTTS_b-4_2000-5164_4722.wav,6451,6246,205
7864,b-3_4607-5008_4821.wav,VTTS_b-3_4607-5008_4821.wav,5070,5480,-410
7865,b-2_2209-2310_2276.wav,VTTS_b-2_2209-2310_2276.wav,1260,1335,-75
7866,b-3_1764-1861_1850.wav,VTTS_b-3_1764-1861_1850.wav,5570,5329,241
7867,b-1_1515-1615_1551.wav,VTTS_b-1_1515-1615_1551.wav,1030,1416,-386
7868,b-4_1601-1706_1627.wav,VTTS_b-4_1601-1706_1627.wav,4860,4029,831
7869,b-4_2000-5164_2091.wav,VTTS_b-4_2000-5164_2091.wav,6770,6513,257
7870,b-4_2000-5164_2138.wav,VTTS_b-4_2000-5164_2138.wav,5030,5561,-531
7871,b-3_6801-6900_6859.wav,VTTS_b-3_6801-6900_6859.wav,4150,4481,-331
7872,b-2_1427-1562_1450.wav,VTTS_b-2_1427-1562_1450.wav,5840,6246,-406
7873,b-4_1101-1220_1179.wav,VTTS_b-4_1101-1220_1179.wav,2190,1997,193
7874,b-1_2422-2522_2498.wav,VTTS_b-1_2422-2522_2498.wav,3360,3262,98
7875,b-2_917-1018_980.wav,VTTS_b-2_917-1018_980.wav,3540,3564,-24
7876,b-4_53-150_137.wav,VTTS_b-4_53-150_137.wav,8600,8197,403
7877,b-3_392-500_487.wav,VTTS_b-3_392-500_487.wav,4810,4748,62
7878,b-3_3025-3111_3102.wav,VTTS_b-3_3025-3111_3102.wav,4420,3727,693
7879,b-4_2000-5164_3769.wav,VTTS_b-4_2000-5164_3769.wav,8140,9149,-1009
7880,b-3_1321-1568_1538.wav,VTTS_b-3_1321-1568_1538.wav,3990,3471,519
7881,b-4_501-1014_568.wav,VTTS_b-4_501-1014_568.wav,13060,10054,3006
7882,b-2_1223-1324_1283.wav,VTTS_b-2_1223-1324_1283.wav,2450,2949,-499
7883,b-3_501-930_871.wav,VTTS_b-3_501-930_871.wav,8980,8580,400
7884,b-4_2000-5164_4405.wav,VTTS_b-4_2000-5164_4405.wav,2347,2218,129
7885,b-4_2000-5164_4390.wav,VTTS_b-4_2000-5164_4390.wav,2831,3088,-257
7886,b-3_6401-6500_6438.wav,VTTS_b-3_6401-6500_6438.wav,2540,2438,102
7887,b-3_3364-3453_3444.wav,VTTS_b-3_3364-3453_3444.wav,4230,4052,178
7888,b-3_4104-4206_4174.wav,VTTS_b-3_4104-4206_4174.wav,2320,2252,68
7889,b-2_1597-1698_1626.wav,VTTS_b-2_1597-1698_1626.wav,4450,5410,-960
7890,b-3_6116-6215_6164.wav,VTTS_b-3_6116-6215_6164.wav,1530,1637,-107
7891,b-3_294-391_300.wav,VTTS_b-3_294-391_300.wav,3690,3646,44
7892,b-4_2000-5164_4186.wav,VTTS_b-4_2000-5164_4186.wav,4150,3773,377
7893,b-3_3198-3278_3255.wav,VTTS_b-3_3198-3278_3255.wav,3000,2612,388
7894,b-4_401-500_402.wav,VTTS_b-4_401-500_402.wav,1740,1637,103
7895,b-3_294-391_385.wav,VTTS_b-3_294-391_385.wav,10720,11610,-890
7896,b-4_2000-5164_4611.wav,VTTS_b-4_2000-5164_4611.wav,12441,11610,831
7897,b-4_2000-5164_4170.wav,VTTS_b-4_2000-5164_4170.wav,3054,3541,-487
7898,b-3_501-930_788.wav,VTTS_b-3_501-930_788.wav,8180,7802,378
7899,b-4_1814-1900_1867.wav,VTTS_b-4_1814-1900_1867.wav,7160,7419,-259
7900,b-2_1597-1698_1618.wav,VTTS_b-2_1597-1698_1618.wav,1730,1614,116
7901,b-4_2000-5164_2184.wav,VTTS_b-4_2000-5164_2184.wav,3930,4052,-122
7902,b-4_1221-1300_1265.wav,VTTS_b-4_1221-1300_1265.wav,5610,5433,177
7903,b-3_1079-1320_1144.wav,VTTS_b-3_1079-1320_1144.wav,8320,8429,-109
7904,b-1_4214-4285_4266.wav,VTTS_b-1_4214-4285_4266.wav,1370,1277,93
7905,b-4_1601-1706_1672.wav,VTTS_b-4_1601-1706_1672.wav,6190,5805,385
7906,b-4_2000-5164_5032.wav,VTTS_b-4_2000-5164_5032.wav,4289,4876,-587
7907,b-3_3025-3111_3083.wav,VTTS_b-3_3025-3111_3083.wav,5790,5735,55
7908,b-3_6501-6600_6524.wav,VTTS_b-3_6501-6600_6524.wav,2300,2310,-10
7909,b-1_1010-1110_1065.wav,VTTS_b-1_1010-1110_1065.wav,2710,2566,144
7910,b-4_1401-1505_1452.wav,VTTS_b-4_1401-1505_1452.wav,7280,6374,906
7911,b-2_1699-1800_1730.wav,VTTS_b-2_1699-1800_1730.wav,2670,2264,406
7912,b-2_407-508_420.wav,VTTS_b-2_407-508_420.wav,4240,5770,-1530
7913,b-3_5428-5533_5488.wav,VTTS_b-3_5428-5533_5488.wav,3430,4493,-1063
7914,b-1_794-1009_977.wav,VTTS_b-1_794-1009_977.wav,3510,3715,-205
7915,b-3_501-930_591.wav,VTTS_b-3_501-930_591.wav,8120,7268,852
7916,b-3_3889-4000_3944.wav,VTTS_b-3_3889-4000_3944.wav,5130,5155,-25
7917,b-4_2000-5164_4341.wav,VTTS_b-4_2000-5164_4341.wav,7938,8324,-386
7918,b-2_509-610_588.wav,VTTS_b-2_509-610_588.wav,1020,1022,-2
7919,b-2_1801-1902_1825.wav,VTTS_b-2_1801-1902_1825.wav,2400,2612,-212
7920,b-4_2000-5164_4478.wav,VTTS_b-4_2000-5164_4478.wav,11697,11401,296
7921,b-4_2000-5164_4307.wav,VTTS_b-4_2000-5164_4307.wav,3635,3750,-115
7922,b-1_4214-4285_4265.wav,VTTS_b-1_4214-4285_4265.wav,1920,1927,-7
7923,b-2_305-406_393.wav,VTTS_b-2_305-406_393.wav,5370,5979,-609
7924,b-4_2000-5164_4509.wav,VTTS_b-4_2000-5164_4509.wav,4292,4621,-329
7925,b-4_1301-1400_1327.wav,VTTS_b-4_1301-1400_1327.wav,5630,5573,57
7926,b-3_2350-2433_2380.wav,VTTS_b-3_2350-2433_2380.wav,5530,5480,50
7927,b-4_1301-1400_1351.wav,VTTS_b-4_1301-1400_1351.wav,12500,10937,1563
7928,b-4_2000-5164_3885.wav,VTTS_b-4_2000-5164_3885.wav,5067,5050,17
7929,b-1_794-1009_801.wav,VTTS_b-1_794-1009_801.wav,1410,1405,5
7930,b-2_305-406_369.wav,VTTS_b-2_305-406_369.wav,4510,4447,63
7931,b-1_2321-2421_2416.wav,VTTS_b-1_2321-2421_2416.wav,3940,3982,-42
7932,b-4_2000-5164_2865.wav,VTTS_b-4_2000-5164_2865.wav,5790,8069,-2279
7933,b-1_276-376_329.wav,VTTS_b-1_276-376_329.wav,3080,2844,236
7934,b-3_501-930_783.wav,VTTS_b-3_501-930_783.wav,3360,4063,-703
7935,b-1_4034-4069_4065.wav,VTTS_b-1_4034-4069_4065.wav,1820,2101,-281
7936,b-3_4001-4103_4093.wav,VTTS_b-3_4001-4103_4093.wav,7810,7070,740
7937,b-3_4607-5008_4840.wav,VTTS_b-3_4607-5008_4840.wav,6900,6943,-43
7938,b-1_2523-2623_2533.wav,VTTS_b-1_2523-2623_2533.wav,6430,5317,1113
7939,b-3_5009-5427_5284.wav,VTTS_b-3_5009-5427_5284.wav,4680,4783,-103
7940,b-3_5533-5638_5584.wav,VTTS_b-3_5533-5638_5584.wav,5600,5677,-77
7941,b-1_276-376_278.wav,VTTS_b-1_276-376_278.wav,2110,1823,287
7942,b-3_2855-2942_2927.wav,VTTS_b-3_2855-2942_2927.wav,2220,2148,72
7943,b-3_294-391_367.wav,VTTS_b-3_294-391_367.wav,7060,7581,-521
7944,b-4_2000-5164_4664.wav,VTTS_b-4_2000-5164_4664.wav,4431,4656,-225
7945,b-3_2943-3024_3019.wav,VTTS_b-3_2943-3024_3019.wav,4790,5155,-365
7946,b-3_4425-4497_4479.wav,VTTS_b-3_4425-4497_4479.wav,2750,2972,-222
7947,b-2_1325-1426_1365.wav,VTTS_b-2_1325-1426_1365.wav,2310,2345,-35
7948,b-4_301-400_372.wav,VTTS_b-4_301-400_372.wav,5490,5259,231
7949,b-1_3632-3732_3691.wav,VTTS_b-1_3632-3732_3691.wav,1890,2125,-235
7950,b-4_2000-5164_3537.wav,VTTS_b-4_2000-5164_3537.wav,5580,6571,-991
7951,b-1_3531-3631_3591.wav,VTTS_b-1_3531-3631_3591.wav,2740,2229,511
7952,b-3_2350-2433_2382.wav,VTTS_b-3_2350-2433_2382.wav,5260,4737,523
7953,b-4_2000-5164_2360.wav,VTTS_b-4_2000-5164_2360.wav,5200,4818,382
7954,b-2_203-304_249.wav,VTTS_b-2_203-304_249.wav,1920,2635,-715
7955,b-4_1506-1600_1574.wav,VTTS_b-4_1506-1600_1574.wav,4860,4017,843
7956,b-2_1325-1426_1377.wav,VTTS_b-2_1325-1426_1377.wav,2060,2775,-715
7957,b-1_2119-2219_2145.wav,VTTS_b-1_2119-2219_2145.wav,2520,2833,-313
7958,b-3_2267-2349_2282.wav,VTTS_b-3_2267-2349_2282.wav,4640,4714,-74
7959,b-3_4104-4206_4185.wav,VTTS_b-3_4104-4206_4185.wav,6220,5666,554
7960,b-2_305-406_357.wav,VTTS_b-2_305-406_357.wav,1240,1254,-14
7961,b-3_1079-1320_1162.wav,VTTS_b-3_1079-1320_1162.wav,4090,4063,27
7962,b-4_1014-1100_1032.wav,VTTS_b-4_1014-1100_1032.wav,6060,5573,487
7963,b-2_2194-2208_2208.wav,VTTS_b-2_2194-2208_2208.wav,3500,3344,156
7964,b-2_203-304_234.wav,VTTS_b-2_203-304_234.wav,1230,1161,69
7965,b-3_6701-6800_6740.wav,VTTS_b-3_6701-6800_6740.wav,4480,4342,138
7966,b-1_794-1009_858.wav,VTTS_b-1_794-1009_858.wav,1060,1033,27
7967,b-3_4607-5008_4822.wav,VTTS_b-3_4607-5008_4822.wav,3890,3704,186
7968,b-3_2000-2088_2012.wav,VTTS_b-3_2000-2088_2012.wav,8790,7268,1522
7969,b-4_501-1014_663.wav,VTTS_b-4_501-1014_663.wav,7700,7105,595
7970,b-1_1111-1211_1183.wav,VTTS_b-1_1111-1211_1183.wav,2510,2380,130
7971,b-1_1-73_69.wav,VTTS_b-1_1-73_69.wav,2210,1881,329
7972,b-3_4425-4497_4434.wav,VTTS_b-3_4425-4497_4434.wav,5970,6200,-230
7973,b-3_6601-6700_6645.wav,VTTS_b-3_6601-6700_6645.wav,7390,7802,-412
7974,b-1_2624-2724_2693.wav,VTTS_b-1_2624-2724_2693.wav,2820,3274,-454
7975,b-1_2826-2926_2897.wav,VTTS_b-1_2826-2926_2897.wav,2560,2450,110
7976,b-2_917-1018_919.wav,VTTS_b-2_917-1018_919.wav,2860,3529,-669
7977,b-4_2000-5164_2651.wav,VTTS_b-4_2000-5164_2651.wav,3300,3111,189
7978,b-3_5533-5638_5560.wav,VTTS_b-3_5533-5638_5560.wav,3770,3657,113
7979,b-1_3531-3631_3562.wav,VTTS_b-1_3531-3631_3562.wav,3100,11610,-8510
7980,b-2_1699-1800_1767.wav,VTTS_b-2_1699-1800_1767.wav,3490,2926,564
7981,b-2_101-202_149.wav,VTTS_b-2_101-202_149.wav,2010,1962,48
7982,b-3_501-930_610.wav,VTTS_b-3_501-930_610.wav,7680,6896,784
7983,b-3_2177-2266_2188.wav,VTTS_b-3_2177-2266_2188.wav,3800,3320,480
7984,b-4_1401-1505_1469.wav,VTTS_b-4_1401-1505_1469.wav,9380,8800,580
7985,b-1_650-685_658.wav,VTTS_b-1_650-685_658.wav,5110,5433,-323
7986,b-4_2000-5164_2802.wav,VTTS_b-4_2000-5164_2802.wav,4620,4365,255
7987,b-3_2524-2854_2592.wav,VTTS_b-3_2524-2854_2592.wav,5270,5097,173
7988,b-2_1223-1324_1251.wav,VTTS_b-2_1223-1324_1251.wav,1300,1451,-151
7989,b-3_2524-2854_2578.wav,VTTS_b-3_2524-2854_2578.wav,5700,7837,-2137
7990,b-1_686-793_780.wav,VTTS_b-1_686-793_780.wav,5450,4214,1236
7991,b-3_6301-6400_6382.wav,VTTS_b-3_6301-6400_6382.wav,4560,3901,659
7992,b-1_2018-2118_2114.wav,VTTS_b-1_2018-2118_2114.wav,1860,1567,293
7993,b-4_2000-5164_5129.wav,VTTS_b-4_2000-5164_5129.wav,2477,2078,399
7994,b-3_6401-6500_6463.wav,VTTS_b-3_6401-6500_6463.wav,9400,7790,1610
7995,b-4_2000-5164_5006.wav,VTTS_b-4_2000-5164_5006.wav,3683,3506,177
7996,b-4_2000-5164_3609.wav,VTTS_b-4_2000-5164_3609.wav,3308,3379,-71
7997,b-3_4498-4605_4545.wav,VTTS_b-3_4498-4605_4545.wav,10030,10519,-489
7998,b-2_1427-1562_1436.wav,VTTS_b-2_1427-1562_1436.wav,1800,2194,-394
7999,b-2_1903-2038_1955.wav,VTTS_b-2_1903-2038_1955.wav,1230,1254,-24
8000,b-4_1901-2000_1970.wav,VTTS_b-4_1901-2000_1970.wav,4240,3924,316
8001,b-4_501-1014_764.wav,VTTS_b-4_501-1014_764.wav,4940,5085,-145
8002,b-1_4466-4498_4491.wav,VTTS_b-1_4466-4498_4491.wav,2970,4005,-1035
8003,b-4_1814-1900_1865.wav,VTTS_b-4_1814-1900_1865.wav,8200,7396,804
8004,b-1_3228-3328_3296.wav,VTTS_b-1_3228-3328_3296.wav,1790,1625,165
8005,b-4_2000-5164_2536.wav,VTTS_b-4_2000-5164_2536.wav,10080,11610,-1530
8006,b-3_3454-3537_3465.wav,VTTS_b-3_3454-3537_3465.wav,3390,3251,139
8007,b-3_5009-5427_5060.wav,VTTS_b-3_5009-5427_5060.wav,4750,4342,408
8008,b-1_686-793_762.wav,VTTS_b-1_686-793_762.wav,2310,2218,92
8009,b-1_2725-2825_2748.wav,VTTS_b-1_2725-2825_2748.wav,4210,3936,274
8010,b-4_401-500_496.wav,VTTS_b-4_401-500_496.wav,3360,3541,-181
8011,b-2_1801-1902_1880.wav,VTTS_b-2_1801-1902_1880.wav,1190,1115,75
8012,b-2_2209-2310_2233.wav,VTTS_b-2_2209-2310_2233.wav,1400,1219,181
8013,b-4_2000-5164_4589.wav,VTTS_b-4_2000-5164_4589.wav,5874,6339,-465
8014,b-4_1814-1900_1815.wav,VTTS_b-4_1814-1900_1815.wav,2730,2670,60
8015,b-2_1019-1120_1085.wav,VTTS_b-2_1019-1120_1085.wav,2080,1393,687
8016,b-3_1079-1320_1245.wav,VTTS_b-3_1079-1320_1245.wav,9060,7465,1595
8017,b-4_1814-1900_1892.wav,VTTS_b-4_1814-1900_1892.wav,1790,1800,-10
8018,b-1_1616-1716_1650.wav,VTTS_b-1_1616-1716_1650.wav,1750,1521,229
8019,b-1_2725-2825_2763.wav,VTTS_b-1_2725-2825_2763.wav,4680,11610,-6930
8020,b-4_2000-5164_5059.wav,VTTS_b-4_2000-5164_5059.wav,8551,11250,-2699
8021,b-3_3454-3537_3473.wav,VTTS_b-3_3454-3537_3473.wav,4260,4133,127
8022,b-3_5009-5427_5274.wav,VTTS_b-3_5009-5427_5274.wav,6200,5329,871
8023,b-1_3026-3126_3107.wav,VTTS_b-1_3026-3126_3107.wav,3370,4133,-763
8024,b-3_5009-5427_5091.wav,VTTS_b-3_5009-5427_5091.wav,7250,7314,-64
8025,b-3_1079-1320_1171.wav,VTTS_b-3_1079-1320_1171.wav,3460,3425,35
8026,b-1_3733-3833_3762.wav,VTTS_b-1_3733-3833_3762.wav,3770,5445,-1675
8027,b-3_3279-3363_3287.wav,VTTS_b-3_3279-3363_3287.wav,5410,6223,-813
8028,b-3_3889-4000_3979.wav,VTTS_b-3_3889-4000_3979.wav,4400,4145,255
8029,b-1_2826-2926_2895.wav,VTTS_b-1_2826-2926_2895.wav,3350,5155,-1805
8030,b-2_203-304_301.wav,VTTS_b-2_203-304_301.wav,2820,2879,-59
8031,b-3_501-930_531.wav,VTTS_b-3_501-930_531.wav,6800,9660,-2860
8032,b-3_3198-3278_3273.wav,VTTS_b-3_3198-3278_3273.wav,3430,4470,-1040
8033,b-2_407-508_502.wav,VTTS_b-2_407-508_502.wav,1890,1846,44
8034,b-1_4286-4321_4297.wav,VTTS_b-1_4286-4321_4297.wav,4490,4261,229
8035,b-3_2000-2088_2030.wav,VTTS_b-3_2000-2088_2030.wav,6350,5375,975
8036,b-2_2311-2412_2379.wav,VTTS_b-2_2311-2412_2379.wav,3610,3042,568
8037,b-1_2018-2118_2085.wav,VTTS_b-1_2018-2118_2085.wav,1790,1602,188
8038,b-3_294-391_366.wav,VTTS_b-3_294-391_366.wav,8420,8046,374
8039,b-1_794-1009_996.wav,VTTS_b-1_794-1009_996.wav,4110,4133,-23
8040,b-1_3733-3833_3799.wav,VTTS_b-1_3733-3833_3799.wav,2570,3170,-600
8041,b-2_1325-1426_1342.wav,VTTS_b-2_1325-1426_1342.wav,2800,2299,501
8042,b-1_2119-2219_2169.wav,VTTS_b-1_2119-2219_2169.wav,1780,1741,39
8043,b-2_407-508_436.wav,VTTS_b-2_407-508_436.wav,4160,4365,-205
8044,b-3_3364-3453_3367.wav,VTTS_b-3_3364-3453_3367.wav,4900,5224,-324
8045,b-3_5009-5427_5401.wav,VTTS_b-3_5009-5427_5401.wav,7870,6780,1090
8046,b-4_401-500_453.wav,VTTS_b-4_401-500_453.wav,7550,7012,538
8047,b-3_3889-4000_3921.wav,VTTS_b-3_3889-4000_3921.wav,3480,3413,67
8048,b-3_1764-1861_1774.wav,VTTS_b-3_1764-1861_1774.wav,4990,5039,-49
8049,b-4_2000-5164_4050.wav,VTTS_b-4_2000-5164_4050.wav,5197,5909,-712
8050,b-2_2413-2500_2467.wav,VTTS_b-2_2413-2500_2467.wav,1530,1416,114
8051,b-3_6217-6274_6243.wav,VTTS_b-3_6217-6274_6243.wav,1680,1683,-3
8052,b-3_1-97_28.wav,VTTS_b-3_1-97_28.wav,3510,3216,294
8053,b-2_101-202_200.wav,VTTS_b-2_101-202_200.wav,2110,2473,-363
8054,b-3_6801-6900_6881.wav,VTTS_b-3_6801-6900_6881.wav,2790,2995,-205
8055,b-1_1212-1312_1218.wav,VTTS_b-1_1212-1312_1218.wav,2020,2159,-139
8056,b-2_1019-1120_1028.wav,VTTS_b-2_1019-1120_1028.wav,2580,2821,-241
8057,b-4_1301-1400_1391.wav,VTTS_b-4_1301-1400_1391.wav,4010,3471,539
8058,b-3_5639-5744_5669.wav,VTTS_b-3_5639-5744_5669.wav,6390,6362,28
8059,b-4_2000-5164_4922.wav,VTTS_b-4_2000-5164_4922.wav,7082,7024,58
8060,b-1_3430-3530_3527.wav,VTTS_b-1_3430-3530_3527.wav,2860,3669,-809
8061,b-2_1325-1426_1368.wav,VTTS_b-2_1325-1426_1368.wav,1770,1486,284
8062,b-4_2000-5164_2100.wav,VTTS_b-4_2000-5164_2100.wav,4590,4203,387
8063,b-1_1010-1110_1041.wav,VTTS_b-1_1010-1110_1041.wav,2550,2415,135
8064,b-1_3632-3732_3706.wav,VTTS_b-1_3632-3732_3706.wav,1010,1022,-12
8065,b-1_3531-3631_3627.wav,VTTS_b-1_3531-3631_3627.wav,1800,1811,-11
8066,b-3_2943-3024_2956.wav,VTTS_b-3_2943-3024_2956.wav,7770,8208,-438
8067,b-1_2220-2320_2232.wav,VTTS_b-1_2220-2320_2232.wav,2280,2473,-193
8068,b-1_1616-1716_1703.wav,VTTS_b-1_1616-1716_1703.wav,2460,2206,254
8069,b-4_2000-5164_2059.wav,VTTS_b-4_2000-5164_2059.wav,2835,2763,72
8070,b-3_294-391_380.wav,VTTS_b-3_294-391_380.wav,2960,2984,-24
8071,b-4_1221-1300_1267.wav,VTTS_b-4_1221-1300_1267.wav,6740,6211,529
8072,b-1_4070-4105_4083.wav,VTTS_b-1_4070-4105_4083.wav,1140,1254,-114
8073,b-4_2000-5164_4096.wav,VTTS_b-4_2000-5164_4096.wav,5421,5631,-210
8074,b-1_2119-2219_2192.wav,VTTS_b-1_2119-2219_2192.wav,2970,2856,114
8075,b-4_2000-5164_2499.wav,VTTS_b-4_2000-5164_2499.wav,2110,1985,125
8076,b-3_4104-4206_4179.wav,VTTS_b-3_4104-4206_4179.wav,3510,3228,282
8077,b-3_2524-2854_2525.wav,VTTS_b-3_2524-2854_2525.wav,5190,5097,93
8078,b-4_501-1014_821.wav,VTTS_b-4_501-1014_821.wav,6310,8220,-1910
8079,b-4_53-150_56.wav,VTTS_b-4_53-150_56.wav,9040,8417,623
8080,b-2_1-100_65.wav,VTTS_b-2_1-100_65.wav,1590,1904,-314
8081,b-2_1-100_37.wav,VTTS_b-2_1-100_37.wav,2750,3239,-489
8082,b-1_2321-2421_2348.wav,VTTS_b-1_2321-2421_2348.wav,1970,1753,217
8083,b-4_1901-2000_1911.wav,VTTS_b-4_1901-2000_1911.wav,4060,4748,-688
8084,b-4_1221-1300_1290.wav,VTTS_b-4_1221-1300_1290.wav,4620,4458,162
8085,b-3_5009-5427_5210.wav,VTTS_b-3_5009-5427_5210.wav,6950,7152,-202
8086,b-4_301-400_331.wav,VTTS_b-4_301-400_331.wav,1830,1823,7
8087,b-4_53-150_106.wav,VTTS_b-4_53-150_106.wav,7410,7477,-67
8088,b-4_2000-5164_5082.wav,VTTS_b-4_2000-5164_5082.wav,4592,4133,459
8089,b-3_2524-2854_2740.wav,VTTS_b-3_2524-2854_2740.wav,2500,2647,-147
8090,b-4_2000-5164_2492.wav,VTTS_b-4_2000-5164_2492.wav,5140,5004,136
8091,b-4_2000-5164_3883.wav,VTTS_b-4_2000-5164_3883.wav,6237,6745,-508
8092,b-3_1568-1665_1642.wav,VTTS_b-3_1568-1665_1642.wav,2560,2554,6
8093,b-3_2000-2088_2024.wav,VTTS_b-3_2000-2088_2024.wav,3510,3657,-147
8094,b-4_2000-5164_4590.wav,VTTS_b-4_2000-5164_4590.wav,4301,4667,-366
8095,b-1_1515-1615_1564.wav,VTTS_b-1_1515-1615_1564.wav,2400,3448,-1048
8096,b-3_6016-6115_6026.wav,VTTS_b-3_6016-6115_6026.wav,5530,4656,874
8097,b-4_501-1014_525.wav,VTTS_b-4_501-1014_525.wav,850,685,165
8098,b-3_4001-4103_4060.wav,VTTS_b-3_4001-4103_4060.wav,3800,3611,189
8099,b-4_2000-5164_4575.wav,VTTS_b-4_2000-5164_4575.wav,14035,11610,2425
8100,b-1_3228-3328_3327.wav,VTTS_b-1_3228-3328_3327.wav,2830,3355,-525
8101,b-3_2177-2266_2242.wav,VTTS_b-3_2177-2266_2242.wav,3780,3181,599
8102,b-3_294-391_320.wav,VTTS_b-3_294-391_320.wav,4680,4226,454
8103,b-3_931-979_945.wav,VTTS_b-3_931-979_945.wav,3330,3843,-513
8104,b-3_3715-3802_3742.wav,VTTS_b-3_3715-3802_3742.wav,2940,3019,-79
8105,b-3_501-930_663.wav,VTTS_b-3_501-930_663.wav,8920,8150,770
8106,b-2_1903-2038_1966.wav,VTTS_b-2_1903-2038_1966.wav,4530,4725,-195
8107,b-4_2000-5164_3573.wav,VTTS_b-4_2000-5164_3573.wav,5937,5817,120
8108,b-1_1919-2017_1975.wav,VTTS_b-1_1919-2017_1975.wav,1490,1451,39
8109,b-3_1568-1665_1585.wav,VTTS_b-3_1568-1665_1585.wav,3020,2705,315
8110,b-4_1301-1400_1307.wav,VTTS_b-4_1301-1400_1307.wav,5930,4772,1158
8111,b-3_2524-2854_2794.wav,VTTS_b-3_2524-2854_2794.wav,10860,9996,864
8112,b-2_713-814_800.wav,VTTS_b-2_713-814_800.wav,2640,2949,-309
8113,b-3_1862-1959_1865.wav,VTTS_b-3_1862-1959_1865.wav,3800,3518,282
8114,b-3_4104-4206_4110.wav,VTTS_b-3_4104-4206_4110.wav,9550,8998,552
8115,b-3_1960-2000_1961.wav,VTTS_b-3_1960-2000_1961.wav,6140,5190,950
8116,b-3_6900-7016_6967.wav,VTTS_b-3_6900-7016_6967.wav,3740,3796,-56
8117,b-2_611-712_716.wav,VTTS_b-2_611-712_716.wav,3600,3019,581
8118,b-3_6601-6700_6615.wav,VTTS_b-3_6601-6700_6615.wav,3310,4586,-1276
8119,b-1_3834-3934_3931.wav,VTTS_b-1_3834-3934_3931.wav,1700,1683,17
8120,b-3_6016-6115_6033.wav,VTTS_b-3_6016-6115_6033.wav,4040,3750,290
8121,b-4_2000-5164_4192.wav,VTTS_b-4_2000-5164_4192.wav,3813,3332,481
8122,b-2_2040-2072_2072.wav,VTTS_b-2_2040-2072_2072.wav,1950,1962,-12
8123,b-4_1814-1900_1837.wav,VTTS_b-4_1814-1900_1837.wav,3480,3866,-386
8124,b-2_509-610_555.wav,VTTS_b-2_509-610_555.wav,2990,3483,-493
8125,b-2_101-202_187.wav,VTTS_b-2_101-202_187.wav,3470,3611,-141
8126,b-3_3198-3278_3209.wav,VTTS_b-3_3198-3278_3209.wav,5510,11610,-6100
8127,b-3_2434-2523_2478.wav,VTTS_b-3_2434-2523_2478.wav,6690,6142,548
8128,b-3_1666-1763_1690.wav,VTTS_b-3_1666-1763_1690.wav,5740,4679,1061
8129,b-1_1010-1110_1097.wav,VTTS_b-1_1010-1110_1097.wav,4040,3971,69
8130,b-3_6016-6115_6107.wav,VTTS_b-3_6016-6115_6107.wav,9650,9242,408
8131,b-4_501-1014_766.wav,VTTS_b-4_501-1014_766.wav,8360,10344,-1984
8132,b-4_2000-5164_4099.wav,VTTS_b-4_2000-5164_4099.wav,8656,8475,181
8133,b-3_3889-4000_3908.wav,VTTS_b-3_3889-4000_3908.wav,7470,7210,260
8134,b-4_2000-5164_4873.wav,VTTS_b-4_2000-5164_4873.wav,6183,6815,-632
8135,b-3_1079-1320_1242.wav,VTTS_b-3_1079-1320_1242.wav,5590,5364,226
8136,b-4_2000-5164_2218.wav,VTTS_b-4_2000-5164_2218.wav,3970,5654,-1684
8137,b-4_2000-5164_2787.wav,VTTS_b-4_2000-5164_2787.wav,4630,4470,160
8138,b-1_1919-2017_1931.wav,VTTS_b-1_1919-2017_1931.wav,5110,4946,164
8139,b-4_2000-5164_3482.wav,VTTS_b-4_2000-5164_3482.wav,2571,2450,121
8140,b-3_5957-6015_5974.wav,VTTS_b-3_5957-6015_5974.wav,4490,4365,125
8141,b-1_2321-2421_2339.wav,VTTS_b-1_2321-2421_2339.wav,4470,4342,128
8142,b-2_101-202_198.wav,VTTS_b-2_101-202_198.wav,2900,2798,102
8143,b-2_305-406_391.wav,VTTS_b-2_305-406_391.wav,1410,3135,-1725
8144,b-3_2524-2854_2577.wav,VTTS_b-3_2524-2854_2577.wav,8800,10681,-1881
8145,b-3_3198-3278_3242.wav,VTTS_b-3_3198-3278_3242.wav,5900,5526,374
8146,b-2_1121-1222_1199.wav,VTTS_b-2_1121-1222_1199.wav,2590,1997,593
8147,b-3_5009-5427_5189.wav,VTTS_b-3_5009-5427_5189.wav,5160,5050,110
8148,b-1_4070-4105_4072.wav,VTTS_b-1_4070-4105_4072.wav,2580,2728,-148
8149,b-4_2000-5164_3237.wav,VTTS_b-4_2000-5164_3237.wav,2742,4110,-1368
8150,b-3_6116-6215_6129.wav,VTTS_b-3_6116-6215_6129.wav,5280,5236,44
8151,b-1_794-1009_794.wav,VTTS_b-1_794-1009_794.wav,3520,3135,385
8152,b-1_4430-4465_4456.wav,VTTS_b-1_4430-4465_4456.wav,2700,2914,-214
8153,b-3_3454-3537_3512.wav,VTTS_b-3_3454-3537_3512.wav,4610,4690,-80
8154,b-4_1221-1300_1229.wav,VTTS_b-4_1221-1300_1229.wav,6220,7721,-1501
8155,b-1_3127-3227_3184.wav,VTTS_b-1_3127-3227_3184.wav,2450,3239,-789
8156,b-3_3538-3627_3604.wav,VTTS_b-3_3538-3627_3604.wav,5350,4853,497
8157,b-4_401-500_486.wav,VTTS_b-4_401-500_486.wav,1650,1591,59
8158,b-3_2524-2854_2558.wav,VTTS_b-3_2524-2854_2558.wav,10260,10484,-224
8159,b-1_1111-1211_1178.wav,VTTS_b-1_1111-1211_1178.wav,1930,1602,328
8160,b-2_1121-1222_1180.wav,VTTS_b-2_1121-1222_1180.wav,2030,1776,254
8161,b-1_1414-1514_1430.wav,VTTS_b-1_1414-1514_1430.wav,1300,1207,93
8162,b-1_3935-4033_3983.wav,VTTS_b-1_3935-4033_3983.wav,1060,1057,3
8163,b-3_98-195_154.wav,VTTS_b-3_98-195_154.wav,5390,5004,386
8164,b-4_2000-5164_2886.wav,VTTS_b-4_2000-5164_2886.wav,2220,2020,200
8165,b-4_1014-1100_1014.wav,VTTS_b-4_1014-1100_1014.wav,1550,1335,215
8166,b-4_501-1014_625.wav,VTTS_b-4_501-1014_625.wav,11740,10437,1303
8167,b-3_1862-1959_1880.wav,VTTS_b-3_1862-1959_1880.wav,5160,5410,-250
8168,b-1_1313-1413_1380.wav,VTTS_b-1_1313-1413_1380.wav,3590,3332,258
8169,b-2_611-712_654.wav,VTTS_b-2_611-712_654.wav,2970,3541,-571
8170,b-1_1111-1211_1211.wav,VTTS_b-1_1111-1211_1211.wav,2290,2241,49
8171,b-1_3228-3328_3274.wav,VTTS_b-1_3228-3328_3274.wav,880,894,-14
8172,b-3_4607-5008_4886.wav,VTTS_b-3_4607-5008_4886.wav,1380,1393,-13
8173,b-2_1019-1120_1039.wav,VTTS_b-2_1019-1120_1039.wav,3010,3553,-543
8174,b-1_276-376_371.wav,VTTS_b-1_276-376_371.wav,1100,1126,-26
8175,b-4_2000-5164_2020.wav,VTTS_b-4_2000-5164_2020.wav,3010,3831,-821
8176,b-4_2000-5164_3116.wav,VTTS_b-4_2000-5164_3116.wav,6587,8603,-2016
8177,b-3_4498-4605_4594.wav,VTTS_b-3_4498-4605_4594.wav,6060,6397,-337
8178,b-4_2000-5164_4662.wav,VTTS_b-4_2000-5164_4662.wav,2331,1997,334
8179,b-1_686-793_690.wav,VTTS_b-1_686-793_690.wav,5200,4911,289
8180,b-1_794-1009_970.wav,VTTS_b-1_794-1009_970.wav,1400,1324,76
8181,b-1_3329-3429_3373.wav,VTTS_b-1_3329-3429_3373.wav,3480,3402,78
8182,b-3_5009-5427_5393.wav,VTTS_b-3_5009-5427_5393.wav,2180,2148,32
8183,b-1_2523-2623_2555.wav,VTTS_b-1_2523-2623_2555.wav,1740,1649,91
8184,b-4_501-1014_676.wav,VTTS_b-4_501-1014_676.wav,3980,3785,195
8185,b-2_1903-2038_1991.wav,VTTS_b-2_1903-2038_1991.wav,1050,964,86
8186,b-2_1597-1698_1638.wav,VTTS_b-2_1597-1698_1638.wav,5190,4447,743
8187,b-3_6016-6115_6061.wav,VTTS_b-3_6016-6115_6061.wav,4400,4075,325
8188,b-2_407-508_505.wav,VTTS_b-2_407-508_505.wav,3230,4470,-1240
8189,b-4_2000-5164_4999.wav,VTTS_b-4_2000-5164_4999.wav,9247,8754,493
8190,b-3_6274-6300_6289.wav,VTTS_b-3_6274-6300_6289.wav,6880,7047,-167
8191,b-2_407-508_454.wav,VTTS_b-2_407-508_454.wav,5650,6351,-701
8192,b-1_3632-3732_3669.wav,VTTS_b-1_3632-3732_3669.wav,4250,3878,372
8193,b-3_6501-6600_6573.wav,VTTS_b-3_6501-6600_6573.wav,1090,1080,10
8194,b-1_3733-3833_3827.wav,VTTS_b-1_3733-3833_3827.wav,1720,1916,-196
8195,b-4_501-1014_836.wav,VTTS_b-4_501-1014_836.wav,7380,6188,1192
8196,b-4_501-1014_974.wav,VTTS_b-4_501-1014_974.wav,4190,4052,138
8197,b-4_2000-5164_4799.wav,VTTS_b-4_2000-5164_4799.wav,13681,11610,2071
8198,b-2_1223-1324_1304.wav,VTTS_b-2_1223-1324_1304.wav,1330,1173,157
8199,b-3_2524-2854_2704.wav,VTTS_b-3_2524-2854_2704.wav,5490,5631,-141
8200,b-3_5745-5852_5766.wav,VTTS_b-3_5745-5852_5766.wav,5210,5306,-96
8201,b-2_305-406_316.wav,VTTS_b-2_305-406_316.wav,3880,7129,-3249
8202,b-3_6301-6400_6363.wav,VTTS_b-3_6301-6400_6363.wav,2580,2241,339
8203,b-4_2000-5164_4177.wav,VTTS_b-4_2000-5164_4177.wav,4016,4760,-744
8204,b-2_815-916_872.wav,VTTS_b-2_815-916_872.wav,1640,1695,-55
8205,b-1_1717-1817_1754.wav,VTTS_b-1_1717-1817_1754.wav,2740,2543,197
8206,b-2_713-814_728.wav,VTTS_b-2_713-814_728.wav,6190,6943,-753
8207,b-4_2000-5164_5124.wav,VTTS_b-4_2000-5164_5124.wav,5475,5224,251
8208,b-4_2000-5164_2111.wav,VTTS_b-4_2000-5164_2111.wav,5720,5921,-201
8209,b-3_2943-3024_2954.wav,VTTS_b-3_2943-3024_2954.wav,3120,3274,-154
8210,b-3_1079-1320_1110.wav,VTTS_b-3_1079-1320_1110.wav,8840,7976,864
8211,b-2_2311-2412_2315.wav,VTTS_b-2_2311-2412_2315.wav,5450,5596,-146
8212,b-1_1818-1918_1910.wav,VTTS_b-1_1818-1918_1910.wav,1720,1498,222
8213,b-4_2000-5164_4048.wav,VTTS_b-4_2000-5164_4048.wav,4183,4168,15
8214,b-3_294-391_374.wav,VTTS_b-3_294-391_374.wav,3520,3123,397
8215,b-1_3127-3227_3211.wav,VTTS_b-1_3127-3227_3211.wav,2560,3123,-563
8216,b-3_1321-1568_1436.wav,VTTS_b-3_1321-1568_1436.wav,3070,2926,144
8217,b-2_713-814_732.wav,VTTS_b-2_713-814_732.wav,1670,3622,-1952
8218,b-1_2523-2623_2607.wav,VTTS_b-1_2523-2623_2607.wav,2260,2125,135
8219,b-3_6116-6215_6172.wav,VTTS_b-3_6116-6215_6172.wav,5380,5468,-88
8220,b-3_5009-5427_5327.wav,VTTS_b-3_5009-5427_5327.wav,7100,6560,540
8221,b-4_2000-5164_2105.wav,VTTS_b-4_2000-5164_2105.wav,3140,2914,226
8222,b-2_305-406_349.wav,VTTS_b-2_305-406_349.wav,4430,4249,181
8223,b-2_305-406_363.wav,VTTS_b-2_305-406_363.wav,4040,5294,-1254
8224,b-3_2943-3024_2999.wav,VTTS_b-3_2943-3024_2999.wav,6780,7175,-395
8225,b-3_3198-3278_3228.wav,VTTS_b-3_3198-3278_3228.wav,7320,7012,308
8226,b-4_2000-5164_4757.wav,VTTS_b-4_2000-5164_4757.wav,2164,1950,214
8227,b-3_4607-5008_4968.wav,VTTS_b-3_4607-5008_4968.wav,3370,3181,189
8228,b-3_2943-3024_2950.wav,VTTS_b-3_2943-3024_2950.wav,3930,6525,-2595
8229,b-2_1699-1800_1764.wav,VTTS_b-2_1699-1800_1764.wav,1590,1126,464
8230,b-3_1-97_90.wav,VTTS_b-3_1-97_90.wav,5880,5317,563
8231,b-4_2000-5164_2460.wav,VTTS_b-4_2000-5164_2460.wav,3760,3181,579
8232,b-1_3329-3429_3427.wav,VTTS_b-1_3329-3429_3427.wav,1150,1068,82
8233,b-1_1414-1514_1490.wav,VTTS_b-1_1414-1514_1490.wav,2800,2496,304
8234,b-3_3889-4000_3982.wav,VTTS_b-3_3889-4000_3982.wav,3170,3332,-162
8235,b-4_2000-5164_3315.wav,VTTS_b-4_2000-5164_3315.wav,3374,3785,-411
8236,b-2_1427-1562_1494.wav,VTTS_b-2_1427-1562_1494.wav,1640,1602,38
8237,b-2_407-508_455.wav,VTTS_b-2_407-508_455.wav,4440,4400,40
8238,b-1_1-73_20.wav,VTTS_b-1_1-73_20.wav,2540,2844,-304
8239,b-1_478-578_557.wav,VTTS_b-1_478-578_557.wav,3960,4528,-568
8240,b-4_2000-5164_4235.wav,VTTS_b-4_2000-5164_4235.wav,9122,8928,194
8241,b-4_1221-1300_1276.wav,VTTS_b-4_1221-1300_1276.wav,4070,4156,-86
8242,b-2_1121-1222_1125.wav,VTTS_b-2_1121-1222_1125.wav,3450,2264,1186
8243,b-3_2089-2176_2095.wav,VTTS_b-3_2089-2176_2095.wav,4220,3228,992
8244,b-4_1707-1813_1765.wav,VTTS_b-4_1707-1813_1765.wav,7230,6885,345
8245,b-1_1616-1716_1620.wav,VTTS_b-1_1616-1716_1620.wav,4410,5120,-710
8246,b-3_2177-2266_2236.wav,VTTS_b-3_2177-2266_2236.wav,3980,3982,-2
8247,b-4_2000-5164_2973.wav,VTTS_b-4_2000-5164_2973.wav,5579,5909,-330
8248,b-3_196-293_262.wav,VTTS_b-3_196-293_262.wav,4570,10809,-6239
8249,b-3_501-930_930.wav,VTTS_b-3_501-930_930.wav,6230,6037,193
8250,b-3_4607-5008_4873.wav,VTTS_b-3_4607-5008_4873.wav,5740,5050,690
8251,b-3_1764-1861_1773.wav,VTTS_b-3_1764-1861_1773.wav,5620,5538,82
8252,b-1_794-1009_924.wav,VTTS_b-1_794-1009_924.wav,3440,3622,-182
8253,b-4_2000-5164_3338.wav,VTTS_b-4_2000-5164_3338.wav,2790,3518,-728
8254,b-4_2000-5164_2522.wav,VTTS_b-4_2000-5164_2522.wav,6090,6525,-435
8255,b-4_2000-5164_2175.wav,VTTS_b-4_2000-5164_2175.wav,2075,2264,-189
8256,b-1_686-793_793.wav,VTTS_b-1_686-793_793.wav,2550,2299,251
8257,b-1_686-793_703.wav,VTTS_b-1_686-793_703.wav,2130,2647,-517
8258,b-3_501-930_644.wav,VTTS_b-3_501-930_644.wav,3210,3030,180
8259,b-4_2000-5164_2227.wav,VTTS_b-4_2000-5164_2227.wav,6370,5968,402
8260,b-3_5009-5427_5032.wav,VTTS_b-3_5009-5427_5032.wav,2380,2508,-128
8261,b-1_276-376_305.wav,VTTS_b-1_276-376_305.wav,1880,2194,-314
8262,b-1_3228-3328_3270.wav,VTTS_b-1_3228-3328_3270.wav,2010,1741,269
8263,b-4_2000-5164_4786.wav,VTTS_b-4_2000-5164_4786.wav,4904,6060,-1156
8264,b-1_4070-4105_4100.wav,VTTS_b-1_4070-4105_4100.wav,3830,3448,382
8265,b-3_3364-3453_3420.wav,VTTS_b-3_3364-3453_3420.wav,7670,6513,1157
8266,b-1_2119-2219_2168.wav,VTTS_b-1_2119-2219_2168.wav,2930,3251,-321
8267,b-3_5853-5956_5870.wav,VTTS_b-3_5853-5956_5870.wav,2870,2705,165
8268,b-4_2000-5164_3625.wav,VTTS_b-4_2000-5164_3625.wav,7206,7895,-689
8269,b-3_196-293_234.wav,VTTS_b-3_196-293_234.wav,9100,11610,-2510
8270,b-3_1666-1763_1671.wav,VTTS_b-3_1666-1763_1671.wav,8620,8557,63
8271,b-3_4607-5008_4651.wav,VTTS_b-3_4607-5008_4651.wav,4780,3924,856
8272,b-3_1321-1568_1348.wav,VTTS_b-3_1321-1568_1348.wav,3320,3680,-360
8273,b-3_4001-4103_4021.wav,VTTS_b-3_4001-4103_4021.wav,3760,4145,-385
8274,b-4_501-1014_913.wav,VTTS_b-4_501-1014_913.wav,6950,6606,344
8275,b-3_1079-1320_1153.wav,VTTS_b-3_1079-1320_1153.wav,3900,3727,173
8276,b-1_3329-3429_3345.wav,VTTS_b-1_3329-3429_3345.wav,3840,3796,44
8277,b-3_5009-5427_5256.wav,VTTS_b-3_5009-5427_5256.wav,3060,3158,-98
8278,b-3_4607-5008_4737.wav,VTTS_b-3_4607-5008_4737.wav,4400,4934,-534
8279,b-4_2000-5164_3049.wav,VTTS_b-4_2000-5164_3049.wav,6087,5689,398
8280,b-1_1414-1514_1415.wav,VTTS_b-1_1414-1514_1415.wav,2990,3947,-957
8281,b-1_2624-2724_2668.wav,VTTS_b-1_2624-2724_2668.wav,4190,4307,-117
8282,b-4_2000-5164_3263.wav,VTTS_b-4_2000-5164_3263.wav,3679,3634,45
8283,b-4_1301-1400_1315.wav,VTTS_b-4_1301-1400_1315.wav,2470,2380,90
8284,b-4_1601-1706_1620.wav,VTTS_b-4_1601-1706_1620.wav,8810,7663,1147
8285,b-3_2350-2433_2428.wav,VTTS_b-3_2350-2433_2428.wav,8320,7454,866
8286,b-4_2000-5164_2792.wav,VTTS_b-4_2000-5164_2792.wav,3980,3808,172
8287,b-4_2000-5164_3356.wav,VTTS_b-4_2000-5164_3356.wav,2950,3146,-196
8288,b-3_4207-4314_4271.wav,VTTS_b-3_4207-4314_4271.wav,5220,4667,553
8289,b-1_2624-2724_2654.wav,VTTS_b-1_2624-2724_2654.wav,1600,1614,-14
8290,b-2_1427-1562_1540.wav,VTTS_b-2_1427-1562_1540.wav,7840,8394,-554
8291,b-3_931-979_973.wav,VTTS_b-3_931-979_973.wav,4900,4714,186
8292,b-3_6116-6215_6117.wav,VTTS_b-3_6116-6215_6117.wav,3460,3657,-197
8293,b-1_4106-4141_4118.wav,VTTS_b-1_4106-4141_4118.wav,1810,3216,-1406
8294,b-3_3538-3627_3591.wav,VTTS_b-3_3538-3627_3591.wav,1070,1149,-79
8295,b-3_4207-4314_4264.wav,VTTS_b-3_4207-4314_4264.wav,4180,3448,732
8296,b-4_2000-5164_5048.wav,VTTS_b-4_2000-5164_5048.wav,4488,4110,378
8297,b-4_401-500_492.wav,VTTS_b-4_401-500_492.wav,4880,5224,-344
8298,b-3_5009-5427_5093.wav,VTTS_b-3_5009-5427_5093.wav,3680,3669,11
8299,b-4_2000-5164_5018.wav,VTTS_b-4_2000-5164_5018.wav,3164,3077,87
8300,b-3_3889-4000_3940.wav,VTTS_b-3_3889-4000_3940.wav,1070,1126,-56
8301,b-3_3025-3111_3094.wav,VTTS_b-3_3025-3111_3094.wav,7420,7303,117
8302,b-4_1506-1600_1563.wav,VTTS_b-4_1506-1600_1563.wav,4510,3483,1027
8303,b-2_1801-1902_1849.wav,VTTS_b-2_1801-1902_1849.wav,1140,1149,-9
8304,b-2_1563-1596_1575.wav,VTTS_b-2_1563-1596_1575.wav,3280,2612,668
8305,b-4_1014-1100_1058.wav,VTTS_b-4_1014-1100_1058.wav,1940,1776,164
8306,b-4_1401-1505_1481.wav,VTTS_b-4_1401-1505_1481.wav,5100,5016,84
8307,b-3_5745-5852_5836.wav,VTTS_b-3_5745-5852_5836.wav,6010,6513,-503
8308,b-4_2000-5164_4620.wav,VTTS_b-4_2000-5164_4620.wav,2514,2543,-29
8309,b-4_2000-5164_2084.wav,VTTS_b-4_2000-5164_2084.wav,1320,871,449
8310,b-2_1699-1800_1795.wav,VTTS_b-2_1699-1800_1795.wav,3600,3042,558
8311,b-1_3935-4033_3961.wav,VTTS_b-1_3935-4033_3961.wav,1400,1370,30
8312,b-3_5428-5533_5495.wav,VTTS_b-3_5428-5533_5495.wav,5820,6200,-380
8313,b-3_2434-2523_2508.wav,VTTS_b-3_2434-2523_2508.wav,5320,5213,107
8314,b-4_2000-5164_3708.wav,VTTS_b-4_2000-5164_3708.wav,7245,9033,-1788
8315,b-1_650-685_682.wav,VTTS_b-1_650-685_682.wav,2740,2415,325
8316,b-1_2725-2825_2814.wav,VTTS_b-1_2725-2825_2814.wav,1040,1022,18
8317,b-4_301-400_315.wav,VTTS_b-4_301-400_315.wav,5270,4853,417
8318,b-3_1321-1568_1474.wav,VTTS_b-3_1321-1568_1474.wav,6770,7187,-417
8319,b-3_1666-1763_1678.wav,VTTS_b-3_1666-1763_1678.wav,7060,6560,500
8320,b-4_2000-5164_4641.wav,VTTS_b-4_2000-5164_4641.wav,3610,3297,313
8321,b-3_3025-3111_3070.wav,VTTS_b-3_3025-3111_3070.wav,6280,6792,-512
8322,b-4_2000-5164_4151.wav,VTTS_b-4_2000-5164_4151.wav,3127,2984,143
8323,b-4_1707-1813_1716.wav,VTTS_b-4_1707-1813_1716.wav,10390,9776,614
8324,b-4_2000-5164_2438.wav,VTTS_b-4_2000-5164_2438.wav,2160,2299,-139
8325,b-2_713-814_726.wav,VTTS_b-2_713-814_726.wav,1790,2206,-416
8326,b-3_6401-6500_6483.wav,VTTS_b-3_6401-6500_6483.wav,1610,1660,-50
8327,b-3_6301-6400_6345.wav,VTTS_b-3_6301-6400_6345.wav,6310,6827,-517
8328,b-4_1221-1300_1298.wav,VTTS_b-4_1221-1300_1298.wav,4700,4644,56
8329,b-1_2220-2320_2224.wav,VTTS_b-1_2220-2320_2224.wav,2240,2113,127
8330,b-1_1818-1918_1819.wav,VTTS_b-1_1818-1918_1819.wav,1140,1277,-137
8331,b-1_1212-1312_1239.wav,VTTS_b-1_1212-1312_1239.wav,2510,2159,351
8332,b-3_1079-1320_1282.wav,VTTS_b-3_1079-1320_1282.wav,2870,4017,-1147
8333,b-1_175-275_265.wav,VTTS_b-1_175-275_265.wav,1670,1718,-48
8334,b-2_2107-2193_2126.wav,VTTS_b-2_2107-2193_2126.wav,1370,1428,-58
8335,b-4_1601-1706_1693.wav,VTTS_b-4_1601-1706_1693.wav,3420,3262,158
8336,b-3_6301-6400_6362.wav,VTTS_b-3_6301-6400_6362.wav,1550,1649,-99
8337,b-1_2018-2118_2030.wav,VTTS_b-1_2018-2118_2030.wav,2440,2403,37
8338,b-2_2311-2412_2366.wav,VTTS_b-2_2311-2412_2366.wav,3290,3680,-390
8339,b-3_3364-3453_3431.wav,VTTS_b-3_3364-3453_3431.wav,2740,2937,-197
8340,b-2_407-508_495.wav,VTTS_b-2_407-508_495.wav,1960,1451,509
8341,b-4_2000-5164_2202.wav,VTTS_b-4_2000-5164_2202.wav,2600,2961,-361
8342,b-1_2725-2825_2804.wav,VTTS_b-1_2725-2825_2804.wav,4020,4644,-624
8343,b-4_2000-5164_4670.wav,VTTS_b-4_2000-5164_4670.wav,4171,4365,-194
8344,b-4_1101-1220_1117.wav,VTTS_b-4_1101-1220_1117.wav,8770,8487,283
8345,b-1_3026-3126_3120.wav,VTTS_b-1_3026-3126_3120.wav,3420,3750,-330
8346,b-4_1601-1706_1619.wav,VTTS_b-4_1601-1706_1619.wav,11110,10960,150
8347,b-1_1818-1918_1883.wav,VTTS_b-1_1818-1918_1883.wav,1580,1335,245
8348,b-4_2000-5164_5101.wav,VTTS_b-4_2000-5164_5101.wav,13561,11610,1951
8349,b-3_3628-3714_3641.wav,VTTS_b-3_3628-3714_3641.wav,6750,7697,-947
8350,b-4_2000-5164_5055.wav,VTTS_b-4_2000-5164_5055.wav,4872,4934,-62
8351,b-2_1903-2038_1922.wav,VTTS_b-2_1903-2038_1922.wav,1140,1881,-741
8352,b-1_1717-1817_1805.wav,VTTS_b-1_1717-1817_1805.wav,2360,2101,259
8353,b-4_53-150_64.wav,VTTS_b-4_53-150_64.wav,8880,8022,858
8354,b-3_6900-7016_6973.wav,VTTS_b-3_6900-7016_6973.wav,4540,4574,-34
8355,b-3_2524-2854_2756.wav,VTTS_b-3_2524-2854_2756.wav,8760,9067,-307
8356,b-3_5428-5533_5431.wav,VTTS_b-3_5428-5533_5431.wav,3180,3344,-164
8357,b-3_3715-3802_3773.wav,VTTS_b-3_3715-3802_3773.wav,1940,2601,-661
8358,b-1_1212-1312_1257.wav,VTTS_b-1_1212-1312_1257.wav,2950,2287,663
8359,b-4_2000-5164_4013.wav,VTTS_b-4_2000-5164_4013.wav,3313,3228,85
8360,b-1_1111-1211_1148.wav,VTTS_b-1_1111-1211_1148.wav,4820,5352,-532
8361,b-3_4498-4605_4578.wav,VTTS_b-3_4498-4605_4578.wav,4650,4981,-331
8362,b-1_686-793_778.wav,VTTS_b-1_686-793_778.wav,1090,1033,57
8363,b-1_2725-2825_2729.wav,VTTS_b-1_2725-2825_2729.wav,1700,1602,98
8364,b-4_2000-5164_2575.wav,VTTS_b-4_2000-5164_2575.wav,4895,4818,77
8365,b-1_794-1009_1000.wav,VTTS_b-1_794-1009_1000.wav,3860,4923,-1063
8366,b-4_1101-1220_1115.wav,VTTS_b-4_1101-1220_1115.wav,2020,1625,395
8367,b-2_407-508_437.wav,VTTS_b-2_407-508_437.wav,4700,5364,-664
8368,b-3_392-500_393.wav,VTTS_b-3_392-500_393.wav,4070,4447,-377
8369,b-4_1221-1300_1224.wav,VTTS_b-4_1221-1300_1224.wav,6680,7465,-785
8370,b-4_2000-5164_2989.wav,VTTS_b-4_2000-5164_2989.wav,9497,9346,151
8371,b-4_501-1014_708.wav,VTTS_b-4_501-1014_708.wav,3220,2926,294
8372,b-4_501-1014_902.wav,VTTS_b-4_501-1014_902.wav,5310,5062,248
8373,b-4_151-300_200.wav,VTTS_b-4_151-300_200.wav,2360,2299,61
8374,b-4_2000-5164_4729.wav,VTTS_b-4_2000-5164_4729.wav,3459,3750,-291
8375,b-4_2000-5164_2330.wav,VTTS_b-4_2000-5164_2330.wav,3640,3866,-226
8376,b-4_1506-1600_1597.wav,VTTS_b-4_1506-1600_1597.wav,3650,3936,-286
8377,b-4_2000-5164_2469.wav,VTTS_b-4_2000-5164_2469.wav,7635,7303,332
8378,b-1_1616-1716_1633.wav,VTTS_b-1_1616-1716_1633.wav,4280,5132,-852
8379,b-3_5009-5427_5381.wav,VTTS_b-3_5009-5427_5381.wav,3290,2926,364
8380,b-3_392-500_427.wav,VTTS_b-3_392-500_427.wav,7410,7407,3
8381,b-4_1401-1505_1410.wav,VTTS_b-4_1401-1505_1410.wav,4330,4180,150
8382,b-1_1616-1716_1648.wav,VTTS_b-1_1616-1716_1648.wav,2070,1846,224
8383,b-3_5533-5638_5572.wav,VTTS_b-3_5533-5638_5572.wav,6850,6420,430
8384,b-1_478-578_526.wav,VTTS_b-1_478-578_526.wav,3410,3518,-108
8385,b-2_1699-1800_1766.wav,VTTS_b-2_1699-1800_1766.wav,3650,3982,-332
8386,b-3_5957-6015_6003.wav,VTTS_b-3_5957-6015_6003.wav,2590,2485,105
8387,b-1_2422-2522_2516.wav,VTTS_b-1_2422-2522_2516.wav,2650,2589,61
8388,b-1_3329-3429_3426.wav,VTTS_b-1_3329-3429_3426.wav,3000,2879,121
8389,b-3_5428-5533_5501.wav,VTTS_b-3_5428-5533_5501.wav,4930,4702,228
8390,b-1_3733-3833_3740.wav,VTTS_b-1_3733-3833_3740.wav,2270,2136,134
8391,b-3_501-930_595.wav,VTTS_b-3_501-930_595.wav,5610,5248,362
8392,b-2_1223-1324_1229.wav,VTTS_b-2_1223-1324_1229.wav,1230,1068,162
8393,b-1_2826-2926_2926.wav,VTTS_b-1_2826-2926_2926.wav,4220,4307,-87
8394,b-4_1-52_13.wav,VTTS_b-4_1-52_13.wav,6230,6211,19
8395,b-3_6601-6700_6603.wav,VTTS_b-3_6601-6700_6603.wav,6560,6223,337
8396,b-3_3538-3627_3566.wav,VTTS_b-3_3538-3627_3566.wav,3280,3379,-99
8397,b-4_1301-1400_1389.wav,VTTS_b-4_1301-1400_1389.wav,7750,7732,18
8398,b-3_5745-5852_5776.wav,VTTS_b-3_5745-5852_5776.wav,5890,5445,445
8399,b-1_2220-2320_2239.wav,VTTS_b-1_2220-2320_2239.wav,2150,1985,165
8400,b-4_2000-5164_4610.wav,VTTS_b-4_2000-5164_4610.wav,5712,5526,186
8401,b-3_2434-2523_2466.wav,VTTS_b-3_2434-2523_2466.wav,2310,2322,-12
8402,b-3_4607-5008_4659.wav,VTTS_b-3_4607-5008_4659.wav,4430,4052,378
8403,b-4_501-1014_535.wav,VTTS_b-4_501-1014_535.wav,1430,1138,292
8404,b-1_686-793_697.wav,VTTS_b-1_686-793_697.wav,2260,2496,-236
8405,b-1_4106-4141_4109.wav,VTTS_b-1_4106-4141_4109.wav,4150,4574,-424
8406,b-3_2089-2176_2173.wav,VTTS_b-3_2089-2176_2173.wav,8000,9601,-1601
8407,b-1_1212-1312_1232.wav,VTTS_b-1_1212-1312_1232.wav,2090,1916,174
8408,b-2_1563-1596_1591.wav,VTTS_b-2_1563-1596_1591.wav,10300,11610,-1310
8409,b-2_1903-2038_1916.wav,VTTS_b-2_1903-2038_1916.wav,2500,2624,-124
8410,b-1_1-73_24.wav,VTTS_b-1_1-73_24.wav,4800,6571,-1771
8411,b-1_2826-2926_2913.wav,VTTS_b-1_2826-2926_2913.wav,2010,2171,-161
8412,b-2_305-406_319.wav,VTTS_b-2_305-406_319.wav,1840,2125,-285
8413,b-1_175-275_252.wav,VTTS_b-1_175-275_252.wav,1030,1103,-73
8414,b-3_2943-3024_2944.wav,VTTS_b-3_2943-3024_2944.wav,5080,5526,-446
8415,b-1_74-174_123.wav,VTTS_b-1_74-174_123.wav,3340,3379,-39
8416,b-4_301-400_332.wav,VTTS_b-4_301-400_332.wav,2860,2868,-8
8417,b-4_2000-5164_4573.wav,VTTS_b-4_2000-5164_4573.wav,3569,3332,237
8418,b-3_6401-6500_6411.wav,VTTS_b-3_6401-6500_6411.wav,4990,4876,114
8419,b-4_151-300_167.wav,VTTS_b-4_151-300_167.wav,4390,3855,535
8420,b-2_509-610_576.wav,VTTS_b-2_509-610_576.wav,2720,3019,-299
8421,b-2_1-100_49.wav,VTTS_b-2_1-100_49.wav,2150,2171,-21
8422,b-3_5428-5533_5443.wav,VTTS_b-3_5428-5533_5443.wav,8140,7744,396
8423,b-3_5853-5956_5877.wav,VTTS_b-3_5853-5956_5877.wav,9500,8882,618
8424,b-1_2321-2421_2365.wav,VTTS_b-1_2321-2421_2365.wav,2630,2125,505
8425,b-3_5957-6015_5983.wav,VTTS_b-3_5957-6015_5983.wav,3060,3065,-5
8426,b-1_175-275_206.wav,VTTS_b-1_175-275_206.wav,2020,1985,35
8427,b-4_2000-5164_2562.wav,VTTS_b-4_2000-5164_2562.wav,3520,3646,-126
8428,b-2_1427-1562_1462.wav,VTTS_b-2_1427-1562_1462.wav,2680,2508,172
8429,b-2_2107-2193_2176.wav,VTTS_b-2_2107-2193_2176.wav,2370,2113,257
8430,b-1_1414-1514_1477.wav,VTTS_b-1_1414-1514_1477.wav,1740,1474,266
8431,b-3_2089-2176_2105.wav,VTTS_b-3_2089-2176_2105.wav,3620,3669,-49
8432,b-3_2177-2266_2212.wav,VTTS_b-3_2177-2266_2212.wav,6910,6838,72
8433,b-1_3935-4033_3981.wav,VTTS_b-1_3935-4033_3981.wav,2310,2183,127
8434,b-3_4001-4103_4016.wav,VTTS_b-3_4001-4103_4016.wav,5990,6734,-744
8435,b-4_301-400_323.wav,VTTS_b-4_301-400_323.wav,10340,9358,982
8436,b-3_5009-5427_5185.wav,VTTS_b-3_5009-5427_5185.wav,5300,4934,366
8437,b-3_501-930_514.wav,VTTS_b-3_501-930_514.wav,2720,2624,96
8438,b-1_2927-3025_2989.wav,VTTS_b-1_2927-3025_2989.wav,2030,1637,393
8439,b-3_6801-6900_6812.wav,VTTS_b-3_6801-6900_6812.wav,3490,3576,-86
8440,b-3_5853-5956_5907.wav,VTTS_b-3_5853-5956_5907.wav,4000,3924,76
8441,b-3_1568-1665_1619.wav,VTTS_b-3_1568-1665_1619.wav,3160,3622,-462
8442,b-4_2000-5164_2982.wav,VTTS_b-4_2000-5164_2982.wav,2723,11610,-8887
8443,b-3_5853-5956_5951.wav,VTTS_b-3_5853-5956_5951.wav,4760,5039,-279
8444,b-3_3538-3627_3610.wav,VTTS_b-3_3538-3627_3610.wav,7340,7117,223
8445,b-1_3329-3429_3410.wav,VTTS_b-1_3329-3429_3410.wav,3340,3228,112
8446,b-3_5853-5956_5943.wav,VTTS_b-3_5853-5956_5943.wav,5450,5689,-239
8447,b-2_1427-1562_1483.wav,VTTS_b-2_1427-1562_1483.wav,1280,1382,-102
8448,b-4_2000-5164_2545.wav,VTTS_b-4_2000-5164_2545.wav,1430,1370,60
8449,b-3_1079-1320_1197.wav,VTTS_b-3_1079-1320_1197.wav,7830,7814,16
8450,b-2_815-916_815.wav,VTTS_b-2_815-916_815.wav,2810,2949,-139
8451,b-3_501-930_928.wav,VTTS_b-3_501-930_928.wav,1600,1451,149
8452,b-3_2434-2523_2464.wav,VTTS_b-3_2434-2523_2464.wav,4690,11610,-6920
8453,b-4_2000-5164_3199.wav,VTTS_b-4_2000-5164_3199.wav,7468,7581,-113
8454,b-3_2524-2854_2730.wav,VTTS_b-3_2524-2854_2730.wav,7180,11006,-3826
8455,b-3_4207-4314_4262.wav,VTTS_b-3_4207-4314_4262.wav,8050,8928,-878
8456,b-3_3112-3197_3156.wav,VTTS_b-3_3112-3197_3156.wav,6900,7361,-461
8457,b-1_1010-1110_1036.wav,VTTS_b-1_1010-1110_1036.wav,4080,3692,388
8458,b-1_4394-4429_4397.wav,VTTS_b-1_4394-4429_4397.wav,4360,4319,41
8459,b-4_1814-1900_1895.wav,VTTS_b-4_1814-1900_1895.wav,3680,4110,-430
8460,b-3_4607-5008_4975.wav,VTTS_b-3_4607-5008_4975.wav,5570,6873,-1303
8461,b-3_3454-3537_3457.wav,VTTS_b-3_3454-3537_3457.wav,4590,4296,294
8462,b-2_305-406_344.wav,VTTS_b-2_305-406_344.wav,4300,4783,-483
8463,b-2_305-406_352.wav,VTTS_b-2_305-406_352.wav,3190,3762,-572
8464,b-2_509-610_551.wav,VTTS_b-2_509-610_551.wav,1250,1161,89
8465,b-3_294-391_346.wav,VTTS_b-3_294-391_346.wav,8080,7906,174
8466,b-3_4207-4314_4297.wav,VTTS_b-3_4207-4314_4297.wav,5010,4365,645
8467,b-4_151-300_217.wav,VTTS_b-4_151-300_217.wav,4780,4690,90
8468,b-3_5009-5427_5435.wav,VTTS_b-3_5009-5427_5435.wav,14370,11610,2760
8469,b-4_2000-5164_3713.wav,VTTS_b-4_2000-5164_3713.wav,3305,3135,170
8470,b-4_501-1014_633.wav,VTTS_b-4_501-1014_633.wav,2470,2345,125
8471,b-4_2000-5164_3166.wav,VTTS_b-4_2000-5164_3166.wav,3103,2856,247
8472,b-1_1010-1110_1075.wav,VTTS_b-1_1010-1110_1075.wav,2990,2810,180
8473,b-3_6701-6800_6749.wav,VTTS_b-3_6701-6800_6749.wav,8860,11610,-2750
8474,b-1_2725-2825_2810.wav,VTTS_b-1_2725-2825_2810.wav,2500,2392,108
8475,b-1_1616-1716_1698.wav,VTTS_b-1_1616-1716_1698.wav,1840,1579,261
8476,b-4_2000-5164_2427.wav,VTTS_b-4_2000-5164_2427.wav,4645,4807,-162
8477,b-3_6016-6115_6055.wav,VTTS_b-3_6016-6115_6055.wav,5880,6049,-169
8478,b-4_2000-5164_5052.wav,VTTS_b-4_2000-5164_5052.wav,7399,6908,491
8479,b-3_3628-3714_3654.wav,VTTS_b-3_3628-3714_3654.wav,3690,3204,486
8480,b-3_294-391_372.wav,VTTS_b-3_294-391_372.wav,5670,6571,-901
8481,b-2_1699-1800_1751.wav,VTTS_b-2_1699-1800_1751.wav,2000,1892,108
8482,b-3_1862-1959_1958.wav,VTTS_b-3_1862-1959_1958.wav,5990,5968,22
8483,b-3_6501-6600_6501.wav,VTTS_b-3_6501-6600_6501.wav,4590,4389,201
8484,b-4_2000-5164_4073.wav,VTTS_b-4_2000-5164_4073.wav,6522,6664,-142
8485,b-4_2000-5164_3247.wav,VTTS_b-4_2000-5164_3247.wav,2287,2508,-221
8486,b-3_501-930_829.wav,VTTS_b-3_501-930_829.wav,10600,11610,-1010
8487,b-3_392-500_467.wav,VTTS_b-3_392-500_467.wav,5770,4957,813
8488,b-1_1111-1211_1146.wav,VTTS_b-1_1111-1211_1146.wav,1730,1579,151
8489,b-1_2826-2926_2876.wav,VTTS_b-1_2826-2926_2876.wav,1710,1927,-217
8490,b-4_1814-1900_1878.wav,VTTS_b-4_1814-1900_1878.wav,7760,7430,330
8491,b-1_4286-4321_4314.wav,VTTS_b-1_4286-4321_4314.wav,2750,2218,532
8492,b-2_509-610_552.wav,VTTS_b-2_509-610_552.wav,1240,1265,-25
8493,b-1_1313-1413_1337.wav,VTTS_b-1_1313-1413_1337.wav,1840,1741,99
8494,b-3_4607-5008_4719.wav,VTTS_b-3_4607-5008_4719.wav,8770,8522,248
8495,b-3_6601-6700_6635.wav,VTTS_b-3_6601-6700_6635.wav,4570,4644,-74
8496,b-1_4106-4141_4128.wav,VTTS_b-1_4106-4141_4128.wav,1350,1370,-20
8497,b-1_3430-3530_3468.wav,VTTS_b-1_3430-3530_3468.wav,1890,2032,-142
8498,b-3_392-500_404.wav,VTTS_b-3_392-500_404.wav,8350,8928,-578
8499,b-4_2000-5164_4910.wav,VTTS_b-4_2000-5164_4910.wav,1040,708,332
8500,b-3_6016-6115_6080.wav,VTTS_b-3_6016-6115_6080.wav,7890,7953,-63
8501,b-4_2000-5164_2439.wav,VTTS_b-4_2000-5164_2439.wav,2960,3170,-210
8502,b-3_3803-3888_3824.wav,VTTS_b-3_3803-3888_3824.wav,10470,11610,-1140
8503,b-3_4607-5008_4979.wav,VTTS_b-3_4607-5008_4979.wav,4200,4168,32
8504,b-4_1707-1813_1736.wav,VTTS_b-4_1707-1813_1736.wav,1060,1057,3
8505,b-2_1563-1596_1573.wav,VTTS_b-2_1563-1596_1573.wav,3880,3320,560
8506,b-3_3628-3714_3631.wav,VTTS_b-3_3628-3714_3631.wav,3290,3135,155
8507,b-3_4315-4424_4379.wav,VTTS_b-3_4315-4424_4379.wav,2620,2426,194
8508,b-3_6301-6400_6332.wav,VTTS_b-3_6301-6400_6332.wav,7270,6536,734
8509,b-4_2000-5164_4331.wav,VTTS_b-4_2000-5164_4331.wav,4365,4563,-198
8510,b-3_4001-4103_4024.wav,VTTS_b-3_4001-4103_4024.wav,3920,3646,274
8511,b-1_3935-4033_4018.wav,VTTS_b-1_3935-4033_4018.wav,2810,2891,-81
8512,b-2_1801-1902_1891.wav,VTTS_b-2_1801-1902_1891.wav,1930,1556,374
8513,b-3_3889-4000_3923.wav,VTTS_b-3_3889-4000_3923.wav,2150,1974,176
8514,b-4_2000-5164_3697.wav,VTTS_b-4_2000-5164_3697.wav,3720,3773,-53
8515,b-1_4034-4069_4039.wav,VTTS_b-1_4034-4069_4039.wav,2830,2961,-131
8516,b-1_2624-2724_2626.wav,VTTS_b-1_2624-2724_2626.wav,2790,2937,-147
8517,b-2_1427-1562_1478.wav,VTTS_b-2_1427-1562_1478.wav,7580,7976,-396
8518,b-3_5428-5533_5452.wav,VTTS_b-3_5428-5533_5452.wav,10750,9718,1032
8519,b-1_1919-2017_2007.wav,VTTS_b-1_1919-2017_2007.wav,2390,2450,-60
8520,b-3_3112-3197_3166.wav,VTTS_b-3_3112-3197_3166.wav,6890,6548,342
8521,b-4_2000-5164_2983.wav,VTTS_b-4_2000-5164_2983.wav,5428,5306,122
8522,b-1_2725-2825_2820.wav,VTTS_b-1_2725-2825_2820.wav,2770,3274,-504
8523,b-1_2220-2320_2272.wav,VTTS_b-1_2220-2320_2272.wav,2020,2067,-47
8524,b-4_2000-5164_2566.wav,VTTS_b-4_2000-5164_2566.wav,3420,3193,227
8525,b-4_2000-5164_4188.wav,VTTS_b-4_2000-5164_4188.wav,5107,4876,231
8526,b-3_5957-6015_5984.wav,VTTS_b-3_5957-6015_5984.wav,4510,4412,98
8527,b-4_2000-5164_2861.wav,VTTS_b-4_2000-5164_2861.wav,3610,3495,115
8528,b-4_2000-5164_3788.wav,VTTS_b-4_2000-5164_3788.wav,3380,3657,-277
8529,b-3_2943-3024_2984.wav,VTTS_b-3_2943-3024_2984.wav,2940,2926,14
8530,b-4_501-1014_736.wav,VTTS_b-4_501-1014_736.wav,5510,5236,274
8531,b-4_501-1014_1004.wav,VTTS_b-4_501-1014_1004.wav,2970,2949,21
8532,b-1_1818-1918_1843.wav,VTTS_b-1_1818-1918_1843.wav,4930,6989,-2059
8533,b-4_1601-1706_1696.wav,VTTS_b-4_1601-1706_1696.wav,3890,4540,-650
8534,b-4_2000-5164_4802.wav,VTTS_b-4_2000-5164_4802.wav,1450,1335,115
8535,b-4_2000-5164_4612.wav,VTTS_b-4_2000-5164_4612.wav,6071,6293,-222
8536,b-3_5745-5852_5833.wav,VTTS_b-3_5745-5852_5833.wav,7300,7187,113
8537,b-1_3733-3833_3743.wav,VTTS_b-1_3733-3833_3743.wav,1920,2067,-147
8538,b-1_3733-3833_3781.wav,VTTS_b-1_3733-3833_3781.wav,3620,11610,-7990
8539,b-3_1321-1568_1368.wav,VTTS_b-3_1321-1568_1368.wav,5720,4702,1018
8540,b-1_1111-1211_1197.wav,VTTS_b-1_1111-1211_1197.wav,2870,2752,118
8541,b-4_2000-5164_4994.wav,VTTS_b-4_2000-5164_4994.wav,2335,2136,199
8542,b-3_4498-4605_4536.wav,VTTS_b-3_4498-4605_4536.wav,4730,4679,51
8543,b-2_1427-1562_1535.wav,VTTS_b-2_1427-1562_1535.wav,3790,3344,446
8544,b-2_1325-1426_1371.wav,VTTS_b-2_1325-1426_1371.wav,3740,3367,373
8545,b-1_3935-4033_4027.wav,VTTS_b-1_3935-4033_4027.wav,2700,2879,-179
8546,b-2_815-916_857.wav,VTTS_b-2_815-916_857.wav,1950,2206,-256
8547,b-1_4142-4177_4176.wav,VTTS_b-1_4142-4177_4176.wav,1510,1393,117
8548,b-3_3715-3802_3735.wav,VTTS_b-3_3715-3802_3735.wav,3040,3135,-95
8549,b-1_1717-1817_1798.wav,VTTS_b-1_1717-1817_1798.wav,2950,3355,-405
8550,b-3_6274-6300_6298.wav,VTTS_b-3_6274-6300_6298.wav,2750,3657,-907
8551,b-4_2000-5164_2943.wav,VTTS_b-4_2000-5164_2943.wav,4623,3855,768
8552,b-1_1010-1110_1077.wav,VTTS_b-1_1010-1110_1077.wav,3760,3332,428
8553,b-3_2524-2854_2777.wav,VTTS_b-3_2524-2854_2777.wav,4510,4214,296
8554,b-2_1597-1698_1678.wav,VTTS_b-2_1597-1698_1678.wav,1600,1486,114
8555,b-3_3364-3453_3445.wav,VTTS_b-3_3364-3453_3445.wav,3300,3413,-113
8556,b-1_2523-2623_2524.wav,VTTS_b-1_2523-2623_2524.wav,2680,4029,-1349
8557,b-4_1707-1813_1719.wav,VTTS_b-4_1707-1813_1719.wav,3200,2914,286
8558,b-3_2089-2176_2132.wav,VTTS_b-3_2089-2176_2132.wav,1600,1509,91
8559,b-3_931-979_977.wav,VTTS_b-3_931-979_977.wav,3190,2868,322
8560,b-1_2523-2623_2528.wav,VTTS_b-1_2523-2623_2528.wav,2530,2403,127
8561,b-3_6016-6115_6078.wav,VTTS_b-3_6016-6115_6078.wav,8200,7593,607
8562,b-4_2000-5164_2030.wav,VTTS_b-4_2000-5164_2030.wav,1980,1916,64
8563,b-3_98-195_131.wav,VTTS_b-3_98-195_131.wav,10040,9694,346
8564,b-2_2040-2072_2043.wav,VTTS_b-2_2040-2072_2043.wav,1750,2577,-827
8565,b-4_151-300_296.wav,VTTS_b-4_151-300_296.wav,3670,3855,-185
8566,b-3_1764-1861_1791.wav,VTTS_b-3_1764-1861_1791.wav,4310,4168,142
8567,b-3_6900-7016_6961.wav,VTTS_b-3_6900-7016_6961.wav,3990,3111,879
8568,b-3_3889-4000_3997.wav,VTTS_b-3_3889-4000_3997.wav,3790,3692,98
8569,b-4_1707-1813_1786.wav,VTTS_b-4_1707-1813_1786.wav,710,1776,-1066
8570,b-4_1707-1813_1725.wav,VTTS_b-4_1707-1813_1725.wav,11570,11076,494
8571,b-2_1597-1698_1628.wav,VTTS_b-2_1597-1698_1628.wav,1720,1521,199
8572,b-3_6217-6274_6226.wav,VTTS_b-3_6217-6274_6226.wav,1780,1672,108
8573,b-3_3538-3627_3620.wav,VTTS_b-3_3538-3627_3620.wav,3850,3947,-97
8574,b-4_501-1014_856.wav,VTTS_b-4_501-1014_856.wav,4560,4423,137
8575,b-4_2000-5164_4493.wav,VTTS_b-4_2000-5164_4493.wav,5463,5526,-63
8576,b-3_3628-3714_3682.wav,VTTS_b-3_3628-3714_3682.wav,5860,6455,-595
8577,b-3_501-930_602.wav,VTTS_b-3_501-930_602.wav,7580,7477,103
8578,b-3_196-293_271.wav,VTTS_b-3_196-293_271.wav,1110,1219,-109
8579,b-1_1919-2017_1997.wav,VTTS_b-1_1919-2017_1997.wav,5380,6339,-959
8580,b-2_2209-2310_2209.wav,VTTS_b-2_2209-2310_2209.wav,1760,1718,42
8581,b-3_501-930_674.wav,VTTS_b-3_501-930_674.wav,4360,4110,250
8582,b-3_3889-4000_3989.wav,VTTS_b-3_3889-4000_3989.wav,8060,7442,618
8583,b-3_4315-4424_4371.wav,VTTS_b-3_4315-4424_4371.wav,5210,4981,229
8584,b-1_3834-3934_3910.wav,VTTS_b-1_3834-3934_3910.wav,3090,3262,-172
8585,b-3_5009-5427_5310.wav,VTTS_b-3_5009-5427_5310.wav,3540,3541,-1
8586,b-3_1764-1861_1771.wav,VTTS_b-3_1764-1861_1771.wav,4620,4354,266
8587,b-3_5009-5427_5226.wav,VTTS_b-3_5009-5427_5226.wav,3960,4098,-138
8588,b-3_1079-1320_1167.wav,VTTS_b-3_1079-1320_1167.wav,930,859,71
8589,b-4_1101-1220_1210.wav,VTTS_b-4_1101-1220_1210.wav,6960,6606,354
8590,b-3_5533-5638_5627.wav,VTTS_b-3_5533-5638_5627.wav,4340,4841,-501
8591,b-4_2000-5164_3671.wav,VTTS_b-4_2000-5164_3671.wav,5308,5341,-33
8592,b-1_2321-2421_2337.wav,VTTS_b-1_2321-2421_2337.wav,2460,2322,138
8593,b-3_3454-3537_3523.wav,VTTS_b-3_3454-3537_3523.wav,10760,11424,-664
8594,b-2_2413-2500_2444.wav,VTTS_b-2_2413-2500_2444.wav,4850,4795,55
8595,b-4_2000-5164_4155.wav,VTTS_b-4_2000-5164_4155.wav,2784,2937,-153
8596,b-1_1-73_67.wav,VTTS_b-1_1-73_67.wav,1500,1730,-230
8597,b-4_2000-5164_4190.wav,VTTS_b-4_2000-5164_4190.wav,3430,3297,133
8598,b-1_3026-3126_3105.wav,VTTS_b-1_3026-3126_3105.wav,1900,1950,-50
8599,b-1_794-1009_961.wav,VTTS_b-1_794-1009_961.wav,1420,1277,143
8600,b-2_1427-1562_1497.wav,VTTS_b-2_1427-1562_1497.wav,2130,2717,-587
8601,b-1_377-477_399.wav,VTTS_b-1_377-477_399.wav,1300,1335,-35
8602,b-1_4178-4213_4198.wav,VTTS_b-1_4178-4213_4198.wav,2290,2241,49
8603,b-1_276-376_291.wav,VTTS_b-1_276-376_291.wav,970,998,-28
8604,b-2_1325-1426_1386.wav,VTTS_b-2_1325-1426_1386.wav,1620,1556,64
8605,b-3_501-930_792.wav,VTTS_b-3_501-930_792.wav,7570,7663,-93
8606,b-2_2107-2193_2143.wav,VTTS_b-2_2107-2193_2143.wav,1250,987,263
8607,b-4_2000-5164_2267.wav,VTTS_b-4_2000-5164_2267.wav,6980,7291,-311
8608,b-1_794-1009_908.wav,VTTS_b-1_794-1009_908.wav,3510,3425,85
8609,b-3_1321-1568_1395.wav,VTTS_b-3_1321-1568_1395.wav,3550,3576,-26
8610,b-2_2209-2310_2220.wav,VTTS_b-2_2209-2310_2220.wav,2730,3599,-869
8611,b-3_1-97_63.wav,VTTS_b-3_1-97_63.wav,5620,4748,872
8612,b-2_611-712_712.wav,VTTS_b-2_611-712_712.wav,2620,3274,-654
8613,b-3_3454-3537_3485.wav,VTTS_b-3_3454-3537_3485.wav,4360,4632,-272
8614,b-4_2000-5164_2309.wav,VTTS_b-4_2000-5164_2309.wav,7215,6711,504
8615,b-4_2000-5164_3982.wav,VTTS_b-4_2000-5164_3982.wav,4671,5445,-774
8616,b-3_2089-2176_2130.wav,VTTS_b-3_2089-2176_2130.wav,2730,1614,1116
8617,b-4_151-300_191.wav,VTTS_b-4_151-300_191.wav,4520,5306,-786
8618,b-2_1121-1222_1219.wav,VTTS_b-2_1121-1222_1219.wav,2170,1858,312
8619,b-3_980-1077_1022.wav,VTTS_b-3_980-1077_1022.wav,4650,4284,366
8620,b-2_203-304_283.wav,VTTS_b-2_203-304_283.wav,1660,1625,35
8621,b-3_6217-6274_6240.wav,VTTS_b-3_6217-6274_6240.wav,3990,3796,194
8622,b-3_3112-3197_3123.wav,VTTS_b-3_3112-3197_3123.wav,2820,2705,115
8623,b-3_4498-4605_4540.wav,VTTS_b-3_4498-4605_4540.wav,1950,1602,348
8624,b-3_4498-4605_4506.wav,VTTS_b-3_4498-4605_4506.wav,6620,6525,95
8625,b-4_1506-1600_1593.wav,VTTS_b-4_1506-1600_1593.wav,2710,1939,771
8626,b-3_4001-4103_4074.wav,VTTS_b-3_4001-4103_4074.wav,4110,4075,35
8627,b-1_1717-1817_1755.wav,VTTS_b-1_1717-1817_1755.wav,2790,2589,201
8628,b-1_276-376_339.wav,VTTS_b-1_276-376_339.wav,1690,1730,-40
8629,b-4_1221-1300_1246.wav,VTTS_b-4_1221-1300_1246.wav,2050,1939,111
8630,b-1_4358-4393_4360.wav,VTTS_b-1_4358-4393_4360.wav,2620,2461,159
8631,b-1_1111-1211_1198.wav,VTTS_b-1_1111-1211_1198.wav,2830,2601,229
8632,b-4_2000-5164_4049.wav,VTTS_b-4_2000-5164_4049.wav,6424,7593,-1169
8633,b-3_4607-5008_4830.wav,VTTS_b-3_4607-5008_4830.wav,3400,3762,-362
8634,b-3_5009-5427_5305.wav,VTTS_b-3_5009-5427_5305.wav,9280,8673,607
8635,b-3_1079-1320_1079.wav,VTTS_b-3_1079-1320_1079.wav,5480,5039,441
8636,b-3_3715-3802_3766.wav,VTTS_b-3_3715-3802_3766.wav,8440,8533,-93
8637,b-1_74-174_83.wav,VTTS_b-1_74-174_83.wav,3350,3390,-40
8638,b-2_1699-1800_1699.wav,VTTS_b-2_1699-1800_1699.wav,3140,2984,156
8639,b-3_5009-5427_5419.wav,VTTS_b-3_5009-5427_5419.wav,2990,2705,285
8640,b-3_3198-3278_3275.wav,VTTS_b-3_3198-3278_3275.wav,3240,2926,314
8641,b-3_3279-3363_3343.wav,VTTS_b-3_3279-3363_3343.wav,2280,2287,-7
8642,b-3_2524-2854_2620.wav,VTTS_b-3_2524-2854_2620.wav,4060,4052,8
8643,b-4_2000-5164_2713.wav,VTTS_b-4_2000-5164_2713.wav,1360,1265,95
8644,b-1_1111-1211_1209.wav,VTTS_b-1_1111-1211_1209.wav,1940,1869,71
8645,b-3_1568-1665_1649.wav,VTTS_b-3_1568-1665_1649.wav,780,766,14
8646,b-4_2000-5164_4355.wav,VTTS_b-4_2000-5164_4355.wav,1674,1614,60
8647,b-3_6701-6800_6723.wav,VTTS_b-3_6701-6800_6723.wav,6320,11610,-5290
8648,b-1_377-477_451.wav,VTTS_b-1_377-477_451.wav,3200,2694,506
8649,b-4_2000-5164_3515.wav,VTTS_b-4_2000-5164_3515.wav,1337,1115,222
8650,b-1_175-275_231.wav,VTTS_b-1_175-275_231.wav,2800,2717,83
8651,b-3_2000-2088_2063.wav,VTTS_b-3_2000-2088_2063.wav,5840,5306,534
8652,b-3_2524-2854_2647.wav,VTTS_b-3_2524-2854_2647.wav,3550,11610,-8060
8653,b-4_2000-5164_4847.wav,VTTS_b-4_2000-5164_4847.wav,4229,3913,316
8654,b-2_407-508_476.wav,VTTS_b-2_407-508_476.wav,3140,4087,-947
8655,b-3_3454-3537_3483.wav,VTTS_b-3_3454-3537_3483.wav,3330,3773,-443
8656,b-3_2524-2854_2696.wav,VTTS_b-3_2524-2854_2696.wav,3310,3576,-266
8657,b-2_2040-2072_2061.wav,VTTS_b-2_2040-2072_2061.wav,2280,2229,51
8658,b-1_478-578_498.wav,VTTS_b-1_478-578_498.wav,4290,5097,-807
8659,b-3_6217-6274_6262.wav,VTTS_b-3_6217-6274_6262.wav,5280,4807,473
8660,b-4_2000-5164_4494.wav,VTTS_b-4_2000-5164_4494.wav,4142,4540,-398
8661,b-1_686-793_707.wav,VTTS_b-1_686-793_707.wav,4020,5027,-1007
8662,b-3_6501-6600_6550.wav,VTTS_b-3_6501-6600_6550.wav,1810,1765,45
8663,b-4_2000-5164_3004.wav,VTTS_b-4_2000-5164_3004.wav,5044,5457,-413
8664,b-4_2000-5164_3436.wav,VTTS_b-4_2000-5164_3436.wav,3857,3669,188
8665,b-3_6217-6274_6237.wav,VTTS_b-3_6217-6274_6237.wav,2890,2740,150
8666,b-2_2107-2193_2158.wav,VTTS_b-2_2107-2193_2158.wav,1480,1463,17
8667,b-2_611-712_627.wav,VTTS_b-2_611-712_627.wav,1430,1474,-44
8668,b-3_6116-6215_6189.wav,VTTS_b-3_6116-6215_6189.wav,3580,4272,-692
8669,b-1_1414-1514_1471.wav,VTTS_b-1_1414-1514_1471.wav,2670,2485,185
8670,b-3_1862-1959_1923.wav,VTTS_b-3_1862-1959_1923.wav,4240,4098,142
8671,b-2_1019-1120_1070.wav,VTTS_b-2_1019-1120_1070.wav,1350,1231,119
8672,b-4_53-150_115.wav,VTTS_b-4_53-150_115.wav,9010,7918,1092
8673,b-3_6601-6700_6652.wav,VTTS_b-3_6601-6700_6652.wav,6280,6711,-431
8674,b-3_4001-4103_4012.wav,VTTS_b-3_4001-4103_4012.wav,12260,11610,650
8675,b-3_1568-1665_1635.wav,VTTS_b-3_1568-1665_1635.wav,2920,2543,377
8676,b-4_2000-5164_2257.wav,VTTS_b-4_2000-5164_2257.wav,2320,2635,-315
8677,b-1_3127-3227_3170.wav,VTTS_b-1_3127-3227_3170.wav,2920,3564,-644
8678,b-3_1568-1665_1582.wav,VTTS_b-3_1568-1665_1582.wav,4240,4377,-137
8679,b-1_2624-2724_2624.wav,VTTS_b-1_2624-2724_2624.wav,1970,1927,43
8680,b-4_1707-1813_1760.wav,VTTS_b-4_1707-1813_1760.wav,2120,1660,460
8681,b-3_1321-1568_1488.wav,VTTS_b-3_1321-1568_1488.wav,5420,5631,-211
8682,b-4_2000-5164_4947.wav,VTTS_b-4_2000-5164_4947.wav,5582,6502,-920
8683,b-4_1301-1400_1361.wav,VTTS_b-4_1301-1400_1361.wav,5710,5085,625
8684,b-1_1313-1413_1390.wav,VTTS_b-1_1313-1413_1390.wav,2160,2101,59
8685,b-4_1901-2000_1910.wav,VTTS_b-4_1901-2000_1910.wav,8090,7047,1043
8686,b-4_2000-5164_2828.wav,VTTS_b-4_2000-5164_2828.wav,4610,4249,361
8687,b-1_686-793_714.wav,VTTS_b-1_686-793_714.wav,1270,1312,-42
8688,b-1_686-793_743.wav,VTTS_b-1_686-793_743.wav,6080,5375,705
8689,b-2_1223-1324_1279.wav,VTTS_b-2_1223-1324_1279.wav,4030,3390,640
8690,b-3_4315-4424_4422.wav,VTTS_b-3_4315-4424_4422.wav,3920,3971,-51
8691,b-4_2000-5164_2255.wav,VTTS_b-4_2000-5164_2255.wav,3960,3704,256
8692,b-2_1801-1902_1857.wav,VTTS_b-2_1801-1902_1857.wav,2010,1765,245
8693,b-1_3834-3934_3933.wav,VTTS_b-1_3834-3934_3933.wav,1940,1974,-34
8694,b-1_276-376_344.wav,VTTS_b-1_276-376_344.wav,1290,1126,164
8695,b-3_6900-7016_6918.wav,VTTS_b-3_6900-7016_6918.wav,11780,11610,170
8696,b-4_1221-1300_1221.wav,VTTS_b-4_1221-1300_1221.wav,1610,1370,240
8697,b-1_794-1009_922.wav,VTTS_b-1_794-1009_922.wav,2280,2101,179
8698,b-1_1515-1615_1576.wav,VTTS_b-1_1515-1615_1576.wav,1490,1486,4
8699,b-4_2000-5164_2487.wav,VTTS_b-4_2000-5164_2487.wav,7800,7396,404
8700,b-1_3733-3833_3821.wav,VTTS_b-1_3733-3833_3821.wav,3110,3019,91
8701,b-1_1313-1413_1403.wav,VTTS_b-1_1313-1413_1403.wav,1560,1463,97
8702,b-3_5639-5744_5722.wav,VTTS_b-3_5639-5744_5722.wav,2300,2670,-370
8703,b-3_98-195_130.wav,VTTS_b-3_98-195_130.wav,3450,3123,327
8704,b-2_611-712_697.wav,VTTS_b-2_611-712_697.wav,2360,2334,26
8705,b-4_1-52_36.wav,VTTS_b-4_1-52_36.wav,8180,11610,-3430
8706,b-3_6301-6400_6322.wav,VTTS_b-3_6301-6400_6322.wav,6340,6304,36
8707,b-2_1325-1426_1374.wav,VTTS_b-2_1325-1426_1374.wav,1140,1149,-9
8708,b-3_2524-2854_2739.wav,VTTS_b-3_2524-2854_2739.wav,6710,7105,-395
8709,b-3_2524-2854_2718.wav,VTTS_b-3_2524-2854_2718.wav,3300,3309,-9
8710,b-4_1506-1600_1553.wav,VTTS_b-4_1506-1600_1553.wav,6530,11610,-5080
8711,b-3_4607-5008_4877.wav,VTTS_b-3_4607-5008_4877.wav,3150,3309,-159
8712,b-3_1862-1959_1943.wav,VTTS_b-3_1862-1959_1943.wav,3440,2612,828
8713,b-3_5009-5427_5366.wav,VTTS_b-3_5009-5427_5366.wav,3890,3878,12
8714,b-1_2523-2623_2525.wav,VTTS_b-1_2523-2623_2525.wav,1720,1567,153
8715,b-3_1321-1568_1454.wav,VTTS_b-3_1321-1568_1454.wav,4520,4586,-66
8716,b-2_611-712_613.wav,VTTS_b-2_611-712_613.wav,2090,2090,0
8717,b-1_3632-3732_3645.wav,VTTS_b-1_3632-3732_3645.wav,6120,4772,1348
8718,b-3_2267-2349_2281.wav,VTTS_b-3_2267-2349_2281.wav,8160,7465,695
8719,b-3_2089-2176_2153.wav,VTTS_b-3_2089-2176_2153.wav,8220,8673,-453
8720,b-3_5639-5744_5643.wav,VTTS_b-3_5639-5744_5643.wav,2130,1985,145
8721,b-1_794-1009_875.wav,VTTS_b-1_794-1009_875.wav,3860,4063,-203
8722,b-3_392-500_408.wav,VTTS_b-3_392-500_408.wav,1430,1521,-91
8723,b-3_1-97_9.wav,VTTS_b-3_1-97_9.wav,5220,4923,297
8724,b-4_2000-5164_3468.wav,VTTS_b-4_2000-5164_3468.wav,3498,4331,-833
8725,b-3_196-293_235.wav,VTTS_b-3_196-293_235.wav,7350,6606,744
8726,b-1_2422-2522_2495.wav,VTTS_b-1_2422-2522_2495.wav,4050,4423,-373
8727,b-1_3531-3631_3576.wav,VTTS_b-1_3531-3631_3576.wav,2640,2891,-251
8728,b-3_4104-4206_4136.wav,VTTS_b-3_4104-4206_4136.wav,8420,7779,641
8729,b-3_2350-2433_2411.wav,VTTS_b-3_2350-2433_2411.wav,3570,3262,308
8730,b-4_2000-5164_2520.wav,VTTS_b-4_2000-5164_2520.wav,4660,4238,422
8731,b-4_501-1014_670.wav,VTTS_b-4_501-1014_670.wav,2160,2032,128
8732,b-4_2000-5164_4841.wav,VTTS_b-4_2000-5164_4841.wav,3864,3762,102
8733,b-3_3628-3714_3669.wav,VTTS_b-3_3628-3714_3669.wav,7960,8197,-237
8734,b-3_2524-2854_2641.wav,VTTS_b-3_2524-2854_2641.wav,660,720,-60
8735,b-1_1414-1514_1418.wav,VTTS_b-1_1414-1514_1418.wav,2270,2183,87
8736,b-2_305-406_327.wav,VTTS_b-2_305-406_327.wav,2940,2844,96
8737,b-3_6116-6215_6161.wav,VTTS_b-3_6116-6215_6161.wav,7980,7187,793
8738,b-4_2000-5164_2484.wav,VTTS_b-4_2000-5164_2484.wav,2440,2252,188
8739,b-3_4315-4424_4357.wav,VTTS_b-3_4315-4424_4357.wav,2470,2995,-525
8740,b-1_1111-1211_1164.wav,VTTS_b-1_1111-1211_1164.wav,2410,2891,-481
8741,b-3_3803-3888_3850.wav,VTTS_b-3_3803-3888_3850.wav,6250,5817,433
8742,b-4_2000-5164_3683.wav,VTTS_b-4_2000-5164_3683.wav,5816,5817,-1
8743,b-3_3715-3802_3727.wav,VTTS_b-3_3715-3802_3727.wav,6170,5933,237
8744,b-4_501-1014_765.wav,VTTS_b-4_501-1014_765.wav,6120,6223,-103
8745,b-1_1717-1817_1717.wav,VTTS_b-1_1717-1817_1717.wav,2130,5422,-3292
8746,b-3_501-930_521.wav,VTTS_b-3_501-930_521.wav,4540,4621,-81
8747,b-3_4425-4497_4435.wav,VTTS_b-3_4425-4497_4435.wav,5280,5190,90
8748,b-1_4142-4177_4156.wav,VTTS_b-1_4142-4177_4156.wav,2220,2833,-613
8749,b-1_794-1009_907.wav,VTTS_b-1_794-1009_907.wav,4230,4551,-321
8750,b-1_1-73_42.wav,VTTS_b-1_1-73_42.wav,4460,4957,-497
8751,b-1_2523-2623_2587.wav,VTTS_b-1_2523-2623_2587.wav,1750,2148,-398
8752,b-3_4315-4424_4322.wav,VTTS_b-3_4315-4424_4322.wav,7980,8034,-54
8753,b-3_501-930_557.wav,VTTS_b-3_501-930_557.wav,6410,5968,442
8754,b-3_4607-5008_4613.wav,VTTS_b-3_4607-5008_4613.wav,3960,3796,164
8755,b-2_1121-1222_1153.wav,VTTS_b-2_1121-1222_1153.wav,3080,2543,537
8756,b-3_501-930_887.wav,VTTS_b-3_501-930_887.wav,8110,7256,854
8757,b-1_3228-3328_3251.wav,VTTS_b-1_3228-3328_3251.wav,1580,2078,-498
8758,b-3_3025-3111_3086.wav,VTTS_b-3_3025-3111_3086.wav,7010,7094,-84
8759,b-1_1616-1716_1656.wav,VTTS_b-1_1616-1716_1656.wav,3920,3309,611
8760,b-4_1014-1100_1079.wav,VTTS_b-4_1014-1100_1079.wav,2770,3506,-736
8761,b-4_2000-5164_3255.wav,VTTS_b-4_2000-5164_3255.wav,4515,4795,-280
8762,b-3_3454-3537_3513.wav,VTTS_b-3_3454-3537_3513.wav,3790,3077,713
8763,b-4_53-150_81.wav,VTTS_b-4_53-150_81.wav,9430,9009,421
8764,b-4_2000-5164_4288.wav,VTTS_b-4_2000-5164_4288.wav,1915,1846,69
8765,b-2_1801-1902_1826.wav,VTTS_b-2_1801-1902_1826.wav,3350,2949,401
8766,b-2_815-916_833.wav,VTTS_b-2_815-916_833.wav,1360,1277,83
8767,b-4_2000-5164_3072.wav,VTTS_b-4_2000-5164_3072.wav,5123,5224,-101
8768,b-3_3803-3888_3842.wav,VTTS_b-3_3803-3888_3842.wav,8440,9265,-825
8769,b-4_2000-5164_2635.wav,VTTS_b-4_2000-5164_2635.wav,3700,3715,-15
8770,b-4_501-1014_507.wav,VTTS_b-4_501-1014_507.wav,3190,3053,137
8771,b-4_2000-5164_4354.wav,VTTS_b-4_2000-5164_4354.wav,4541,4667,-126
8772,b-1_2624-2724_2684.wav,VTTS_b-1_2624-2724_2684.wav,2060,2136,-76
8773,b-3_501-930_784.wav,VTTS_b-3_501-930_784.wav,6280,6478,-198
8774,b-3_1764-1861_1795.wav,VTTS_b-3_1764-1861_1795.wav,4940,5224,-284
8775,b-4_151-300_242.wav,VTTS_b-4_151-300_242.wav,9030,8777,253
8776,b-4_2000-5164_4234.wav,VTTS_b-4_2000-5164_4234.wav,4737,4598,139
8777,b-1_2725-2825_2728.wav,VTTS_b-1_2725-2825_2728.wav,1580,1451,129
8778,b-3_1862-1959_1946.wav,VTTS_b-3_1862-1959_1946.wav,3660,3553,107
8779,b-3_5428-5533_5528.wav,VTTS_b-3_5428-5533_5528.wav,6380,6269,111
8780,b-3_6401-6500_6444.wav,VTTS_b-3_6401-6500_6444.wav,4760,4505,255
8781,b-1_794-1009_896.wav,VTTS_b-1_794-1009_896.wav,3080,2844,236
8782,b-4_501-1014_542.wav,VTTS_b-4_501-1014_542.wav,10760,9392,1368
8783,b-2_1427-1562_1542.wav,VTTS_b-2_1427-1562_1542.wav,5040,4412,628
8784,b-3_1862-1959_1937.wav,VTTS_b-3_1862-1959_1937.wav,4880,4319,561
8785,b-4_501-1014_883.wav,VTTS_b-4_501-1014_883.wav,5800,5178,622
8786,b-2_1427-1562_1473.wav,VTTS_b-2_1427-1562_1473.wav,6860,7117,-257
8787,b-4_2000-5164_3814.wav,VTTS_b-4_2000-5164_3814.wav,1816,2136,-320
8788,b-3_2855-2942_2855.wav,VTTS_b-3_2855-2942_2855.wav,4790,6177,-1387
8789,b-1_74-174_174.wav,VTTS_b-1_74-174_174.wav,1480,1416,64
8790,b-3_6801-6900_6894.wav,VTTS_b-3_6801-6900_6894.wav,4240,3982,258
8791,b-3_392-500_417.wav,VTTS_b-3_392-500_417.wav,4840,5666,-826
8792,b-3_6217-6274_6247.wav,VTTS_b-3_6217-6274_6247.wav,3260,3413,-153
8793,b-1_377-477_462.wav,VTTS_b-1_377-477_462.wav,1720,2067,-347
8794,b-4_2000-5164_2731.wav,VTTS_b-4_2000-5164_2731.wav,7870,10321,-2451
8795,b-3_931-979_976.wav,VTTS_b-3_931-979_976.wav,6390,6002,388
8796,b-3_2434-2523_2502.wav,VTTS_b-3_2434-2523_2502.wav,5660,5457,203
8797,b-4_1707-1813_1772.wav,VTTS_b-4_1707-1813_1772.wav,2520,2566,-46
8798,b-1_1-73_66.wav,VTTS_b-1_1-73_66.wav,3050,3111,-61
8799,b-1_1212-1312_1249.wav,VTTS_b-1_1212-1312_1249.wav,4990,3460,1530
8800,b-1_1515-1615_1600.wav,VTTS_b-1_1515-1615_1600.wav,4020,4087,-67
8801,b-3_5745-5852_5751.wav,VTTS_b-3_5745-5852_5751.wav,3990,3773,217
8802,b-3_1321-1568_1521.wav,VTTS_b-3_1321-1568_1521.wav,5190,4748,442
8803,b-4_301-400_307.wav,VTTS_b-4_301-400_307.wav,3980,3762,218
8804,b-2_2413-2500_2463.wav,VTTS_b-2_2413-2500_2463.wav,1530,1289,241
8805,b-2_2311-2412_2411.wav,VTTS_b-2_2311-2412_2411.wav,2880,2995,-115
8806,b-4_1601-1706_1692.wav,VTTS_b-4_1601-1706_1692.wav,6930,6374,556
8807,b-1_2523-2623_2590.wav,VTTS_b-1_2523-2623_2590.wav,1630,1602,28
8808,b-4_401-500_448.wav,VTTS_b-4_401-500_448.wav,2460,2508,-48
8809,b-3_4607-5008_4793.wav,VTTS_b-3_4607-5008_4793.wav,3300,5793,-2493
8810,b-4_2000-5164_3812.wav,VTTS_b-4_2000-5164_3812.wav,2651,3599,-948
8811,b-2_1325-1426_1356.wav,VTTS_b-2_1325-1426_1356.wav,1180,1219,-39
8812,b-2_1-100_100.wav,VTTS_b-2_1-100_100.wav,1670,1579,91
8813,b-3_501-930_769.wav,VTTS_b-3_501-930_769.wav,3530,3239,291
8814,b-4_151-300_212.wav,VTTS_b-4_151-300_212.wav,1440,1335,105
8815,b-3_3025-3111_3060.wav,VTTS_b-3_3025-3111_3060.wav,3670,3913,-243
8816,b-1_1313-1413_1402.wav,VTTS_b-1_1313-1413_1402.wav,1280,1324,-44
8817,b-4_501-1014_850.wav,VTTS_b-4_501-1014_850.wav,4410,4702,-292
8818,b-2_1-100_55.wav,VTTS_b-2_1-100_55.wav,1430,1405,25
8819,b-2_713-814_729.wav,VTTS_b-2_713-814_729.wav,2500,3065,-565
8820,b-2_1699-1800_1728.wav,VTTS_b-2_1699-1800_1728.wav,6950,5480,1470
8821,b-1_478-578_536.wav,VTTS_b-1_478-578_536.wav,3810,2902,908
8822,b-3_1-97_11.wav,VTTS_b-3_1-97_11.wav,5770,11610,-5840
8823,b-3_1079-1320_1252.wav,VTTS_b-3_1079-1320_1252.wav,3560,3785,-225
8824,b-1_4178-4213_4183.wav,VTTS_b-1_4178-4213_4183.wav,2270,2194,76
8825,b-4_1601-1706_1642.wav,VTTS_b-4_1601-1706_1642.wav,4650,4598,52
8826,b-2_2209-2310_2282.wav,VTTS_b-2_2209-2310_2282.wav,1250,1347,-97
8827,b-1_2018-2118_2040.wav,VTTS_b-1_2018-2118_2040.wav,2200,2659,-459
8828,b-4_501-1014_695.wav,VTTS_b-4_501-1014_695.wav,2530,2438,92
8829,b-4_1401-1505_1453.wav,VTTS_b-4_1401-1505_1453.wav,7260,7558,-298
8830,b-4_2000-5164_2854.wav,VTTS_b-4_2000-5164_2854.wav,4255,5259,-1004
8831,b-1_2927-3025_2948.wav,VTTS_b-1_2927-3025_2948.wav,1500,1730,-230
8832,b-2_713-814_756.wav,VTTS_b-2_713-814_756.wav,1640,1637,3
8833,b-3_3715-3802_3743.wav,VTTS_b-3_3715-3802_3743.wav,4430,7012,-2582
8834,b-2_305-406_350.wav,VTTS_b-2_305-406_350.wav,2600,2670,-70
8835,b-1_2321-2421_2399.wav,VTTS_b-1_2321-2421_2399.wav,4410,4772,-362
8836,b-2_1223-1324_1263.wav,VTTS_b-2_1223-1324_1263.wav,2860,2531,329
8837,b-1_276-376_318.wav,VTTS_b-1_276-376_318.wav,2980,2821,159
8838,b-3_5533-5638_5634.wav,VTTS_b-3_5533-5638_5634.wav,3630,3367,263
8839,b-1_1010-1110_1019.wav,VTTS_b-1_1010-1110_1019.wav,1350,1196,154
8840,b-3_5009-5427_5300.wav,VTTS_b-3_5009-5427_5300.wav,3050,4110,-1060
8841,b-1_3228-3328_3259.wav,VTTS_b-1_3228-3328_3259.wav,2650,2403,247
8842,b-4_1707-1813_1780.wav,VTTS_b-4_1707-1813_1780.wav,3440,3170,270
8843,b-1_3430-3530_3464.wav,VTTS_b-1_3430-3530_3464.wav,7680,7535,145
8844,b-1_1111-1211_1118.wav,VTTS_b-1_1111-1211_1118.wav,1940,1858,82
8845,b-3_2524-2854_2584.wav,VTTS_b-3_2524-2854_2584.wav,7780,6769,1011
8846,b-1_3430-3530_3453.wav,VTTS_b-1_3430-3530_3453.wav,3240,3274,-34
8847,b-1_2826-2926_2893.wav,VTTS_b-1_2826-2926_2893.wav,1710,1892,-182
8848,b-1_2018-2118_2059.wav,VTTS_b-1_2018-2118_2059.wav,1270,1242,28
8849,b-1_1616-1716_1636.wav,VTTS_b-1_1616-1716_1636.wav,1420,1498,-78
8850,b-4_2000-5164_3382.wav,VTTS_b-4_2000-5164_3382.wav,3966,3889,77
8851,b-3_4001-4103_4045.wav,VTTS_b-3_4001-4103_4045.wav,5810,4748,1062
8852,b-4_2000-5164_4350.wav,VTTS_b-4_2000-5164_4350.wav,3760,5050,-1290
8853,b-4_401-500_443.wav,VTTS_b-4_401-500_443.wav,3500,2844,656
8854,b-4_501-1014_834.wav,VTTS_b-4_501-1014_834.wav,3870,3669,201
8855,b-4_501-1014_810.wav,VTTS_b-4_501-1014_810.wav,4610,4307,303
8856,b-3_5428-5533_5463.wav,VTTS_b-3_5428-5533_5463.wav,3940,3947,-7
8857,b-4_2000-5164_2243.wav,VTTS_b-4_2000-5164_2243.wav,3290,3193,97
8858,b-4_2000-5164_2669.wav,VTTS_b-4_2000-5164_2669.wav,2320,2287,33
8859,b-3_5639-5744_5640.wav,VTTS_b-3_5639-5744_5640.wav,5210,5190,20
8860,b-4_2000-5164_2920.wav,VTTS_b-4_2000-5164_2920.wav,3501,3320,181
8861,b-3_392-500_416.wav,VTTS_b-3_392-500_416.wav,9020,9451,-431
8862,b-3_98-195_133.wav,VTTS_b-3_98-195_133.wav,3130,2902,228
8863,b-2_2209-2310_2286.wav,VTTS_b-2_2209-2310_2286.wav,1040,1033,7
8864,b-1_1313-1413_1375.wav,VTTS_b-1_1313-1413_1375.wav,2250,2136,114
8865,b-2_101-202_180.wav,VTTS_b-2_101-202_180.wav,1410,1277,133
8866,b-2_1699-1800_1735.wav,VTTS_b-2_1699-1800_1735.wav,2400,2171,229
8867,b-1_1212-1312_1264.wav,VTTS_b-1_1212-1312_1264.wav,2700,2554,146
8868,b-4_2000-5164_5145.wav,VTTS_b-4_2000-5164_5145.wav,6713,7802,-1089
8869,b-2_1-100_5.wav,VTTS_b-2_1-100_5.wav,1900,2891,-991
8870,b-3_4207-4314_4265.wav,VTTS_b-3_4207-4314_4265.wav,7890,6316,1574
8871,b-4_2000-5164_3360.wav,VTTS_b-4_2000-5164_3360.wav,6413,6351,62
8872,b-4_1101-1220_1158.wav,VTTS_b-4_1101-1220_1158.wav,5930,5828,102
8873,b-4_2000-5164_2189.wav,VTTS_b-4_2000-5164_2189.wav,4060,4249,-189
8874,b-1_3935-4033_4020.wav,VTTS_b-1_3935-4033_4020.wav,2280,2786,-506
8875,b-1_3632-3732_3698.wav,VTTS_b-1_3632-3732_3698.wav,2570,3286,-716
8876,b-1_2321-2421_2395.wav,VTTS_b-1_2321-2421_2395.wav,2400,2078,322
8877,b-1_2624-2724_2703.wav,VTTS_b-1_2624-2724_2703.wav,1830,1846,-16
8878,b-1_1818-1918_1863.wav,VTTS_b-1_1818-1918_1863.wav,4520,5166,-646
8879,b-3_5639-5744_5639.wav,VTTS_b-3_5639-5744_5639.wav,5820,5863,-43
8880,b-1_4214-4285_4246.wav,VTTS_b-1_4214-4285_4246.wav,2270,2206,64
8881,b-4_151-300_253.wav,VTTS_b-4_151-300_253.wav,3230,3065,165
8882,b-3_3198-3278_3249.wav,VTTS_b-3_3198-3278_3249.wav,10590,9961,629
8883,b-2_2311-2412_2369.wav,VTTS_b-2_2311-2412_2369.wav,1610,1556,54
8884,b-3_501-930_748.wav,VTTS_b-3_501-930_748.wav,6670,6502,168
8885,b-4_2000-5164_5149.wav,VTTS_b-4_2000-5164_5149.wav,4077,3773,304
8886,b-1_1313-1413_1331.wav,VTTS_b-1_1313-1413_1331.wav,4130,5074,-944
8887,b-4_2000-5164_2299.wav,VTTS_b-4_2000-5164_2299.wav,2660,2508,152
8888,b-3_1-97_50.wav,VTTS_b-3_1-97_50.wav,6970,6420,550
8889,b-4_2000-5164_3599.wav,VTTS_b-4_2000-5164_3599.wav,9127,11610,-2483
8890,b-3_5009-5427_5198.wav,VTTS_b-3_5009-5427_5198.wav,7240,6803,437
8891,b-2_1223-1324_1228.wav,VTTS_b-2_1223-1324_1228.wav,1200,1300,-100
8892,b-2_1325-1426_1338.wav,VTTS_b-2_1325-1426_1338.wav,1260,1289,-29
8893,b-1_1010-1110_1033.wav,VTTS_b-1_1010-1110_1033.wav,4870,4667,203
8894,b-3_1321-1568_1531.wav,VTTS_b-3_1321-1568_1531.wav,5480,3541,1939
8895,b-3_501-930_605.wav,VTTS_b-3_501-930_605.wav,6140,11610,-5470
8896,b-2_1223-1324_1321.wav,VTTS_b-2_1223-1324_1321.wav,4450,4203,247
8897,b-4_501-1014_1005.wav,VTTS_b-4_501-1014_1005.wav,3390,3831,-441
8898,b-1_1313-1413_1354.wav,VTTS_b-1_1313-1413_1354.wav,2270,1672,598
8899,b-4_2000-5164_2060.wav,VTTS_b-4_2000-5164_2060.wav,7355,7848,-493
8900,b-4_1-52_4.wav,VTTS_b-4_1-52_4.wav,5880,5027,853
8901,b-1_1010-1110_1086.wav,VTTS_b-1_1010-1110_1086.wav,4380,11610,-7230
8902,b-3_5428-5533_5472.wav,VTTS_b-3_5428-5533_5472.wav,3930,4214,-284
8903,b-3_3889-4000_3924.wav,VTTS_b-3_3889-4000_3924.wav,8290,8348,-58
8904,b-4_2000-5164_4072.wav,VTTS_b-4_2000-5164_4072.wav,3189,4447,-1258
8905,b-4_2000-5164_2817.wav,VTTS_b-4_2000-5164_2817.wav,3960,3541,419
8906,b-1_2826-2926_2919.wav,VTTS_b-1_2826-2926_2919.wav,2210,2183,27
8907,b-3_4498-4605_4541.wav,VTTS_b-3_4498-4605_4541.wav,5690,5596,94
8908,b-2_1121-1222_1187.wav,VTTS_b-2_1121-1222_1187.wav,3130,2902,228
8909,b-4_2000-5164_4553.wav,VTTS_b-4_2000-5164_4553.wav,4185,3982,203
8910,b-1_478-578_516.wav,VTTS_b-1_478-578_516.wav,1710,1474,236
8911,b-1_4358-4393_4359.wav,VTTS_b-1_4358-4393_4359.wav,2370,2159,211
8912,b-3_98-195_155.wav,VTTS_b-3_98-195_155.wav,6350,5991,359
8913,b-3_4315-4424_4330.wav,VTTS_b-3_4315-4424_4330.wav,7260,9253,-1993
8914,b-1_175-275_264.wav,VTTS_b-1_175-275_264.wav,1650,1509,141
8915,b-3_392-500_439.wav,VTTS_b-3_392-500_439.wav,4850,6002,-1152
8916,b-2_1801-1902_1855.wav,VTTS_b-2_1801-1902_1855.wav,2650,2241,409
8917,b-3_6116-6215_6202.wav,VTTS_b-3_6116-6215_6202.wav,3930,4574,-644
8918,b-4_2000-5164_4709.wav,VTTS_b-4_2000-5164_4709.wav,3770,3855,-85
8919,b-4_2000-5164_2404.wav,VTTS_b-4_2000-5164_2404.wav,2290,2368,-78
8920,b-1_4142-4177_4150.wav,VTTS_b-1_4142-4177_4150.wav,1980,1892,88
8921,b-3_1666-1763_1711.wav,VTTS_b-3_1666-1763_1711.wav,4040,4029,11
8922,b-3_3628-3714_3690.wav,VTTS_b-3_3628-3714_3690.wav,2940,3506,-566
8923,b-2_2107-2193_2180.wav,VTTS_b-2_2107-2193_2180.wav,2520,2334,186
8924,b-3_1079-1320_1259.wav,VTTS_b-3_1079-1320_1259.wav,6630,6107,523
8925,b-3_3628-3714_3688.wav,VTTS_b-3_3628-3714_3688.wav,6420,6049,371
8926,b-3_5009-5427_5050.wav,VTTS_b-3_5009-5427_5050.wav,4770,4899,-129
8927,b-3_501-930_754.wav,VTTS_b-3_501-930_754.wav,2670,2519,151
8928,b-1_1-73_21.wav,VTTS_b-1_1-73_21.wav,2540,2577,-37
8929,b-4_2000-5164_2441.wav,VTTS_b-4_2000-5164_2441.wav,2110,2577,-467
8930,b-4_151-300_257.wav,VTTS_b-4_151-300_257.wav,6720,6815,-95
8931,b-1_2523-2623_2572.wav,VTTS_b-1_2523-2623_2572.wav,1750,2403,-653
8932,b-3_1764-1861_1813.wav,VTTS_b-3_1764-1861_1813.wav,5070,5132,-62
8933,b-3_5009-5427_5024.wav,VTTS_b-3_5009-5427_5024.wav,1110,1022,88
8934,b-3_4607-5008_4676.wav,VTTS_b-3_4607-5008_4676.wav,6710,6711,-1
8935,b-1_4466-4498_4480.wav,VTTS_b-1_4466-4498_4480.wav,1180,1207,-27
8936,b-3_1862-1959_1890.wav,VTTS_b-3_1862-1959_1890.wav,5580,5027,553
8937,b-4_2000-5164_4100.wav,VTTS_b-4_2000-5164_4100.wav,3163,3762,-599
8938,b-3_5009-5427_5377.wav,VTTS_b-3_5009-5427_5377.wav,5660,7465,-1805
8939,b-4_1221-1300_1241.wav,VTTS_b-4_1221-1300_1241.wav,1640,1544,96
8940,b-1_1010-1110_1106.wav,VTTS_b-1_1010-1110_1106.wav,1510,1474,36
8941,b-1_377-477_421.wav,VTTS_b-1_377-477_421.wav,1670,1649,21
8942,b-2_1699-1800_1700.wav,VTTS_b-2_1699-1800_1700.wav,1470,1207,263
8943,b-3_4607-5008_4869.wav,VTTS_b-3_4607-5008_4869.wav,5230,5759,-529
8944,b-1_1919-2017_1969.wav,VTTS_b-1_1919-2017_1969.wav,2330,2496,-166
8945,b-3_3889-4000_3894.wav,VTTS_b-3_3889-4000_3894.wav,4030,3796,234
8946,b-3_98-195_142.wav,VTTS_b-3_98-195_142.wav,4380,4005,375
8947,b-3_5009-5427_5244.wav,VTTS_b-3_5009-5427_5244.wav,5000,5016,-16
8948,b-3_4607-5008_4681.wav,VTTS_b-3_4607-5008_4681.wav,7190,6699,491
8949,b-3_1079-1320_1267.wav,VTTS_b-3_1079-1320_1267.wav,6810,7163,-353
8950,b-2_1325-1426_1425.wav,VTTS_b-2_1325-1426_1425.wav,7910,7872,38
8951,b-3_4425-4497_4440.wav,VTTS_b-3_4425-4497_4440.wav,6180,6084,96
8952,b-3_2524-2854_2698.wav,VTTS_b-3_2524-2854_2698.wav,9880,11610,-1730
8953,b-3_3198-3278_3234.wav,VTTS_b-3_3198-3278_3234.wav,3260,3030,230
8954,b-1_4430-4465_4455.wav,VTTS_b-1_4430-4465_4455.wav,1200,1173,27
8955,b-4_1601-1706_1653.wav,VTTS_b-4_1601-1706_1653.wav,9170,7790,1380
8956,b-4_1707-1813_1757.wav,VTTS_b-4_1707-1813_1757.wav,4670,4679,-9
8957,b-3_3364-3453_3384.wav,VTTS_b-3_3364-3453_3384.wav,6720,5979,741
8958,b-4_1301-1400_1329.wav,VTTS_b-4_1301-1400_1329.wav,2500,2786,-286
8959,b-3_501-930_896.wav,VTTS_b-3_501-930_896.wav,8430,8220,210
8960,b-3_294-391_339.wav,VTTS_b-3_294-391_339.wav,4710,4493,217
8961,b-2_2413-2500_2446.wav,VTTS_b-2_2413-2500_2446.wav,2220,2218,2
8962,b-3_3628-3714_3676.wav,VTTS_b-3_3628-3714_3676.wav,6870,6931,-61
8963,b-1_579-649_637.wav,VTTS_b-1_579-649_637.wav,2760,3262,-502
8964,b-4_1707-1813_1723.wav,VTTS_b-4_1707-1813_1723.wav,9220,10333,-1113
8965,b-1_478-578_495.wav,VTTS_b-1_478-578_495.wav,2510,2961,-451
8966,b-4_1401-1505_1501.wav,VTTS_b-4_1401-1505_1501.wav,3800,7872,-4072
8967,b-2_1121-1222_1188.wav,VTTS_b-2_1121-1222_1188.wav,2170,3065,-895
8968,b-3_2524-2854_2835.wav,VTTS_b-3_2524-2854_2835.wav,3980,3936,44
8969,b-3_5853-5956_5952.wav,VTTS_b-3_5853-5956_5952.wav,4510,4400,110
8970,b-1_2624-2724_2718.wav,VTTS_b-1_2624-2724_2718.wav,2540,2218,322
8971,b-2_407-508_472.wav,VTTS_b-2_407-508_472.wav,1740,882,858
8972,b-1_2018-2118_2103.wav,VTTS_b-1_2018-2118_2103.wav,2560,2125,435
8973,b-2_1903-2038_1989.wav,VTTS_b-2_1903-2038_1989.wav,2670,2810,-140
8974,b-2_1597-1698_1629.wav,VTTS_b-2_1597-1698_1629.wav,2920,3309,-389
8975,b-4_1814-1900_1853.wav,VTTS_b-4_1814-1900_1853.wav,9180,8173,1007
8976,b-4_2000-5164_4963.wav,VTTS_b-4_2000-5164_4963.wav,8390,7558,832
8977,b-3_501-930_837.wav,VTTS_b-3_501-930_837.wav,2600,2287,313
8978,b-1_1818-1918_1888.wav,VTTS_b-1_1818-1918_1888.wav,2530,2171,359
8979,b-3_392-500_401.wav,VTTS_b-3_392-500_401.wav,5330,5317,13
8980,b-4_2000-5164_3295.wav,VTTS_b-4_2000-5164_3295.wav,5484,5584,-100
8981,b-4_2000-5164_4683.wav,VTTS_b-4_2000-5164_4683.wav,1474,1358,116
8982,b-3_6301-6400_6321.wav,VTTS_b-3_6301-6400_6321.wav,6900,6420,480
8983,b-2_1801-1902_1844.wav,VTTS_b-2_1801-1902_1844.wav,7370,11610,-4240
8984,b-4_2000-5164_3820.wav,VTTS_b-4_2000-5164_3820.wav,4329,4493,-164
8985,b-1_4214-4285_4285.wav,VTTS_b-1_4214-4285_4285.wav,3980,7744,-3764
8986,b-3_6301-6400_6383.wav,VTTS_b-3_6301-6400_6383.wav,6980,7163,-183
8987,b-3_3803-3888_3880.wav,VTTS_b-3_3803-3888_3880.wav,1720,1730,-10
8988,b-2_2107-2193_2189.wav,VTTS_b-2_2107-2193_2189.wav,1390,1289,101
8989,b-4_2000-5164_2625.wav,VTTS_b-4_2000-5164_2625.wav,18110,11610,6500
8990,b-3_2855-2942_2918.wav,VTTS_b-3_2855-2942_2918.wav,5100,5410,-310
8991,b-1_1313-1413_1361.wav,VTTS_b-1_1313-1413_1361.wav,3570,3100,470
8992,b-1_3733-3833_3815.wav,VTTS_b-1_3733-3833_3815.wav,2280,2310,-30
8993,b-4_2000-5164_5131.wav,VTTS_b-4_2000-5164_5131.wav,6183,6722,-539
8994,b-3_931-979_951.wav,VTTS_b-3_931-979_951.wav,7700,8185,-485
8995,b-3_2267-2349_2305.wav,VTTS_b-3_2267-2349_2305.wav,3990,4377,-387
8996,b-1_377-477_460.wav,VTTS_b-1_377-477_460.wav,2650,3007,-357
8997,b-4_2000-5164_4732.wav,VTTS_b-4_2000-5164_4732.wav,3839,4667,-828
8998,b-1_3935-4033_3941.wav,VTTS_b-1_3935-4033_3941.wav,3400,3483,-83
8999,b-1_1414-1514_1452.wav,VTTS_b-1_1414-1514_1452.wav,2140,1904,236
9000,b-1_1212-1312_1269.wav,VTTS_b-1_1212-1312_1269.wav,4110,3820,290
9001,b-3_4498-4605_4586.wav,VTTS_b-3_4498-4605_4586.wav,3660,3483,177
9002,b-2_2107-2193_2136.wav,VTTS_b-2_2107-2193_2136.wav,2820,2902,-82
9003,b-3_5009-5427_5146.wav,VTTS_b-3_5009-5427_5146.wav,4820,5155,-335
9004,b-3_1960-2000_1962.wav,VTTS_b-3_1960-2000_1962.wav,2370,2159,211
9005,b-3_5428-5533_5497.wav,VTTS_b-3_5428-5533_5497.wav,7220,6978,242
9006,b-4_151-300_211.wav,VTTS_b-4_151-300_211.wav,2870,3193,-323
9007,b-2_1903-2038_2019.wav,VTTS_b-2_1903-2038_2019.wav,3360,3379,-19
9008,b-2_2311-2412_2385.wav,VTTS_b-2_2311-2412_2385.wav,2460,2113,347
9009,b-3_6701-6800_6795.wav,VTTS_b-3_6701-6800_6795.wav,7330,8905,-1575
9010,b-1_2523-2623_2622.wav,VTTS_b-1_2523-2623_2622.wav,1580,1637,-57
9011,b-1_794-1009_959.wav,VTTS_b-1_794-1009_959.wav,3800,5515,-1715
9012,b-1_175-275_251.wav,VTTS_b-1_175-275_251.wav,1850,1765,85
9013,b-1_686-793_713.wav,VTTS_b-1_686-793_713.wav,1850,2113,-263
9014,b-4_2000-5164_4505.wav,VTTS_b-4_2000-5164_4505.wav,2817,2682,135
9015,b-3_2524-2854_2539.wav,VTTS_b-3_2524-2854_2539.wav,4550,4470,80
9016,b-2_101-202_152.wav,VTTS_b-2_101-202_152.wav,2450,3692,-1242
9017,b-1_2119-2219_2150.wav,VTTS_b-1_2119-2219_2150.wav,1820,1579,241
9018,b-3_5428-5533_5453.wav,VTTS_b-3_5428-5533_5453.wav,5290,6502,-1212
9019,b-1_3228-3328_3309.wav,VTTS_b-1_3228-3328_3309.wav,1170,1173,-3
9020,b-3_4425-4497_4473.wav,VTTS_b-3_4425-4497_4473.wav,2790,2473,317
9021,b-1_1818-1918_1882.wav,VTTS_b-1_1818-1918_1882.wav,2110,1753,357
9022,b-3_1666-1763_1744.wav,VTTS_b-3_1666-1763_1744.wav,7670,7488,182
9023,b-3_501-930_919.wav,VTTS_b-3_501-930_919.wav,11390,9242,2148
9024,b-3_4001-4103_4013.wav,VTTS_b-3_4001-4103_4013.wav,7900,6722,1178
9025,b-3_1666-1763_1692.wav,VTTS_b-3_1666-1763_1692.wav,5320,5573,-253
9026,b-3_3198-3278_3223.wav,VTTS_b-3_3198-3278_3223.wav,4150,4087,63
9027,b-2_2413-2500_2443.wav,VTTS_b-2_2413-2500_2443.wav,3320,2972,348
9028,b-3_2524-2854_2672.wav,VTTS_b-3_2524-2854_2672.wav,4820,4830,-10
9029,b-2_1019-1120_1053.wav,VTTS_b-2_1019-1120_1053.wav,2930,3483,-553
9030,b-1_1212-1312_1255.wav,VTTS_b-1_1212-1312_1255.wav,1610,1289,321
9031,b-3_4607-5008_4670.wav,VTTS_b-3_4607-5008_4670.wav,6140,7872,-1732
9032,b-3_2524-2854_2681.wav,VTTS_b-3_2524-2854_2681.wav,2730,2972,-242
9033,b-3_3454-3537_3480.wav,VTTS_b-3_3454-3537_3480.wav,1710,1625,85
9034,b-4_2000-5164_2450.wav,VTTS_b-4_2000-5164_2450.wav,4420,4493,-73
9035,b-4_2000-5164_2155.wav,VTTS_b-4_2000-5164_2155.wav,6600,11610,-5010
9036,b-1_2523-2623_2530.wav,VTTS_b-1_2523-2623_2530.wav,4950,5050,-100
9037,b-3_4425-4497_4436.wav,VTTS_b-3_4425-4497_4436.wav,7200,7210,-10
9038,b-2_2194-2208_2201.wav,VTTS_b-2_2194-2208_2201.wav,2110,2450,-340
9039,b-1_4394-4429_4404.wav,VTTS_b-1_4394-4429_4404.wav,1670,1533,137
9040,b-2_1427-1562_1501.wav,VTTS_b-2_1427-1562_1501.wav,2610,1741,869
9041,b-2_101-202_150.wav,VTTS_b-2_101-202_150.wav,1440,1533,-93
9042,b-4_1301-1400_1340.wav,VTTS_b-4_1301-1400_1340.wav,8270,8603,-333
9043,b-1_3632-3732_3648.wav,VTTS_b-1_3632-3732_3648.wav,2140,1916,224
9044,b-1_4358-4393_4392.wav,VTTS_b-1_4358-4393_4392.wav,2480,2566,-86
9045,b-3_2524-2854_2606.wav,VTTS_b-3_2524-2854_2606.wav,5330,5039,291
9046,b-1_2725-2825_2784.wav,VTTS_b-1_2725-2825_2784.wav,4020,4040,-20
9047,b-1_1818-1918_1822.wav,VTTS_b-1_1818-1918_1822.wav,3860,3994,-134
9048,b-3_6900-7016_6926.wav,VTTS_b-3_6900-7016_6926.wav,5020,4505,515
9049,b-3_1764-1861_1820.wav,VTTS_b-3_1764-1861_1820.wav,4260,4168,92
9050,b-4_2000-5164_5144.wav,VTTS_b-4_2000-5164_5144.wav,3572,3413,159
9051,b-2_1801-1902_1802.wav,VTTS_b-2_1801-1902_1802.wav,3090,2856,234
9052,b-4_501-1014_867.wav,VTTS_b-4_501-1014_867.wav,5150,5968,-818
9053,b-1_4142-4177_4147.wav,VTTS_b-1_4142-4177_4147.wav,2110,2368,-258
9054,b-3_1321-1568_1341.wav,VTTS_b-3_1321-1568_1341.wav,2760,2415,345
9055,b-2_1699-1800_1781.wav,VTTS_b-2_1699-1800_1781.wav,900,940,-40
9056,b-3_3364-3453_3364.wav,VTTS_b-3_3364-3453_3364.wav,4040,3843,197
9057,b-3_3279-3363_3358.wav,VTTS_b-3_3279-3363_3358.wav,5590,6014,-424
9058,b-4_2000-5164_3451.wav,VTTS_b-4_2000-5164_3451.wav,6058,7396,-1338
9059,b-3_4498-4605_4511.wav,VTTS_b-3_4498-4605_4511.wav,2520,2577,-57
9060,b-2_2209-2310_2264.wav,VTTS_b-2_2209-2310_2264.wav,1730,1486,244
9061,b-4_53-150_91.wav,VTTS_b-4_53-150_91.wav,9400,7848,1552
9062,b-3_3889-4000_3963.wav,VTTS_b-3_3889-4000_3963.wav,6860,6757,103
9063,b-1_2725-2825_2780.wav,VTTS_b-1_2725-2825_2780.wav,1240,1265,-25
9064,b-2_815-916_860.wav,VTTS_b-2_815-916_860.wav,1430,2276,-846
9065,b-3_5745-5852_5808.wav,VTTS_b-3_5745-5852_5808.wav,4180,4203,-23
9066,b-1_1717-1817_1734.wav,VTTS_b-1_1717-1817_1734.wav,1210,1207,3
9067,b-4_1014-1100_1048.wav,VTTS_b-4_1014-1100_1048.wav,4760,4609,151
9068,b-2_1-100_36.wav,VTTS_b-2_1-100_36.wav,5080,5236,-156
9069,b-4_2000-5164_2141.wav,VTTS_b-4_2000-5164_2141.wav,6760,5828,932
9070,b-1_2422-2522_2488.wav,VTTS_b-1_2422-2522_2488.wav,2800,2450,350
9071,b-2_203-304_292.wav,VTTS_b-2_203-304_292.wav,2480,2717,-237
9072,b-1_4286-4321_4304.wav,VTTS_b-1_4286-4321_4304.wav,1130,1115,15
9073,b-2_203-304_288.wav,VTTS_b-2_203-304_288.wav,1280,1173,107
9074,b-3_2524-2854_2784.wav,VTTS_b-3_2524-2854_2784.wav,10400,11610,-1210
9075,b-4_1601-1706_1654.wav,VTTS_b-4_1601-1706_1654.wav,6530,6769,-239
9076,b-1_1212-1312_1265.wav,VTTS_b-1_1212-1312_1265.wav,3000,2728,272
9077,b-3_6601-6700_6680.wav,VTTS_b-3_6601-6700_6680.wav,6470,6571,-101
9078,b-2_101-202_126.wav,VTTS_b-2_101-202_126.wav,2270,2357,-87
9079,b-1_3228-3328_3284.wav,VTTS_b-1_3228-3328_3284.wav,4140,4180,-40
9080,b-1_1010-1110_1043.wav,VTTS_b-1_1010-1110_1043.wav,1320,1184,136
9081,b-3_501-930_660.wav,VTTS_b-3_501-930_660.wav,7210,7732,-522
9082,b-2_407-508_449.wav,VTTS_b-2_407-508_449.wav,3350,3564,-214
9083,b-4_2000-5164_4271.wav,VTTS_b-4_2000-5164_4271.wav,2870,3030,-160
9084,b-4_2000-5164_4833.wav,VTTS_b-4_2000-5164_4833.wav,3156,2821,335
9085,b-3_6801-6900_6879.wav,VTTS_b-3_6801-6900_6879.wav,4510,4110,400
9086,b-1_2422-2522_2507.wav,VTTS_b-1_2422-2522_2507.wav,1950,2194,-244
9087,b-3_501-930_675.wav,VTTS_b-3_501-930_675.wav,7230,6200,1030
9088,b-3_6301-6400_6365.wav,VTTS_b-3_6301-6400_6365.wav,6630,11610,-4980
9089,b-3_4425-4497_4476.wav,VTTS_b-3_4425-4497_4476.wav,2650,2984,-334
9090,b-4_2000-5164_5090.wav,VTTS_b-4_2000-5164_5090.wav,4836,5700,-864
9091,b-3_392-500_445.wav,VTTS_b-3_392-500_445.wav,8630,10147,-1517
9092,b-1_1212-1312_1221.wav,VTTS_b-1_1212-1312_1221.wav,1310,1207,103
9093,b-1_2826-2926_2840.wav,VTTS_b-1_2826-2926_2840.wav,1590,1486,104
9094,b-4_501-1014_655.wav,VTTS_b-4_501-1014_655.wav,2270,1974,296
9095,b-3_1321-1568_1497.wav,VTTS_b-3_1321-1568_1497.wav,6530,6989,-459
9096,b-3_4315-4424_4334.wav,VTTS_b-3_4315-4424_4334.wav,5680,6502,-822
9097,b-3_1568-1665_1651.wav,VTTS_b-3_1568-1665_1651.wav,5560,4853,707
9098,b-1_4322-4357_4355.wav,VTTS_b-1_4322-4357_4355.wav,4200,4865,-665
9099,b-1_1313-1413_1344.wav,VTTS_b-1_1313-1413_1344.wav,1260,1242,18
9100,b-4_1901-2000_1917.wav,VTTS_b-4_1901-2000_1917.wav,4240,3843,397
9101,b-3_3715-3802_3738.wav,VTTS_b-3_3715-3802_3738.wav,6050,6269,-219
9102,b-1_2725-2825_2754.wav,VTTS_b-1_2725-2825_2754.wav,1600,1846,-246
9103,b-4_1301-1400_1334.wav,VTTS_b-4_1301-1400_1334.wav,10610,8940,1670
9104,b-4_2000-5164_2975.wav,VTTS_b-4_2000-5164_2975.wav,4293,5840,-1547
9105,b-3_98-195_186.wav,VTTS_b-3_98-195_186.wav,4090,3762,328
9106,b-3_4607-5008_4631.wav,VTTS_b-3_4607-5008_4631.wav,5140,6339,-1199
9107,b-3_501-930_800.wav,VTTS_b-3_501-930_800.wav,5360,5968,-608
9108,b-1_1010-1110_1048.wav,VTTS_b-1_1010-1110_1048.wav,1980,1324,656
9109,b-2_917-1018_966.wav,VTTS_b-2_917-1018_966.wav,1710,1788,-78
9110,b-4_501-1014_960.wav,VTTS_b-4_501-1014_960.wav,2580,2485,95
9111,b-4_2000-5164_4388.wav,VTTS_b-4_2000-5164_4388.wav,4536,4563,-27
9112,b-3_1568-1665_1650.wav,VTTS_b-3_1568-1665_1650.wav,4540,3796,744
9113,b-2_1325-1426_1390.wav,VTTS_b-2_1325-1426_1390.wav,6930,6362,568
9114,b-3_4104-4206_4188.wav,VTTS_b-3_4104-4206_4188.wav,3190,2670,520
9115,b-3_2350-2433_2397.wav,VTTS_b-3_2350-2433_2397.wav,2550,2450,100
9116,b-3_2855-2942_2921.wav,VTTS_b-3_2855-2942_2921.wav,720,813,-93
9117,b-1_3733-3833_3764.wav,VTTS_b-1_3733-3833_3764.wav,2680,3332,-652
9118,b-4_1506-1600_1509.wav,VTTS_b-4_1506-1600_1509.wav,3610,3576,34
9119,b-4_2000-5164_2182.wav,VTTS_b-4_2000-5164_2182.wav,3160,4702,-1542
9120,b-2_1903-2038_1987.wav,VTTS_b-2_1903-2038_1987.wav,2900,2601,299
9121,b-4_2000-5164_2927.wav,VTTS_b-4_2000-5164_2927.wav,7994,8081,-87
9122,b-4_2000-5164_2108.wav,VTTS_b-4_2000-5164_2108.wav,5380,5143,237
9123,b-2_611-712_689.wav,VTTS_b-2_611-712_689.wav,2870,2090,780
9124,b-4_1301-1400_1337.wav,VTTS_b-4_1301-1400_1337.wav,8930,7546,1384
9125,b-4_2000-5164_4793.wav,VTTS_b-4_2000-5164_4793.wav,7708,7941,-233
9126,b-4_2000-5164_4756.wav,VTTS_b-4_2000-5164_4756.wav,6367,6339,28
9127,b-3_5853-5956_5922.wav,VTTS_b-3_5853-5956_5922.wav,6870,6188,682
9128,b-1_2523-2623_2549.wav,VTTS_b-1_2523-2623_2549.wav,3220,3355,-135
9129,b-4_1-52_27.wav,VTTS_b-4_1-52_27.wav,7560,7430,130
9130,b-3_1321-1568_1505.wav,VTTS_b-3_1321-1568_1505.wav,10360,9242,1118
9131,b-2_1903-2038_2038.wav,VTTS_b-2_1903-2038_2038.wav,4340,3831,509
9132,b-1_1212-1312_1247.wav,VTTS_b-1_1212-1312_1247.wav,1120,929,191
9133,b-1_1717-1817_1732.wav,VTTS_b-1_1717-1817_1732.wav,1900,2055,-155
9134,b-4_2000-5164_2193.wav,VTTS_b-4_2000-5164_2193.wav,5820,11610,-5790
9135,b-3_5009-5427_5155.wav,VTTS_b-3_5009-5427_5155.wav,3200,3204,-4
9136,b-2_815-916_828.wav,VTTS_b-2_815-916_828.wav,2870,3402,-532
9137,b-3_6301-6400_6341.wav,VTTS_b-3_6301-6400_6341.wav,1310,1277,33
9138,b-3_6016-6115_6044.wav,VTTS_b-3_6016-6115_6044.wav,8610,7442,1168
9139,b-1_3531-3631_3560.wav,VTTS_b-1_3531-3631_3560.wav,1040,1579,-539
9140,b-3_5428-5533_5436.wav,VTTS_b-3_5428-5533_5436.wav,5350,5004,346
9141,b-1_377-477_441.wav,VTTS_b-1_377-477_441.wav,2810,2833,-23
9142,b-1_3329-3429_3396.wav,VTTS_b-1_3329-3429_3396.wav,1400,1324,76
9143,b-4_2000-5164_2120.wav,VTTS_b-4_2000-5164_2120.wav,5160,4737,423
9144,b-3_3803-3888_3819.wav,VTTS_b-3_3803-3888_3819.wav,4750,4853,-103
9145,b-3_501-930_551.wav,VTTS_b-3_501-930_551.wav,3670,3077,593
9146,b-2_1121-1222_1204.wav,VTTS_b-2_1121-1222_1204.wav,3690,2961,729
9147,b-4_1401-1505_1448.wav,VTTS_b-4_1401-1505_1448.wav,6310,6060,250
9148,b-1_3127-3227_3177.wav,VTTS_b-1_3127-3227_3177.wav,1480,1614,-134
9149,b-3_6601-6700_6696.wav,VTTS_b-3_6601-6700_6696.wav,7720,7036,684
9150,b-1_3733-3833_3798.wav,VTTS_b-1_3733-3833_3798.wav,4250,4760,-510
9151,b-1_2927-3025_2951.wav,VTTS_b-1_2927-3025_2951.wav,2140,3448,-1308
9152,b-1_4142-4177_4159.wav,VTTS_b-1_4142-4177_4159.wav,1890,1939,-49
9153,b-2_1597-1698_1634.wav,VTTS_b-2_1597-1698_1634.wav,8600,8707,-107
9154,b-4_2000-5164_4517.wav,VTTS_b-4_2000-5164_4517.wav,4231,4122,109
9155,b-2_1223-1324_1325.wav,VTTS_b-2_1223-1324_1325.wav,6210,7187,-977
9156,b-2_2311-2412_2395.wav,VTTS_b-2_2311-2412_2395.wav,2750,2705,45
9157,b-3_501-930_513.wav,VTTS_b-3_501-930_513.wav,5670,5909,-239
9158,b-4_1401-1505_1485.wav,VTTS_b-4_1401-1505_1485.wav,6070,5944,126
9159,b-4_1221-1300_1249.wav,VTTS_b-4_1221-1300_1249.wav,3470,3646,-176
9160,b-1_74-174_101.wav,VTTS_b-1_74-174_101.wav,4170,4307,-137
9161,b-4_2000-5164_4644.wav,VTTS_b-4_2000-5164_4644.wav,4841,4865,-24
9162,b-3_4607-5008_4874.wav,VTTS_b-3_4607-5008_4874.wav,2500,2635,-135
9163,b-4_2000-5164_2416.wav,VTTS_b-4_2000-5164_2416.wav,3900,3750,150
9164,b-1_3935-4033_4031.wav,VTTS_b-1_3935-4033_4031.wav,1830,1834,-4
9165,b-3_1321-1568_1484.wav,VTTS_b-3_1321-1568_1484.wav,3690,3541,149
9166,b-2_1223-1324_1259.wav,VTTS_b-2_1223-1324_1259.wav,4230,5085,-855
9167,b-4_2000-5164_3528.wav,VTTS_b-4_2000-5164_3528.wav,4007,3611,396
9168,b-1_2220-2320_2237.wav,VTTS_b-1_2220-2320_2237.wav,820,801,19
9169,b-4_1901-2000_1913.wav,VTTS_b-4_1901-2000_1913.wav,4740,5236,-496
9170,b-1_3632-3732_3647.wav,VTTS_b-1_3632-3732_3647.wav,1500,1231,269
9171,b-4_2000-5164_4366.wav,VTTS_b-4_2000-5164_4366.wav,1790,1811,-21
9172,b-1_1818-1918_1911.wav,VTTS_b-1_1818-1918_1911.wav,2030,1834,196
9173,b-4_1401-1505_1474.wav,VTTS_b-4_1401-1505_1474.wav,8300,9567,-1267
9174,b-2_815-916_889.wav,VTTS_b-2_815-916_889.wav,1460,1312,148
9175,b-4_2000-5164_3991.wav,VTTS_b-4_2000-5164_3991.wav,6524,6594,-70
9176,b-3_2177-2266_2256.wav,VTTS_b-3_2177-2266_2256.wav,6480,5759,721
9177,b-2_1903-2038_2001.wav,VTTS_b-2_1903-2038_2001.wav,1620,1474,146
9178,b-3_3364-3453_3423.wav,VTTS_b-3_3364-3453_3423.wav,4480,4540,-60
9179,b-4_2000-5164_5012.wav,VTTS_b-4_2000-5164_5012.wav,3213,3320,-107
9180,b-3_2524-2854_2549.wav,VTTS_b-3_2524-2854_2549.wav,3060,2949,111
9181,b-3_5853-5956_5898.wav,VTTS_b-3_5853-5956_5898.wav,2960,2647,313
9182,b-1_2119-2219_2129.wav,VTTS_b-1_2119-2219_2129.wav,1460,1405,55
9183,b-2_611-712_708.wav,VTTS_b-2_611-712_708.wav,2940,1683,1257
9184,b-4_1901-2000_1972.wav,VTTS_b-4_1901-2000_1972.wav,5530,5248,282
9185,b-1_377-477_392.wav,VTTS_b-1_377-477_392.wav,2980,2728,252
9186,b-4_2000-5164_2597.wav,VTTS_b-4_2000-5164_2597.wav,4850,4923,-73
9187,b-3_5009-5427_5234.wav,VTTS_b-3_5009-5427_5234.wav,3570,3622,-52
9188,b-3_3454-3537_3527.wav,VTTS_b-3_3454-3537_3527.wav,5740,11610,-5870
9189,b-3_2089-2176_2115.wav,VTTS_b-3_2089-2176_2115.wav,6710,8301,-1591
9190,b-4_1221-1300_1263.wav,VTTS_b-4_1221-1300_1263.wav,9270,9195,75
9191,b-4_2000-5164_2582.wav,VTTS_b-4_2000-5164_2582.wav,7240,8754,-1514
9192,b-3_3803-3888_3803.wav,VTTS_b-3_3803-3888_3803.wav,4470,4249,221
9193,b-1_3127-3227_3152.wav,VTTS_b-1_3127-3227_3152.wav,3940,4876,-936
9194,b-4_2000-5164_2824.wav,VTTS_b-4_2000-5164_2824.wav,3650,4098,-448
9195,b-3_3112-3197_3190.wav,VTTS_b-3_3112-3197_3190.wav,4270,3680,590
9196,b-1_276-376_315.wav,VTTS_b-1_276-376_315.wav,1780,1718,62
9197,b-4_2000-5164_4425.wav,VTTS_b-4_2000-5164_4425.wav,8876,9741,-865
9198,b-3_3803-3888_3855.wav,VTTS_b-3_3803-3888_3855.wav,3850,4540,-690
9199,b-3_980-1077_1007.wav,VTTS_b-3_980-1077_1007.wav,4390,3181,1209
9200,b-3_5853-5956_5949.wav,VTTS_b-3_5853-5956_5949.wav,4550,4609,-59
9201,b-3_1568-1665_1578.wav,VTTS_b-3_1568-1665_1578.wav,2410,2670,-260
9202,b-3_3454-3537_3497.wav,VTTS_b-3_3454-3537_3497.wav,5570,4876,694
9203,b-1_3733-3833_3739.wav,VTTS_b-1_3733-3833_3739.wav,4220,5689,-1469
9204,b-4_1506-1600_1535.wav,VTTS_b-4_1506-1600_1535.wav,4040,4063,-23
9205,b-4_2000-5164_3223.wav,VTTS_b-4_2000-5164_3223.wav,2863,2659,204
9206,b-4_1506-1600_1512.wav,VTTS_b-4_1506-1600_1512.wav,6750,6153,597
9207,b-1_276-376_356.wav,VTTS_b-1_276-376_356.wav,1400,1498,-98
9208,b-3_3715-3802_3736.wav,VTTS_b-3_3715-3802_3736.wav,3220,3297,-77
9209,b-1_686-793_730.wav,VTTS_b-1_686-793_730.wav,1280,1161,119
9210,b-1_1717-1817_1780.wav,VTTS_b-1_1717-1817_1780.wav,1590,1498,92
9211,b-4_2000-5164_3695.wav,VTTS_b-4_2000-5164_3695.wav,2600,2206,394
9212,b-3_4607-5008_4918.wav,VTTS_b-3_4607-5008_4918.wav,7800,7883,-83
9213,b-3_1568-1665_1603.wav,VTTS_b-3_1568-1665_1603.wav,9690,9451,239
9214,b-3_501-930_579.wav,VTTS_b-3_501-930_579.wav,4530,4667,-137
9215,b-4_2000-5164_3450.wav,VTTS_b-4_2000-5164_3450.wav,2196,2078,118
9216,b-3_2524-2854_2552.wav,VTTS_b-3_2524-2854_2552.wav,3340,3437,-97
9217,b-2_611-712_702.wav,VTTS_b-2_611-712_702.wav,1090,1231,-141
9218,b-1_4142-4177_4143.wav,VTTS_b-1_4142-4177_4143.wav,990,1045,-55
9219,b-4_2000-5164_2903.wav,VTTS_b-4_2000-5164_2903.wav,7874,7628,246
9220,b-2_713-814_763.wav,VTTS_b-2_713-814_763.wav,4900,4505,395
9221,b-1_1010-1110_1011.wav,VTTS_b-1_1010-1110_1011.wav,1660,1753,-93
9222,b-2_2311-2412_2399.wav,VTTS_b-2_2311-2412_2399.wav,3720,3320,400
9223,b-3_1079-1320_1304.wav,VTTS_b-3_1079-1320_1304.wav,10480,10159,321
9224,b-4_1101-1220_1160.wav,VTTS_b-4_1101-1220_1160.wav,3580,3170,410
9225,b-1_74-174_102.wav,VTTS_b-1_74-174_102.wav,3920,2856,1064
9226,b-4_2000-5164_3725.wav,VTTS_b-4_2000-5164_3725.wav,1835,1672,163
9227,b-2_1801-1902_1805.wav,VTTS_b-2_1801-1902_1805.wav,1890,1718,172
9228,b-2_1699-1800_1792.wav,VTTS_b-2_1699-1800_1792.wav,2980,2392,588
9229,b-3_4315-4424_4389.wav,VTTS_b-3_4315-4424_4389.wav,9840,8452,1388
9230,b-3_5009-5427_5409.wav,VTTS_b-3_5009-5427_5409.wav,3250,3158,92
9231,b-4_2000-5164_3349.wav,VTTS_b-4_2000-5164_3349.wav,8012,8835,-823
9232,b-4_2000-5164_4303.wav,VTTS_b-4_2000-5164_4303.wav,5067,5097,-30
9233,b-3_1-97_89.wav,VTTS_b-3_1-97_89.wav,3950,3715,235
9234,b-3_6274-6300_6278.wav,VTTS_b-3_6274-6300_6278.wav,6000,5677,323
9235,b-2_2413-2500_2457.wav,VTTS_b-2_2413-2500_2457.wav,1410,1370,40
9236,b-2_101-202_156.wav,VTTS_b-2_101-202_156.wav,1720,1741,-21
9237,b-4_2000-5164_3925.wav,VTTS_b-4_2000-5164_3925.wav,5563,5840,-277
9238,b-4_1814-1900_1831.wav,VTTS_b-4_1814-1900_1831.wav,3050,3762,-712
9239,b-1_1818-1918_1870.wav,VTTS_b-1_1818-1918_1870.wav,1520,2798,-1278
9240,b-3_6401-6500_6479.wav,VTTS_b-3_6401-6500_6479.wav,11790,11610,180
9241,b-2_713-814_802.wav,VTTS_b-2_713-814_802.wav,2510,2368,142
9242,b-2_1325-1426_1362.wav,VTTS_b-2_1325-1426_1362.wav,4870,4911,-41
9243,b-1_2927-3025_3016.wav,VTTS_b-1_2927-3025_3016.wav,2970,3483,-513
9244,b-3_501-930_927.wav,VTTS_b-3_501-930_927.wav,4470,4005,465
9245,b-1_1212-1312_1244.wav,VTTS_b-1_1212-1312_1244.wav,3520,3402,118
9246,b-4_2000-5164_4387.wav,VTTS_b-4_2000-5164_4387.wav,6535,6908,-373
9247,b-3_6301-6400_6318.wav,VTTS_b-3_6301-6400_6318.wav,4190,4319,-129
9248,b-3_3025-3111_3071.wav,VTTS_b-3_3025-3111_3071.wav,7280,6571,709
9249,b-2_2073-2106_2095.wav,VTTS_b-2_2073-2106_2095.wav,1340,1335,5
9250,b-3_1079-1320_1314.wav,VTTS_b-3_1079-1320_1314.wav,7830,6896,934
9251,b-3_196-293_216.wav,VTTS_b-3_196-293_216.wav,3730,3634,96
9252,b-3_392-500_454.wav,VTTS_b-3_392-500_454.wav,5310,5399,-89
9253,b-4_1101-1220_1112.wav,VTTS_b-4_1101-1220_1112.wav,3070,2984,86
9254,b-1_2422-2522_2506.wav,VTTS_b-1_2422-2522_2506.wav,7160,7477,-317
9255,b-4_1221-1300_1222.wav,VTTS_b-4_1221-1300_1222.wav,1720,1614,106
9256,b-3_501-930_678.wav,VTTS_b-3_501-930_678.wav,3900,4122,-222
9257,b-3_392-500_398.wav,VTTS_b-3_392-500_398.wav,6940,6490,450
9258,b-3_5428-5533_5480.wav,VTTS_b-3_5428-5533_5480.wav,3090,3019,71
9259,b-1_4394-4429_4415.wav,VTTS_b-1_4394-4429_4415.wav,1540,1474,66
9260,b-3_3538-3627_3545.wav,VTTS_b-3_3538-3627_3545.wav,1600,1614,-14
9261,b-4_401-500_434.wav,VTTS_b-4_401-500_434.wav,9700,7790,1910
9262,b-2_1699-1800_1708.wav,VTTS_b-2_1699-1800_1708.wav,2070,1788,282
9263,b-2_1-100_54.wav,VTTS_b-2_1-100_54.wav,1590,2473,-883
9264,b-3_3889-4000_3889.wav,VTTS_b-3_3889-4000_3889.wav,7820,7837,-17
9265,b-4_2000-5164_2902.wav,VTTS_b-4_2000-5164_2902.wav,3665,3680,-15
9266,b-4_53-150_54.wav,VTTS_b-4_53-150_54.wav,7520,6583,937
9267,b-2_917-1018_979.wav,VTTS_b-2_917-1018_979.wav,1880,1927,-47
9268,b-4_401-500_474.wav,VTTS_b-4_401-500_474.wav,6660,6711,-51
9269,b-4_501-1014_859.wav,VTTS_b-4_501-1014_859.wav,5060,5387,-327
9270,b-4_2000-5164_2590.wav,VTTS_b-4_2000-5164_2590.wav,4690,4551,139
9271,b-1_3127-3227_3215.wav,VTTS_b-1_3127-3227_3215.wav,1720,1776,-56
9272,b-4_1014-1100_1083.wav,VTTS_b-4_1014-1100_1083.wav,4250,4505,-255
9273,b-3_98-195_191.wav,VTTS_b-3_98-195_191.wav,7710,8684,-974
9274,b-1_1515-1615_1529.wav,VTTS_b-1_1515-1615_1529.wav,4370,3762,608
9275,b-3_3538-3627_3581.wav,VTTS_b-3_3538-3627_3581.wav,4600,4447,153
9276,b-1_4106-4141_4121.wav,VTTS_b-1_4106-4141_4121.wav,5750,6594,-844
9277,b-3_2524-2854_2585.wav,VTTS_b-3_2524-2854_2585.wav,930,813,117
9278,b-3_2350-2433_2353.wav,VTTS_b-3_2350-2433_2353.wav,2270,2612,-342
9279,b-3_1-97_81.wav,VTTS_b-3_1-97_81.wav,4080,3762,318
9280,b-4_2000-5164_3717.wav,VTTS_b-4_2000-5164_3717.wav,1860,1950,-90
9281,b-1_3935-4033_3999.wav,VTTS_b-1_3935-4033_3999.wav,3060,2844,216
9282,b-2_917-1018_938.wav,VTTS_b-2_917-1018_938.wav,5230,6211,-981
9283,b-1_4322-4357_4353.wav,VTTS_b-1_4322-4357_4353.wav,2630,2508,122
9284,b-4_2000-5164_2466.wav,VTTS_b-4_2000-5164_2466.wav,1070,975,95
9285,b-3_980-1077_1045.wav,VTTS_b-3_980-1077_1045.wav,4140,3947,193
9286,b-1_3632-3732_3716.wav,VTTS_b-1_3632-3732_3716.wav,2970,3541,-571
9287,b-1_175-275_247.wav,VTTS_b-1_175-275_247.wav,2030,1997,33
9288,b-4_2000-5164_4218.wav,VTTS_b-4_2000-5164_4218.wav,5663,5886,-223
9289,b-4_2000-5164_4128.wav,VTTS_b-4_2000-5164_4128.wav,6793,6803,-10
9290,b-4_2000-5164_4789.wav,VTTS_b-4_2000-5164_4789.wav,7825,7814,11
9291,b-3_1321-1568_1410.wav,VTTS_b-3_1321-1568_1410.wav,9210,8800,410
9292,b-4_2000-5164_4260.wav,VTTS_b-4_2000-5164_4260.wav,1863,1892,-29
9293,b-3_3112-3197_3127.wav,VTTS_b-3_3112-3197_3127.wav,7410,9242,-1832
9294,b-2_917-1018_1004.wav,VTTS_b-2_917-1018_1004.wav,3400,4180,-780
9295,b-3_6900-7016_6935.wav,VTTS_b-3_6900-7016_6935.wav,8720,9253,-533
9296,b-4_2000-5164_2682.wav,VTTS_b-4_2000-5164_2682.wav,5465,5968,-503
9297,b-4_1707-1813_1773.wav,VTTS_b-4_1707-1813_1773.wav,3530,3355,175
9298,b-4_301-400_324.wav,VTTS_b-4_301-400_324.wav,1720,1602,118
9299,b-2_713-814_805.wav,VTTS_b-2_713-814_805.wav,1480,1428,52
9300,b-4_1-52_17.wav,VTTS_b-4_1-52_17.wav,5880,6850,-970
9301,b-1_74-174_84.wav,VTTS_b-1_74-174_84.wav,1270,1207,63
9302,b-3_5009-5427_5315.wav,VTTS_b-3_5009-5427_5315.wav,6450,6513,-63
9303,b-2_1019-1120_1097.wav,VTTS_b-2_1019-1120_1097.wav,2530,2078,452
9304,b-3_3112-3197_3145.wav,VTTS_b-3_3112-3197_3145.wav,5210,5677,-467
9305,b-1_1919-2017_2005.wav,VTTS_b-1_1919-2017_2005.wav,1640,1637,3
9306,b-4_501-1014_624.wav,VTTS_b-4_501-1014_624.wav,5160,5039,121
9307,b-3_6801-6900_6880.wav,VTTS_b-3_6801-6900_6880.wav,3400,3425,-25
9308,b-1_2119-2219_2187.wav,VTTS_b-1_2119-2219_2187.wav,1970,1579,391
9309,b-2_611-712_676.wav,VTTS_b-2_611-712_676.wav,2050,1869,181
9310,b-2_2311-2412_2330.wav,VTTS_b-2_2311-2412_2330.wav,3310,3715,-405
9311,b-3_1568-1665_1625.wav,VTTS_b-3_1568-1665_1625.wav,9900,11610,-1710
9312,b-3_980-1077_1026.wav,VTTS_b-3_980-1077_1026.wav,1840,1962,-122
9313,b-1_2523-2623_2537.wav,VTTS_b-1_2523-2623_2537.wav,2450,2264,186
9314,b-4_501-1014_718.wav,VTTS_b-4_501-1014_718.wav,7500,7094,406
9315,b-3_1862-1959_1927.wav,VTTS_b-3_1862-1959_1927.wav,10230,8615,1615
9316,b-1_2624-2724_2720.wav,VTTS_b-1_2624-2724_2720.wav,2600,2496,104
9317,b-3_501-930_932.wav,VTTS_b-3_501-930_932.wav,3190,3088,102
9318,b-3_5009-5427_5073.wav,VTTS_b-3_5009-5427_5073.wav,3920,4098,-178
9319,b-3_3198-3278_3206.wav,VTTS_b-3_3198-3278_3206.wav,6510,5399,1111
9320,b-4_501-1014_932.wav,VTTS_b-4_501-1014_932.wav,8460,9218,-758
9321,b-4_501-1014_635.wav,VTTS_b-4_501-1014_635.wav,3810,4783,-973
9322,b-3_4607-5008_4831.wav,VTTS_b-3_4607-5008_4831.wav,7750,7767,-17
9323,b-3_2855-2942_2917.wav,VTTS_b-3_2855-2942_2917.wav,5250,5909,-659
9324,b-1_276-376_347.wav,VTTS_b-1_276-376_347.wav,4840,4621,219
9325,b-3_2524-2854_2630.wav,VTTS_b-3_2524-2854_2630.wav,2520,2868,-348
9326,b-4_2000-5164_3265.wav,VTTS_b-4_2000-5164_3265.wav,3925,5352,-1427
9327,b-2_1427-1562_1554.wav,VTTS_b-2_1427-1562_1554.wav,1430,1428,2
9328,b-3_501-930_733.wav,VTTS_b-3_501-930_733.wav,6720,6943,-223
9329,b-4_1221-1300_1227.wav,VTTS_b-4_1221-1300_1227.wav,3930,3564,366
9330,b-4_2000-5164_2101.wav,VTTS_b-4_2000-5164_2101.wav,5300,5016,284
9331,b-3_501-930_857.wav,VTTS_b-3_501-930_857.wav,4160,5898,-1738
9332,b-3_5745-5852_5829.wav,VTTS_b-3_5745-5852_5829.wav,4940,4307,633
9333,b-3_6401-6500_6426.wav,VTTS_b-3_6401-6500_6426.wav,4490,4075,415
9334,b-3_196-293_252.wav,VTTS_b-3_196-293_252.wav,4720,3332,1388
9335,b-2_407-508_421.wav,VTTS_b-2_407-508_421.wav,2310,2972,-662
9336,b-3_5745-5852_5785.wav,VTTS_b-3_5745-5852_5785.wav,5970,5817,153
9337,b-4_2000-5164_3462.wav,VTTS_b-4_2000-5164_3462.wav,3975,11610,-7635
9338,b-1_478-578_506.wav,VTTS_b-1_478-578_506.wav,1600,1718,-118
9339,b-1_1010-1110_1060.wav,VTTS_b-1_1010-1110_1060.wav,800,836,-36
9340,b-3_6116-6215_6151.wav,VTTS_b-3_6116-6215_6151.wav,2090,1950,140
9341,b-1_1414-1514_1470.wav,VTTS_b-1_1414-1514_1470.wav,4710,4226,484
9342,b-1_1515-1615_1607.wav,VTTS_b-1_1515-1615_1607.wav,3570,3332,238
9343,b-3_1-97_37.wav,VTTS_b-3_1-97_37.wav,6020,5085,935
9344,b-3_1-97_99.wav,VTTS_b-3_1-97_99.wav,5670,6711,-1041
9345,b-2_407-508_486.wav,VTTS_b-2_407-508_486.wav,2140,3111,-971
9346,b-4_2000-5164_3596.wav,VTTS_b-4_2000-5164_3596.wav,4567,3866,701
9347,b-3_5957-6015_5994.wav,VTTS_b-3_5957-6015_5994.wav,6260,6490,-230
9348,b-1_1717-1817_1728.wav,VTTS_b-1_1717-1817_1728.wav,2280,1904,376
9349,b-3_2350-2433_2392.wav,VTTS_b-3_2350-2433_2392.wav,7240,7140,100
9350,b-2_101-202_129.wav,VTTS_b-2_101-202_129.wav,1680,2229,-549
9351,b-3_3803-3888_3868.wav,VTTS_b-3_3803-3888_3868.wav,5970,6803,-833
9352,b-1_1919-2017_1950.wav,VTTS_b-1_1919-2017_1950.wav,2520,2705,-185
9353,b-4_1221-1300_1283.wav,VTTS_b-4_1221-1300_1283.wav,4770,5700,-930
9354,b-4_2000-5164_4229.wav,VTTS_b-4_2000-5164_4229.wav,10925,9694,1231
9355,b-2_2209-2310_2262.wav,VTTS_b-2_2209-2310_2262.wav,1380,1219,161
9356,b-2_305-406_375.wav,VTTS_b-2_305-406_375.wav,910,871,39
9357,b-3_1764-1861_1796.wav,VTTS_b-3_1764-1861_1796.wav,6950,7070,-120
9358,b-3_196-293_261.wav,VTTS_b-3_196-293_261.wav,12970,11610,1360
9359,b-3_2943-3024_3009.wav,VTTS_b-3_2943-3024_3009.wav,4050,4296,-246
9360,b-1_1414-1514_1483.wav,VTTS_b-1_1414-1514_1483.wav,1900,1869,31
9361,b-2_611-712_668.wav,VTTS_b-2_611-712_668.wav,2010,2380,-370
9362,b-1_1010-1110_1025.wav,VTTS_b-1_1010-1110_1025.wav,2980,2740,240
9363,b-2_1597-1698_1691.wav,VTTS_b-2_1597-1698_1691.wav,5430,6420,-990
9364,b-2_1-100_2.wav,VTTS_b-2_1-100_2.wav,7960,11018,-3058
9365,b-4_2000-5164_3380.wav,VTTS_b-4_2000-5164_3380.wav,3461,3204,257
9366,b-3_2000-2088_2040.wav,VTTS_b-3_2000-2088_2040.wav,3140,2763,377
9367,b-2_917-1018_950.wav,VTTS_b-2_917-1018_950.wav,3740,4423,-683
9368,b-1_2624-2724_2666.wav,VTTS_b-1_2624-2724_2666.wav,1540,1858,-318
9369,b-4_401-500_475.wav,VTTS_b-4_401-500_475.wav,11270,11610,-340
9370,b-4_2000-5164_2275.wav,VTTS_b-4_2000-5164_2275.wav,8980,8371,609
9371,b-3_3803-3888_3878.wav,VTTS_b-3_3803-3888_3878.wav,2930,3111,-181
9372,b-1_2523-2623_2540.wav,VTTS_b-1_2523-2623_2540.wav,1500,1428,72
9373,b-1_3733-3833_3760.wav,VTTS_b-1_3733-3833_3760.wav,2370,2392,-22
9374,b-3_501-930_515.wav,VTTS_b-3_501-930_515.wav,8870,9451,-581
9375,b-1_2321-2421_2398.wav,VTTS_b-1_2321-2421_2398.wav,3300,2891,409
9376,b-1_1919-2017_2001.wav,VTTS_b-1_1919-2017_2001.wav,1980,3111,-1131
9377,b-4_53-150_95.wav,VTTS_b-4_53-150_95.wav,8700,8092,608
9378,b-2_1903-2038_1958.wav,VTTS_b-2_1903-2038_1958.wav,3010,2752,258
9379,b-3_6900-7016_6990.wav,VTTS_b-3_6900-7016_6990.wav,4810,4690,120
9380,b-2_1597-1698_1700.wav,VTTS_b-2_1597-1698_1700.wav,6180,5909,271
9381,b-4_2000-5164_2205.wav,VTTS_b-4_2000-5164_2205.wav,3285,3146,139
9382,b-4_301-400_342.wav,VTTS_b-4_301-400_342.wav,5000,5341,-341
9383,b-4_1707-1813_1776.wav,VTTS_b-4_1707-1813_1776.wav,4670,4365,305
9384,b-2_101-202_103.wav,VTTS_b-2_101-202_103.wav,1950,1846,104
9385,b-3_5853-5956_5867.wav,VTTS_b-3_5853-5956_5867.wav,2800,2717,83
9386,b-2_1597-1698_1652.wav,VTTS_b-2_1597-1698_1652.wav,3110,3170,-60
9387,b-4_2000-5164_2156.wav,VTTS_b-4_2000-5164_2156.wav,1190,1080,110
9388,b-3_3112-3197_3114.wav,VTTS_b-3_3112-3197_3114.wav,5530,5666,-136
9389,b-4_2000-5164_2268.wav,VTTS_b-4_2000-5164_2268.wav,14700,11610,3090
9390,b-4_1506-1600_1554.wav,VTTS_b-4_1506-1600_1554.wav,5640,5248,392
9391,b-2_1597-1698_1689.wav,VTTS_b-2_1597-1698_1689.wav,6710,8127,-1417
9392,b-2_305-406_332.wav,VTTS_b-2_305-406_332.wav,3310,5050,-1740
9393,b-3_5009-5427_5156.wav,VTTS_b-3_5009-5427_5156.wav,6380,6293,87
9394,b-3_3803-3888_3834.wav,VTTS_b-3_3803-3888_3834.wav,4190,4307,-117
9395,b-3_501-930_925.wav,VTTS_b-3_501-930_925.wav,3560,2902,658
9396,b-3_3198-3278_3266.wav,VTTS_b-3_3198-3278_3266.wav,3720,3878,-158
9397,b-1_2220-2320_2310.wav,VTTS_b-1_2220-2320_2310.wav,1890,1776,114
9398,b-4_1101-1220_1215.wav,VTTS_b-4_1101-1220_1215.wav,6120,9427,-3307
9399,b-1_3531-3631_3614.wav,VTTS_b-1_3531-3631_3614.wav,1420,1428,-8
9400,b-3_4607-5008_4907.wav,VTTS_b-3_4607-5008_4907.wav,6630,6281,349
9401,b-4_501-1014_639.wav,VTTS_b-4_501-1014_639.wav,4230,3924,306
9402,b-3_1079-1320_1190.wav,VTTS_b-3_1079-1320_1190.wav,7390,7233,157
9403,b-3_3538-3627_3629.wav,VTTS_b-3_3538-3627_3629.wav,3730,3680,50
9404,b-1_3733-3833_3753.wav,VTTS_b-1_3733-3833_3753.wav,2770,3901,-1131
9405,b-4_1221-1300_1273.wav,VTTS_b-4_1221-1300_1273.wav,1000,4899,-3899
9406,b-4_1506-1600_1578.wav,VTTS_b-4_1506-1600_1578.wav,15090,11610,3480
9407,b-3_1321-1568_1377.wav,VTTS_b-3_1321-1568_1377.wav,2730,2798,-68
9408,b-3_3364-3453_3429.wav,VTTS_b-3_3364-3453_3429.wav,7320,6780,540
9409,b-3_5639-5744_5702.wav,VTTS_b-3_5639-5744_5702.wav,4600,5735,-1135
9410,b-4_501-1014_569.wav,VTTS_b-4_501-1014_569.wav,2020,2717,-697
9411,b-3_5009-5427_5273.wav,VTTS_b-3_5009-5427_5273.wav,6700,6757,-57
9412,b-3_2524-2854_2842.wav,VTTS_b-3_2524-2854_2842.wav,5920,6374,-454
9413,b-1_4466-4498_4485.wav,VTTS_b-1_4466-4498_4485.wav,3010,3181,-171
9414,b-1_377-477_422.wav,VTTS_b-1_377-477_422.wav,1400,1683,-283
9415,b-3_3025-3111_3074.wav,VTTS_b-3_3025-3111_3074.wav,6210,6664,-454
9416,b-4_2000-5164_4161.wav,VTTS_b-4_2000-5164_4161.wav,5086,4957,129
9417,b-3_6274-6300_6279.wav,VTTS_b-3_6274-6300_6279.wav,5280,5085,195
9418,b-4_2000-5164_3333.wav,VTTS_b-4_2000-5164_3333.wav,6467,6037,430
9419,b-4_1401-1505_1441.wav,VTTS_b-4_1401-1505_1441.wav,5430,5050,380
9420,b-3_1568-1665_1639.wav,VTTS_b-3_1568-1665_1639.wav,4940,4737,203
9421,b-4_2000-5164_2332.wav,VTTS_b-4_2000-5164_2332.wav,7265,7407,-142
9422,b-2_1801-1902_1840.wav,VTTS_b-2_1801-1902_1840.wav,1730,1834,-104
9423,b-4_1014-1100_1040.wav,VTTS_b-4_1014-1100_1040.wav,2760,2810,-50
9424,b-3_5009-5427_5027.wav,VTTS_b-3_5009-5427_5027.wav,6960,7837,-877
9425,b-3_2524-2854_2632.wav,VTTS_b-3_2524-2854_2632.wav,3690,3309,381
9426,b-3_2524-2854_2604.wav,VTTS_b-3_2524-2854_2604.wav,2870,2752,118
9427,b-1_2119-2219_2201.wav,VTTS_b-1_2119-2219_2201.wav,6390,6908,-518
9428,b-3_5428-5533_5474.wav,VTTS_b-3_5428-5533_5474.wav,6940,8475,-1535
9429,b-3_1079-1320_1286.wav,VTTS_b-3_1079-1320_1286.wav,3940,3982,-42
9430,b-4_301-400_361.wav,VTTS_b-4_301-400_361.wav,2840,2612,228
9431,b-1_3026-3126_3069.wav,VTTS_b-1_3026-3126_3069.wav,4520,4865,-345
9432,b-4_2000-5164_4391.wav,VTTS_b-4_2000-5164_4391.wav,3040,3193,-153
9433,b-3_196-293_205.wav,VTTS_b-3_196-293_205.wav,4410,4063,347
9434,b-4_1101-1220_1108.wav,VTTS_b-4_1101-1220_1108.wav,8490,8150,340
9435,b-3_1079-1320_1203.wav,VTTS_b-3_1079-1320_1203.wav,4220,4191,29
9436,b-3_4001-4103_4036.wav,VTTS_b-3_4001-4103_4036.wav,3610,11610,-8000
9437,b-3_4104-4206_4107.wav,VTTS_b-3_4104-4206_4107.wav,6060,6420,-360
9438,b-4_501-1014_1003.wav,VTTS_b-4_501-1014_1003.wav,2510,2508,2
9439,b-1_2220-2320_2241.wav,VTTS_b-1_2220-2320_2241.wav,1570,1985,-415
9440,b-4_501-1014_890.wav,VTTS_b-4_501-1014_890.wav,4740,4667,73
9441,b-4_1401-1505_1421.wav,VTTS_b-4_1401-1505_1421.wav,2970,2357,613
9442,b-4_2000-5164_2517.wav,VTTS_b-4_2000-5164_2517.wav,2520,2485,35
9443,b-4_2000-5164_2958.wav,VTTS_b-4_2000-5164_2958.wav,9604,9973,-369
9444,b-4_2000-5164_3611.wav,VTTS_b-4_2000-5164_3611.wav,4028,4238,-210
9445,b-2_101-202_101.wav,VTTS_b-2_101-202_101.wav,1330,1161,169
9446,b-3_6501-6600_6592.wav,VTTS_b-3_6501-6600_6592.wav,7420,6873,547
9447,b-4_2000-5164_2391.wav,VTTS_b-4_2000-5164_2391.wav,4050,4714,-664
9448,b-1_3733-3833_3776.wav,VTTS_b-1_3733-3833_3776.wav,4220,5886,-1666
9449,b-3_4498-4605_4503.wav,VTTS_b-3_4498-4605_4503.wav,5930,11610,-5680
9450,b-3_6801-6900_6878.wav,VTTS_b-3_6801-6900_6878.wav,5090,4563,527
9451,b-3_2524-2854_2640.wav,VTTS_b-3_2524-2854_2640.wav,5560,5654,-94
9452,b-4_1301-1400_1387.wav,VTTS_b-4_1301-1400_1387.wav,5880,5445,435
9453,b-1_2119-2219_2125.wav,VTTS_b-1_2119-2219_2125.wav,1510,1765,-255
9454,b-3_2855-2942_2930.wav,VTTS_b-3_2855-2942_2930.wav,6520,9601,-3081
9455,b-1_1515-1615_1580.wav,VTTS_b-1_1515-1615_1580.wav,1700,1765,-65
9456,b-3_4315-4424_4349.wav,VTTS_b-3_4315-4424_4349.wav,2990,2682,308
9457,b-4_1301-1400_1381.wav,VTTS_b-4_1301-1400_1381.wav,1590,1382,208
9458,b-4_1814-1900_1877.wav,VTTS_b-4_1814-1900_1877.wav,5560,5352,208
9459,b-3_2000-2088_2022.wav,VTTS_b-3_2000-2088_2022.wav,3600,3785,-185
9460,b-4_1901-2000_1965.wav,VTTS_b-4_1901-2000_1965.wav,10250,11157,-907
9461,b-1_2119-2219_2167.wav,VTTS_b-1_2119-2219_2167.wav,1790,1161,629
9462,b-4_2000-5164_5104.wav,VTTS_b-4_2000-5164_5104.wav,3972,3785,187
9463,b-4_2000-5164_2286.wav,VTTS_b-4_2000-5164_2286.wav,6265,6560,-295
9464,b-4_2000-5164_2015.wav,VTTS_b-4_2000-5164_2015.wav,7100,9462,-2362
9465,b-3_5009-5427_5193.wav,VTTS_b-3_5009-5427_5193.wav,7260,6583,677
9466,b-1_2321-2421_2387.wav,VTTS_b-1_2321-2421_2387.wav,2350,3622,-1272
9467,b-4_1401-1505_1496.wav,VTTS_b-4_1401-1505_1496.wav,3080,3413,-333
9468,b-4_1601-1706_1673.wav,VTTS_b-4_1601-1706_1673.wav,5290,6908,-1618
9469,b-4_2000-5164_3807.wav,VTTS_b-4_2000-5164_3807.wav,3264,4133,-869
9470,b-2_101-202_164.wav,VTTS_b-2_101-202_164.wav,1490,1637,-147
9471,b-4_2000-5164_2442.wav,VTTS_b-4_2000-5164_2442.wav,5370,7082,-1712
9472,b-3_2177-2266_2237.wav,VTTS_b-3_2177-2266_2237.wav,6710,5979,731
9473,b-4_501-1014_775.wav,VTTS_b-4_501-1014_775.wav,3160,3564,-404
9474,b-1_1717-1817_1791.wav,VTTS_b-1_1717-1817_1791.wav,3650,2902,748
9475,b-3_4001-4103_4087.wav,VTTS_b-3_4001-4103_4087.wav,6910,7384,-474
9476,b-3_1764-1861_1824.wav,VTTS_b-3_1764-1861_1824.wav,2330,3077,-747
9477,b-4_2000-5164_2678.wav,VTTS_b-4_2000-5164_2678.wav,10800,9915,885
9478,b-3_2943-3024_3018.wav,VTTS_b-3_2943-3024_3018.wav,3790,3901,-111
9479,b-3_501-930_859.wav,VTTS_b-3_501-930_859.wav,5840,6943,-1103
9480,b-4_2000-5164_5046.wav,VTTS_b-4_2000-5164_5046.wav,2509,2159,350
9481,b-2_2311-2412_2358.wav,VTTS_b-2_2311-2412_2358.wav,1930,2020,-90
9482,b-3_501-930_691.wav,VTTS_b-3_501-930_691.wav,4180,5642,-1462
9483,b-1_377-477_402.wav,VTTS_b-1_377-477_402.wav,2210,2241,-31
9484,b-4_2000-5164_2359.wav,VTTS_b-4_2000-5164_2359.wav,4995,4899,96
9485,b-2_101-202_162.wav,VTTS_b-2_101-202_162.wav,1520,1544,-24
9486,b-1_1414-1514_1511.wav,VTTS_b-1_1414-1514_1511.wav,3440,3019,421
9487,b-3_196-293_279.wav,VTTS_b-3_196-293_279.wav,3770,3344,426
9488,b-4_2000-5164_2940.wav,VTTS_b-4_2000-5164_2940.wav,5378,5596,-218
9489,b-4_2000-5164_2180.wav,VTTS_b-4_2000-5164_2180.wav,3505,4690,-1185
9490,b-1_3733-3833_3785.wav,VTTS_b-1_3733-3833_3785.wav,2020,2810,-790
9491,b-1_3632-3732_3646.wav,VTTS_b-1_3632-3732_3646.wav,2090,2589,-499
9492,b-1_377-477_420.wav,VTTS_b-1_377-477_420.wav,1620,1695,-75
9493,b-3_3454-3537_3520.wav,VTTS_b-3_3454-3537_3520.wav,4430,4435,-5
9494,b-2_2311-2412_2390.wav,VTTS_b-2_2311-2412_2390.wav,1220,1382,-162
9495,b-1_2523-2623_2620.wav,VTTS_b-1_2523-2623_2620.wav,2200,2136,64
9496,b-3_6401-6500_6447.wav,VTTS_b-3_6401-6500_6447.wav,1490,1451,39
9497,b-3_2434-2523_2460.wav,VTTS_b-3_2434-2523_2460.wav,3960,3065,895
9498,b-4_2000-5164_3394.wav,VTTS_b-4_2000-5164_3394.wav,4633,4679,-46
9499,b-3_3279-3363_3346.wav,VTTS_b-3_3279-3363_3346.wav,10090,9532,558
9500,b-1_2523-2623_2580.wav,VTTS_b-1_2523-2623_2580.wav,2410,2241,169
9501,b-2_1427-1562_1529.wav,VTTS_b-2_1427-1562_1529.wav,4150,3437,713
9502,b-4_1401-1505_1419.wav,VTTS_b-4_1401-1505_1419.wav,3120,2879,241
9503,b-4_2000-5164_2993.wav,VTTS_b-4_2000-5164_2993.wav,2475,2543,-68
9504,b-3_4207-4314_4245.wav,VTTS_b-3_4207-4314_4245.wav,4170,4447,-277
9505,b-4_2000-5164_2721.wav,VTTS_b-4_2000-5164_2721.wav,4275,4063,212
9506,b-3_4104-4206_4197.wav,VTTS_b-3_4104-4206_4197.wav,3760,3611,149
9507,b-3_3025-3111_3078.wav,VTTS_b-3_3025-3111_3078.wav,6580,6432,148
9508,b-3_2350-2433_2368.wav,VTTS_b-3_2350-2433_2368.wav,4750,5190,-440
9509,b-3_4607-5008_4785.wav,VTTS_b-3_4607-5008_4785.wav,4570,4098,472
9510,b-1_1717-1817_1813.wav,VTTS_b-1_1717-1817_1813.wav,1370,1358,12
9511,b-2_1019-1120_1034.wav,VTTS_b-2_1019-1120_1034.wav,1560,1440,120
9512,b-4_2000-5164_4372.wav,VTTS_b-4_2000-5164_4372.wav,1705,1207,498
9513,b-4_2000-5164_4316.wav,VTTS_b-4_2000-5164_4316.wav,6709,6908,-199
9514,b-1_2624-2724_2660.wav,VTTS_b-1_2624-2724_2660.wav,2950,3088,-138
9515,b-3_1568-1665_1638.wav,VTTS_b-3_1568-1665_1638.wav,3910,3529,381
9516,b-1_74-174_166.wav,VTTS_b-1_74-174_166.wav,1510,1591,-81
9517,b-3_2524-2854_2772.wav,VTTS_b-3_2524-2854_2772.wav,4540,3855,685
9518,b-3_1-97_49.wav,VTTS_b-3_1-97_49.wav,4540,4795,-255
9519,b-4_2000-5164_3544.wav,VTTS_b-4_2000-5164_3544.wav,4059,4528,-469
9520,b-1_3632-3732_3689.wav,VTTS_b-1_3632-3732_3689.wav,1280,1312,-32
9521,b-3_6217-6274_6233.wav,VTTS_b-3_6217-6274_6233.wav,1800,1892,-92
9522,b-3_5009-5427_5362.wav,VTTS_b-3_5009-5427_5362.wav,3650,3495,155
9523,b-4_1601-1706_1647.wav,VTTS_b-4_1601-1706_1647.wav,4740,4946,-206
9524,b-3_196-293_213.wav,VTTS_b-3_196-293_213.wav,4720,5468,-748
9525,b-4_2000-5164_4345.wav,VTTS_b-4_2000-5164_4345.wav,8095,9276,-1181
9526,b-3_3198-3278_3268.wav,VTTS_b-3_3198-3278_3268.wav,5200,5062,138
9527,b-3_6116-6215_6177.wav,VTTS_b-3_6116-6215_6177.wav,6260,6385,-125
9528,b-3_5745-5852_5852.wav,VTTS_b-3_5745-5852_5852.wav,5070,5178,-108
9529,b-3_4498-4605_4579.wav,VTTS_b-3_4498-4605_4579.wav,9060,9021,39
9530,b-1_1919-2017_1968.wav,VTTS_b-1_1919-2017_1968.wav,5470,6037,-567
9531,b-3_2524-2854_2627.wav,VTTS_b-3_2524-2854_2627.wav,6740,9149,-2409
9532,b-4_1101-1220_1164.wav,VTTS_b-4_1101-1220_1164.wav,2270,2368,-98
9533,b-4_501-1014_911.wav,VTTS_b-4_501-1014_911.wav,8060,7686,374
9534,b-2_611-712_660.wav,VTTS_b-2_611-712_660.wav,1160,1405,-245
9535,b-3_5009-5427_5160.wav,VTTS_b-3_5009-5427_5160.wav,3210,3262,-52
9536,b-4_2000-5164_2710.wav,VTTS_b-4_2000-5164_2710.wav,1590,1463,127
9537,b-2_1699-1800_1783.wav,VTTS_b-2_1699-1800_1783.wav,3880,5236,-1356
9538,b-4_2000-5164_3565.wav,VTTS_b-4_2000-5164_3565.wav,3011,2659,352
9539,b-3_2000-2088_2072.wav,VTTS_b-3_2000-2088_2072.wav,7280,6420,860
9540,b-3_98-195_118.wav,VTTS_b-3_98-195_118.wav,5200,4586,614
9541,b-3_98-195_160.wav,VTTS_b-3_98-195_160.wav,4610,6281,-1671
9542,b-1_794-1009_880.wav,VTTS_b-1_794-1009_880.wav,3270,3344,-74
9543,b-2_1427-1562_1512.wav,VTTS_b-2_1427-1562_1512.wav,4900,7059,-2159
9544,b-3_2524-2854_2639.wav,VTTS_b-3_2524-2854_2639.wav,1780,1846,-66
9545,b-3_4425-4497_4456.wav,VTTS_b-3_4425-4497_4456.wav,4310,4505,-195
9546,b-3_1079-1320_1250.wav,VTTS_b-3_1079-1320_1250.wav,9250,9555,-305
9547,b-3_1764-1861_1811.wav,VTTS_b-3_1764-1861_1811.wav,5070,5224,-154
9548,b-4_2000-5164_3574.wav,VTTS_b-4_2000-5164_3574.wav,3833,3773,60
9549,b-4_2000-5164_4066.wav,VTTS_b-4_2000-5164_4066.wav,5808,5120,688
9550,b-4_2000-5164_4375.wav,VTTS_b-4_2000-5164_4375.wav,3505,3529,-24
9551,b-1_2927-3025_2958.wav,VTTS_b-1_2927-3025_2958.wav,4120,4899,-779
9552,b-3_4607-5008_4784.wav,VTTS_b-3_4607-5008_4784.wav,2510,2426,84
9553,b-1_1-73_37.wav,VTTS_b-1_1-73_37.wav,2140,2159,-19
9554,b-3_6501-6600_6564.wav,VTTS_b-3_6501-6600_6564.wav,3970,3808,162
9555,b-4_2000-5164_3046.wav,VTTS_b-4_2000-5164_3046.wav,2711,2554,157
9556,b-4_2000-5164_2586.wav,VTTS_b-4_2000-5164_2586.wav,6340,6641,-301
9557,b-3_501-930_555.wav,VTTS_b-3_501-930_555.wav,6250,7187,-937
9558,b-3_2089-2176_2090.wav,VTTS_b-3_2089-2176_2090.wav,5270,5944,-674
9559,b-3_1321-1568_1502.wav,VTTS_b-3_1321-1568_1502.wav,3980,3437,543
9560,b-4_2000-5164_5111.wav,VTTS_b-4_2000-5164_5111.wav,6125,6118,7
9561,b-3_5009-5427_5135.wav,VTTS_b-3_5009-5427_5135.wav,3900,3228,672
9562,b-4_1101-1220_1194.wav,VTTS_b-4_1101-1220_1194.wav,8130,7744,386
9563,b-1_3632-3732_3671.wav,VTTS_b-1_3632-3732_3671.wav,1390,1370,20
9564,b-1_74-174_121.wav,VTTS_b-1_74-174_121.wav,4280,5666,-1386
9565,b-3_501-930_847.wav,VTTS_b-3_501-930_847.wav,3390,2879,511
9566,b-1_74-174_170.wav,VTTS_b-1_74-174_170.wav,1220,1173,47
9567,b-4_1014-1100_1017.wav,VTTS_b-4_1014-1100_1017.wav,8290,7245,1045
9568,b-2_1121-1222_1194.wav,VTTS_b-2_1121-1222_1194.wav,2250,2148,102
9569,b-3_5853-5956_5947.wav,VTTS_b-3_5853-5956_5947.wav,4720,4981,-261
9570,b-4_501-1014_978.wav,VTTS_b-4_501-1014_978.wav,4340,3785,555
9571,b-3_6801-6900_6826.wav,VTTS_b-3_6801-6900_6826.wav,1600,1428,172
9572,b-4_2000-5164_5029.wav,VTTS_b-4_2000-5164_5029.wav,4128,4458,-330
9573,b-3_5009-5427_5238.wav,VTTS_b-3_5009-5427_5238.wav,4420,4331,89
9574,b-3_4315-4424_4335.wav,VTTS_b-3_4315-4424_4335.wav,7690,10437,-2747
9575,b-1_4178-4213_4200.wav,VTTS_b-1_4178-4213_4200.wav,3690,3320,370
9576,b-3_2943-3024_3024.wav,VTTS_b-3_2943-3024_3024.wav,3620,3425,195
9577,b-2_1-100_22.wav,VTTS_b-2_1-100_22.wav,2680,4493,-1813
9578,b-2_1597-1698_1617.wav,VTTS_b-2_1597-1698_1617.wav,6980,6223,757
9579,b-4_2000-5164_4131.wav,VTTS_b-4_2000-5164_4131.wav,3446,3437,9
9580,b-1_1717-1817_1792.wav,VTTS_b-1_1717-1817_1792.wav,2410,2775,-365
9581,b-1_478-578_561.wav,VTTS_b-1_478-578_561.wav,1770,1602,168
9582,b-4_2000-5164_2967.wav,VTTS_b-4_2000-5164_2967.wav,1584,1416,168
9583,b-4_1506-1600_1510.wav,VTTS_b-4_1506-1600_1510.wav,7440,7384,56
9584,b-3_3715-3802_3732.wav,VTTS_b-3_3715-3802_3732.wav,3170,3170,0
9585,b-4_2000-5164_2429.wav,VTTS_b-4_2000-5164_2429.wav,5460,5666,-206
9586,b-4_2000-5164_3605.wav,VTTS_b-4_2000-5164_3605.wav,3139,3204,-65
9587,b-4_1814-1900_1859.wav,VTTS_b-4_1814-1900_1859.wav,3480,3947,-467
9588,b-3_1079-1320_1109.wav,VTTS_b-3_1079-1320_1109.wav,5670,5654,16
9589,b-1_1818-1918_1823.wav,VTTS_b-1_1818-1918_1823.wav,2870,2786,84
9590,b-4_151-300_156.wav,VTTS_b-4_151-300_156.wav,6950,5863,1087
9591,b-3_4607-5008_4943.wav,VTTS_b-3_4607-5008_4943.wav,7390,7721,-331
9592,b-3_501-930_824.wav,VTTS_b-3_501-930_824.wav,5010,6118,-1108
9593,b-1_1313-1413_1410.wav,VTTS_b-1_1313-1413_1410.wav,4830,4156,674
9594,b-4_2000-5164_2589.wav,VTTS_b-4_2000-5164_2589.wav,2015,1765,250
9595,b-4_2000-5164_4872.wav,VTTS_b-4_2000-5164_4872.wav,2111,1823,288
9596,b-1_3026-3126_3074.wav,VTTS_b-1_3026-3126_3074.wav,4040,4087,-47
9597,b-3_6116-6215_6190.wav,VTTS_b-3_6116-6215_6190.wav,7110,11610,-4500
9598,b-3_5428-5533_5473.wav,VTTS_b-3_5428-5533_5473.wav,4250,4180,70
9599,b-4_1506-1600_1573.wav,VTTS_b-4_1506-1600_1573.wav,6950,6362,588
9600,b-4_151-300_291.wav,VTTS_b-4_151-300_291.wav,6910,6211,699
9601,b-3_931-979_936.wav,VTTS_b-3_931-979_936.wav,6600,6943,-343
9602,b-3_6301-6400_6364.wav,VTTS_b-3_6301-6400_6364.wav,1920,1765,155
9603,b-2_611-712_698.wav,VTTS_b-2_611-712_698.wav,4990,5039,-49
9604,b-2_407-508_468.wav,VTTS_b-2_407-508_468.wav,1270,1300,-30
9605,b-2_1903-2038_1990.wav,VTTS_b-2_1903-2038_1990.wav,2330,2763,-433
9606,b-3_3198-3278_3236.wav,VTTS_b-3_3198-3278_3236.wav,3910,3541,369
9607,b-4_2000-5164_3207.wav,VTTS_b-4_2000-5164_3207.wav,1203,1161,42
9608,b-3_1079-1320_1137.wav,VTTS_b-3_1079-1320_1137.wav,5750,5561,189
9609,b-3_98-195_143.wav,VTTS_b-3_98-195_143.wav,8690,7558,1132
9610,b-4_1401-1505_1411.wav,VTTS_b-4_1401-1505_1411.wav,7190,6304,886
9611,b-3_1862-1959_1871.wav,VTTS_b-3_1862-1959_1871.wav,8340,7407,933
9612,b-3_4001-4103_4053.wav,VTTS_b-3_4001-4103_4053.wav,6600,7256,-656
9613,b-1_3228-3328_3321.wav,VTTS_b-1_3228-3328_3321.wav,2550,2717,-167
9614,b-2_2311-2412_2365.wav,VTTS_b-2_2311-2412_2365.wav,3060,2786,274
9615,b-2_1597-1698_1609.wav,VTTS_b-2_1597-1698_1609.wav,950,1033,-83
9616,b-3_4607-5008_4745.wav,VTTS_b-3_4607-5008_4745.wav,4390,4481,-91
9617,b-3_2524-2854_2758.wav,VTTS_b-3_2524-2854_2758.wav,3160,3135,25
9618,b-1_3935-4033_4008.wav,VTTS_b-1_3935-4033_4008.wav,2080,2264,-184
9619,b-3_4607-5008_4952.wav,VTTS_b-3_4607-5008_4952.wav,6330,5805,525
9620,b-4_2000-5164_2187.wav,VTTS_b-4_2000-5164_2187.wav,7380,8011,-631
9621,b-4_2000-5164_4277.wav,VTTS_b-4_2000-5164_4277.wav,2197,1997,200
9622,b-3_4207-4314_4282.wav,VTTS_b-3_4207-4314_4282.wav,6100,6316,-216
9623,b-1_1212-1312_1309.wav,VTTS_b-1_1212-1312_1309.wav,4740,10879,-6139
9624,b-3_5009-5427_5103.wav,VTTS_b-3_5009-5427_5103.wav,2880,2728,152
9625,b-4_2000-5164_4701.wav,VTTS_b-4_2000-5164_4701.wav,9746,11610,-1864
9626,b-3_2524-2854_2638.wav,VTTS_b-3_2524-2854_2638.wav,4860,4574,286
9627,b-2_1325-1426_1373.wav,VTTS_b-2_1325-1426_1373.wav,4720,10136,-5416
9628,b-3_5009-5427_5321.wav,VTTS_b-3_5009-5427_5321.wav,1030,917,113
9629,b-1_2927-3025_3010.wav,VTTS_b-1_2927-3025_3010.wav,3280,3111,169
9630,b-2_917-1018_1014.wav,VTTS_b-2_917-1018_1014.wav,4090,3367,723
9631,b-4_2000-5164_4580.wav,VTTS_b-4_2000-5164_4580.wav,5409,5898,-489
9632,b-3_501-930_542.wav,VTTS_b-3_501-930_542.wav,8560,7872,688
9633,b-2_1597-1698_1624.wav,VTTS_b-2_1597-1698_1624.wav,1770,1846,-76
9634,b-3_196-293_209.wav,VTTS_b-3_196-293_209.wav,9830,10797,-967
9635,b-1_4322-4357_4339.wav,VTTS_b-1_4322-4357_4339.wav,1190,1277,-87
9636,b-2_815-916_905.wav,VTTS_b-2_815-916_905.wav,1700,1950,-250
9637,b-3_3364-3453_3417.wav,VTTS_b-3_3364-3453_3417.wav,4000,3831,169
9638,b-2_1563-1596_1569.wav,VTTS_b-2_1563-1596_1569.wav,1330,1265,65
9639,b-3_3198-3278_3256.wav,VTTS_b-3_3198-3278_3256.wav,2090,2287,-197
9640,b-4_2000-5164_2509.wav,VTTS_b-4_2000-5164_2509.wav,2180,2299,-119
9641,b-3_3454-3537_3476.wav,VTTS_b-3_3454-3537_3476.wav,4800,4516,284
9642,b-1_794-1009_892.wav,VTTS_b-1_794-1009_892.wav,3590,3692,-102
9643,b-4_53-150_89.wav,VTTS_b-4_53-150_89.wav,9920,10136,-216
9644,b-3_4315-4424_4419.wav,VTTS_b-3_4315-4424_4419.wav,4130,3831,299
9645,b-2_305-406_402.wav,VTTS_b-2_305-406_402.wav,5820,6966,-1146
9646,b-3_2434-2523_2447.wav,VTTS_b-3_2434-2523_2447.wav,3020,2694,326
9647,b-2_1019-1120_1118.wav,VTTS_b-2_1019-1120_1118.wav,2270,1881,389
9648,b-4_401-500_433.wav,VTTS_b-4_401-500_433.wav,4260,4377,-117
9649,b-4_2000-5164_2324.wav,VTTS_b-4_2000-5164_2324.wav,3245,4063,-818
9650,b-1_2119-2219_2209.wav,VTTS_b-1_2119-2219_2209.wav,3940,2972,968
9651,b-1_2321-2421_2361.wav,VTTS_b-1_2321-2421_2361.wav,2500,2322,178
9652,b-1_1919-2017_1965.wav,VTTS_b-1_1919-2017_1965.wav,3000,2879,121
9653,b-2_1019-1120_1065.wav,VTTS_b-2_1019-1120_1065.wav,1870,1660,210
9654,b-3_2524-2854_2659.wav,VTTS_b-3_2524-2854_2659.wav,4910,5004,-94
9655,b-3_501-930_831.wav,VTTS_b-3_501-930_831.wav,4390,4133,257
9656,b-4_401-500_403.wav,VTTS_b-4_401-500_403.wav,5190,6432,-1242
9657,b-4_401-500_480.wav,VTTS_b-4_401-500_480.wav,6150,5979,171
9658,b-3_2943-3024_2959.wav,VTTS_b-3_2943-3024_2959.wav,6140,6583,-443
9659,b-3_6016-6115_6052.wav,VTTS_b-3_6016-6115_6052.wav,13810,11610,2200
9660,b-4_151-300_282.wav,VTTS_b-4_151-300_282.wav,6250,6385,-135
9661,b-3_392-500_429.wav,VTTS_b-3_392-500_429.wav,5380,6351,-971
9662,b-3_2524-2854_2524.wav,VTTS_b-3_2524-2854_2524.wav,3350,3379,-29
9663,b-1_3531-3631_3628.wav,VTTS_b-1_3531-3631_3628.wav,2540,2206,334
9664,b-1_1616-1716_1647.wav,VTTS_b-1_1616-1716_1647.wav,1310,1207,103
9665,b-2_1597-1698_1605.wav,VTTS_b-2_1597-1698_1605.wav,1970,1904,66
9666,b-1_1515-1615_1541.wav,VTTS_b-1_1515-1615_1541.wav,2820,2252,568
9667,b-4_2000-5164_3698.wav,VTTS_b-4_2000-5164_3698.wav,3241,3135,106
9668,b-2_1325-1426_1346.wav,VTTS_b-2_1325-1426_1346.wav,5140,4540,600
9669,b-1_3228-3328_3253.wav,VTTS_b-1_3228-3328_3253.wav,5410,5817,-407
9670,b-3_6601-6700_6627.wav,VTTS_b-3_6601-6700_6627.wav,4980,4365,615
9671,b-3_2000-2088_2080.wav,VTTS_b-3_2000-2088_2080.wav,8180,7465,715
9672,b-4_2000-5164_4825.wav,VTTS_b-4_2000-5164_4825.wav,6768,6142,626
9673,b-4_2000-5164_4937.wav,VTTS_b-4_2000-5164_4937.wav,8319,10379,-2060
9674,b-3_3364-3453_3437.wav,VTTS_b-3_3364-3453_3437.wav,5580,4772,808
9675,b-3_5428-5533_5455.wav,VTTS_b-3_5428-5533_5455.wav,4110,8162,-4052
9676,b-2_2209-2310_2244.wav,VTTS_b-2_2209-2310_2244.wav,2560,2612,-52
9677,b-1_1717-1817_1808.wav,VTTS_b-1_1717-1817_1808.wav,2160,1393,767
9678,b-1_2826-2926_2862.wav,VTTS_b-1_2826-2926_2862.wav,1990,1858,132
9679,b-3_3803-3888_3867.wav,VTTS_b-3_3803-3888_3867.wav,2070,2113,-43
9680,b-1_2927-3025_2993.wav,VTTS_b-1_2927-3025_2993.wav,1520,1672,-152
9681,b-2_2107-2193_2154.wav,VTTS_b-2_2107-2193_2154.wav,1650,1533,117
9682,b-4_2000-5164_4524.wav,VTTS_b-4_2000-5164_4524.wav,3888,11610,-7722
9683,b-2_2040-2072_2060.wav,VTTS_b-2_2040-2072_2060.wav,1650,1858,-208
9684,b-3_6401-6500_6450.wav,VTTS_b-3_6401-6500_6450.wav,4030,3704,326
9685,b-1_1616-1716_1701.wav,VTTS_b-1_1616-1716_1701.wav,3190,2868,322
9686,b-3_4607-5008_4608.wav,VTTS_b-3_4607-5008_4608.wav,4190,3982,208
9687,b-3_2524-2854_2581.wav,VTTS_b-3_2524-2854_2581.wav,11010,11610,-600
9688,b-2_1597-1698_1643.wav,VTTS_b-2_1597-1698_1643.wav,2050,2009,41
9689,b-3_6900-7016_6981.wav,VTTS_b-3_6900-7016_6981.wav,6780,5631,1149
9690,b-1_579-649_629.wav,VTTS_b-1_579-649_629.wav,3350,3042,308
9691,b-4_151-300_239.wav,VTTS_b-4_151-300_239.wav,4290,3924,366
9692,b-4_2000-5164_3218.wav,VTTS_b-4_2000-5164_3218.wav,5368,4667,701
9693,b-3_3538-3627_3618.wav,VTTS_b-3_3538-3627_3618.wav,3750,3843,-93
9694,b-1_794-1009_930.wav,VTTS_b-1_794-1009_930.wav,2900,2508,392
9695,b-4_2000-5164_4650.wav,VTTS_b-4_2000-5164_4650.wav,8990,8963,27
9696,b-2_2073-2106_2086.wav,VTTS_b-2_2073-2106_2086.wav,1350,1591,-241
9697,b-2_815-916_863.wav,VTTS_b-2_815-916_863.wav,1770,1625,145
9698,b-3_980-1077_1042.wav,VTTS_b-3_980-1077_1042.wav,3570,3390,180
9699,b-4_2000-5164_4902.wav,VTTS_b-4_2000-5164_4902.wav,2524,3123,-599
9700,b-4_1814-1900_1872.wav,VTTS_b-4_1814-1900_1872.wav,4200,4272,-72
9701,b-2_611-712_714.wav,VTTS_b-2_611-712_714.wav,2400,1927,473
9702,b-3_5853-5956_5933.wav,VTTS_b-3_5853-5956_5933.wav,2670,2728,-58
9703,b-4_1506-1600_1544.wav,VTTS_b-4_1506-1600_1544.wav,8110,6200,1910
9704,b-3_1764-1861_1785.wav,VTTS_b-3_1764-1861_1785.wav,2680,3111,-431
9705,b-3_3803-3888_3833.wav,VTTS_b-3_3803-3888_3833.wav,3630,3274,356
9706,b-4_2000-5164_4116.wav,VTTS_b-4_2000-5164_4116.wav,7089,7221,-132
9707,b-2_1427-1562_1539.wav,VTTS_b-2_1427-1562_1539.wav,7760,8464,-704
9708,b-2_2107-2193_2134.wav,VTTS_b-2_2107-2193_2134.wav,1280,1196,84
9709,b-3_1-97_30.wav,VTTS_b-3_1-97_30.wav,3710,3971,-261
9710,b-1_3531-3631_3541.wav,VTTS_b-1_3531-3631_3541.wav,2400,2276,124
9711,b-3_1079-1320_1228.wav,VTTS_b-3_1079-1320_1228.wav,3600,3483,117
9712,b-2_407-508_490.wav,VTTS_b-2_407-508_490.wav,1770,1869,-99
9713,b-2_2311-2412_2342.wav,VTTS_b-2_2311-2412_2342.wav,1330,1428,-98
9714,b-4_2000-5164_3980.wav,VTTS_b-4_2000-5164_3980.wav,6640,6978,-338
9715,b-3_5009-5427_5336.wav,VTTS_b-3_5009-5427_5336.wav,7230,7709,-479
9716,b-3_6401-6500_6470.wav,VTTS_b-3_6401-6500_6470.wav,6460,6467,-7
9717,b-1_2321-2421_2346.wav,VTTS_b-1_2321-2421_2346.wav,9400,10170,-770
9718,b-2_1-100_70.wav,VTTS_b-2_1-100_70.wav,3350,6060,-2710
9719,b-3_1764-1861_1806.wav,VTTS_b-3_1764-1861_1806.wav,3280,3228,52
9720,b-3_196-293_222.wav,VTTS_b-3_196-293_222.wav,4960,5433,-473
9721,b-2_203-304_262.wav,VTTS_b-2_203-304_262.wav,3910,3796,114
9722,b-1_1111-1211_1155.wav,VTTS_b-1_1111-1211_1155.wav,1620,1544,76
9723,b-3_3364-3453_3389.wav,VTTS_b-3_3364-3453_3389.wav,5380,4888,492
9724,b-1_1515-1615_1526.wav,VTTS_b-1_1515-1615_1526.wav,1890,1625,265
9725,b-1_1515-1615_1543.wav,VTTS_b-1_1515-1615_1543.wav,3840,3564,276
9726,b-4_2000-5164_3498.wav,VTTS_b-4_2000-5164_3498.wav,1088,1033,55
9727,b-4_1221-1300_1232.wav,VTTS_b-4_1221-1300_1232.wav,3690,3286,404
9728,b-1_3430-3530_3430.wav,VTTS_b-1_3430-3530_3430.wav,3950,3669,281
9729,b-3_4315-4424_4381.wav,VTTS_b-3_4315-4424_4381.wav,5070,4714,356
9730,b-4_401-500_446.wav,VTTS_b-4_401-500_446.wav,2850,2891,-41
9731,b-4_2000-5164_4403.wav,VTTS_b-4_2000-5164_4403.wav,4324,4540,-216
9732,b-1_4286-4321_4318.wav,VTTS_b-1_4286-4321_4318.wav,5570,6072,-502
9733,b-1_4214-4285_4273.wav,VTTS_b-1_4214-4285_4273.wav,2760,3495,-735
9734,b-4_2000-5164_2139.wav,VTTS_b-4_2000-5164_2139.wav,4455,6687,-2232
9735,b-2_1019-1120_1113.wav,VTTS_b-2_1019-1120_1113.wav,1830,1509,321
9736,b-3_5533-5638_5583.wav,VTTS_b-3_5533-5638_5583.wav,8940,7941,999
9737,b-4_2000-5164_2599.wav,VTTS_b-4_2000-5164_2599.wav,3980,4156,-176
9738,b-2_2209-2310_2295.wav,VTTS_b-2_2209-2310_2295.wav,1660,1382,278
9739,b-4_2000-5164_2505.wav,VTTS_b-4_2000-5164_2505.wav,4305,4214,91
9740,b-1_3329-3429_3333.wav,VTTS_b-1_3329-3429_3333.wav,1200,1312,-112
9741,b-1_1010-1110_1052.wav,VTTS_b-1_1010-1110_1052.wav,4060,3553,507
9742,b-3_2434-2523_2513.wav,VTTS_b-3_2434-2523_2513.wav,5400,5642,-242
9743,b-2_1121-1222_1179.wav,VTTS_b-2_1121-1222_1179.wav,1480,1231,249
9744,b-3_2943-3024_3008.wav,VTTS_b-3_2943-3024_3008.wav,4960,4656,304
9745,b-3_6801-6900_6852.wav,VTTS_b-3_6801-6900_6852.wav,1430,1277,153
9746,b-4_2000-5164_4202.wav,VTTS_b-4_2000-5164_4202.wav,2209,2101,108
9747,b-3_1666-1763_1684.wav,VTTS_b-3_1666-1763_1684.wav,5900,4981,919
9748,b-3_2524-2854_2566.wav,VTTS_b-3_2524-2854_2566.wav,7570,6954,616
9749,b-4_2000-5164_2000.wav,VTTS_b-4_2000-5164_2000.wav,8134,9671,-1537
9750,b-3_2089-2176_2151.wav,VTTS_b-3_2089-2176_2151.wav,5140,5526,-386
9751,b-2_2107-2193_2166.wav,VTTS_b-2_2107-2193_2166.wav,1110,1091,19
9752,b-4_2000-5164_3887.wav,VTTS_b-4_2000-5164_3887.wav,4277,4122,155
9753,b-2_1699-1800_1802.wav,VTTS_b-2_1699-1800_1802.wav,1920,2125,-205
9754,b-3_501-930_520.wav,VTTS_b-3_501-930_520.wav,1670,1521,149
9755,b-3_1079-1320_1184.wav,VTTS_b-3_1079-1320_1184.wav,4360,3274,1086
9756,b-3_1862-1959_1929.wav,VTTS_b-3_1862-1959_1929.wav,5040,4342,698
9757,b-4_1707-1813_1793.wav,VTTS_b-4_1707-1813_1793.wav,4580,4574,6
9758,b-3_6701-6800_6798.wav,VTTS_b-3_6701-6800_6798.wav,5320,5027,293
9759,b-4_2000-5164_4592.wav,VTTS_b-4_2000-5164_4592.wav,11651,11610,41
9760,b-1_1515-1615_1612.wav,VTTS_b-1_1515-1615_1612.wav,3300,3123,177
9761,b-4_2000-5164_4112.wav,VTTS_b-4_2000-5164_4112.wav,3821,3448,373
9762,b-3_4315-4424_4351.wav,VTTS_b-3_4315-4424_4351.wav,6350,5352,998
9763,b-3_1079-1320_1097.wav,VTTS_b-3_1079-1320_1097.wav,6230,5724,506
9764,b-3_1862-1959_1888.wav,VTTS_b-3_1862-1959_1888.wav,4260,4400,-140
9765,b-4_2000-5164_3301.wav,VTTS_b-4_2000-5164_3301.wav,3836,3773,63
9766,b-3_1079-1320_1150.wav,VTTS_b-3_1079-1320_1150.wav,3230,2833,397
9767,b-3_3538-3627_3619.wav,VTTS_b-3_3538-3627_3619.wav,2940,3053,-113
9768,b-3_1079-1320_1261.wav,VTTS_b-3_1079-1320_1261.wav,10120,9520,600
9769,b-4_2000-5164_3580.wav,VTTS_b-4_2000-5164_3580.wav,3768,4203,-435
9770,b-1_2119-2219_2136.wav,VTTS_b-1_2119-2219_2136.wav,3290,3460,-170
9771,b-4_2000-5164_2990.wav,VTTS_b-4_2000-5164_2990.wav,6798,7999,-1201
9772,b-1_2018-2118_2060.wav,VTTS_b-1_2018-2118_2060.wav,3890,4818,-928
9773,b-1_1515-1615_1606.wav,VTTS_b-1_1515-1615_1606.wav,2130,1974,156
9774,b-4_1-52_31.wav,VTTS_b-4_1-52_31.wav,9500,8638,862
9775,b-3_1764-1861_1838.wav,VTTS_b-3_1764-1861_1838.wav,4090,4969,-879
9776,b-4_501-1014_610.wav,VTTS_b-4_501-1014_610.wav,4870,4226,644
9777,b-4_2000-5164_2934.wav,VTTS_b-4_2000-5164_2934.wav,3580,3413,167
9778,b-3_6900-7016_6941.wav,VTTS_b-3_6900-7016_6941.wav,4600,4911,-311
9779,b-1_4214-4285_4228.wav,VTTS_b-1_4214-4285_4228.wav,1240,1219,21
9780,b-3_3025-3111_3097.wav,VTTS_b-3_3025-3111_3097.wav,4550,4249,301
9781,b-4_1506-1600_1579.wav,VTTS_b-4_1506-1600_1579.wav,9290,10124,-834
9782,b-3_4607-5008_4880.wav,VTTS_b-3_4607-5008_4880.wav,2490,2473,17
9783,b-3_6016-6115_6110.wav,VTTS_b-3_6016-6115_6110.wav,2700,3309,-609
9784,b-4_501-1014_705.wav,VTTS_b-4_501-1014_705.wav,6700,6235,465
9785,b-3_4607-5008_4925.wav,VTTS_b-3_4607-5008_4925.wav,7130,6072,1058
9786,b-4_2000-5164_2954.wav,VTTS_b-4_2000-5164_2954.wav,10896,10054,842
9787,b-1_3127-3227_3168.wav,VTTS_b-1_3127-3227_3168.wav,1620,1602,18
9788,b-3_4498-4605_4510.wav,VTTS_b-3_4498-4605_4510.wav,3510,4563,-1053
9789,b-3_5009-5427_5331.wav,VTTS_b-3_5009-5427_5331.wav,6290,6107,183
9790,b-4_1601-1706_1659.wav,VTTS_b-4_1601-1706_1659.wav,5570,5259,311
9791,b-4_2000-5164_4651.wav,VTTS_b-4_2000-5164_4651.wav,3652,3529,123
9792,b-2_713-814_787.wav,VTTS_b-2_713-814_787.wav,3020,2914,106
9793,b-4_2000-5164_3804.wav,VTTS_b-4_2000-5164_3804.wav,6065,6583,-518
9794,b-3_6016-6115_6108.wav,VTTS_b-3_6016-6115_6108.wav,1980,1846,134
9795,b-3_5639-5744_5704.wav,VTTS_b-3_5639-5744_5704.wav,5010,5364,-354
9796,b-4_2000-5164_2143.wav,VTTS_b-4_2000-5164_2143.wav,6540,6200,340
9797,b-4_2000-5164_4263.wav,VTTS_b-4_2000-5164_4263.wav,1997,2601,-604
9798,b-2_1903-2038_2007.wav,VTTS_b-2_1903-2038_2007.wav,2600,2531,69
9799,b-4_1814-1900_1858.wav,VTTS_b-4_1814-1900_1858.wav,8450,7895,555
9800,b-3_6301-6400_6328.wav,VTTS_b-3_6301-6400_6328.wav,990,917,73
9801,b-4_2000-5164_2454.wav,VTTS_b-4_2000-5164_2454.wav,3420,3320,100
9802,b-4_2000-5164_4901.wav,VTTS_b-4_2000-5164_4901.wav,7104,7616,-512
9803,b-3_931-979_950.wav,VTTS_b-3_931-979_950.wav,8030,7767,263
9804,b-2_1427-1562_1476.wav,VTTS_b-2_1427-1562_1476.wav,2380,2113,267
9805,b-3_196-293_217.wav,VTTS_b-3_196-293_217.wav,7290,7024,266
9806,b-3_501-930_851.wav,VTTS_b-3_501-930_851.wav,6100,5968,132
9807,b-4_501-1014_506.wav,VTTS_b-4_501-1014_506.wav,2190,2055,135
9808,b-2_1-100_61.wav,VTTS_b-2_1-100_61.wav,1940,2090,-150
9809,b-2_1-100_46.wav,VTTS_b-2_1-100_46.wav,2600,2891,-291
9810,b-1_1717-1817_1721.wav,VTTS_b-1_1717-1817_1721.wav,1450,1265,185
9811,b-3_501-930_639.wav,VTTS_b-3_501-930_639.wav,6020,6780,-760
9812,b-1_794-1009_852.wav,VTTS_b-1_794-1009_852.wav,2910,2763,147
9813,b-4_2000-5164_4447.wav,VTTS_b-4_2000-5164_4447.wav,2679,2403,276
9814,b-4_1014-1100_1088.wav,VTTS_b-4_1014-1100_1088.wav,6130,6049,81
9815,b-3_2267-2349_2348.wav,VTTS_b-3_2267-2349_2348.wav,8760,11610,-2850
9816,b-1_1515-1615_1547.wav,VTTS_b-1_1515-1615_1547.wav,5230,5306,-76
9817,b-1_1111-1211_1203.wav,VTTS_b-1_1111-1211_1203.wav,3620,3320,300
9818,b-1_2018-2118_2032.wav,VTTS_b-1_2018-2118_2032.wav,1760,1997,-237
9819,b-3_1079-1320_1161.wav,VTTS_b-3_1079-1320_1161.wav,4310,4412,-102
9820,b-3_980-1077_985.wav,VTTS_b-3_980-1077_985.wav,4830,6734,-1904
9821,b-1_1414-1514_1449.wav,VTTS_b-1_1414-1514_1449.wav,3890,4122,-232
9822,b-4_2000-5164_3355.wav,VTTS_b-4_2000-5164_3355.wav,2800,3146,-346
9823,b-1_1-73_7.wav,VTTS_b-1_1-73_7.wav,1370,1312,58
9824,b-4_2000-5164_3156.wav,VTTS_b-4_2000-5164_3156.wav,3708,3994,-286
9825,b-3_5639-5744_5728.wav,VTTS_b-3_5639-5744_5728.wav,1550,1567,-17
9826,b-4_151-300_250.wav,VTTS_b-4_151-300_250.wav,5230,5503,-273
9827,b-3_6116-6215_6137.wav,VTTS_b-3_6116-6215_6137.wav,2320,2519,-199
9828,b-2_305-406_372.wav,VTTS_b-2_305-406_372.wav,2070,1846,224
9829,b-1_794-1009_954.wav,VTTS_b-1_794-1009_954.wav,3000,3820,-820
9830,b-2_2209-2310_2255.wav,VTTS_b-2_2209-2310_2255.wav,1450,1300,150
9831,b-1_3531-3631_3608.wav,VTTS_b-1_3531-3631_3608.wav,1990,1776,214
9832,b-1_686-793_711.wav,VTTS_b-1_686-793_711.wav,4750,4540,210
9833,b-3_2524-2854_2754.wav,VTTS_b-3_2524-2854_2754.wav,8050,8626,-576
9834,b-2_2311-2412_2368.wav,VTTS_b-2_2311-2412_2368.wav,3350,3053,297
9835,b-1_1919-2017_1923.wav,VTTS_b-1_1919-2017_1923.wav,1380,1602,-222
9836,b-3_4315-4424_4337.wav,VTTS_b-3_4315-4424_4337.wav,9580,9056,524
9837,b-4_501-1014_770.wav,VTTS_b-4_501-1014_770.wav,6220,6281,-61
9838,b-3_2524-2854_2534.wav,VTTS_b-3_2524-2854_2534.wav,8090,9857,-1767
9839,b-3_2943-3024_3023.wav,VTTS_b-3_2943-3024_3023.wav,2000,2067,-67
9840,b-1_2523-2623_2527.wav,VTTS_b-1_2523-2623_2527.wav,1850,2183,-333
9841,b-4_2000-5164_4081.wav,VTTS_b-4_2000-5164_4081.wav,6197,5526,671
9842,b-3_3538-3627_3543.wav,VTTS_b-3_3538-3627_3543.wav,6130,6107,23
9843,b-3_3364-3453_3383.wav,VTTS_b-3_3364-3453_3383.wav,8130,11610,-3480
9844,b-4_1401-1505_1406.wav,VTTS_b-4_1401-1505_1406.wav,4630,5271,-641
9845,b-4_1814-1900_1843.wav,VTTS_b-4_1814-1900_1843.wav,3730,3680,50
9846,b-4_1014-1100_1080.wav,VTTS_b-4_1014-1100_1080.wav,5240,5364,-124
9847,b-2_101-202_159.wav,VTTS_b-2_101-202_159.wav,2490,2461,29
9848,b-3_501-930_586.wav,VTTS_b-3_501-930_586.wav,4210,4005,205
9849,b-1_4214-4285_4218.wav,VTTS_b-1_4214-4285_4218.wav,1260,1184,76
9850,b-2_509-610_545.wav,VTTS_b-2_509-610_545.wav,4220,3855,365
9851,b-1_4106-4141_4111.wav,VTTS_b-1_4106-4141_4111.wav,3240,3495,-255
9852,b-4_1814-1900_1823.wav,VTTS_b-4_1814-1900_1823.wav,3930,3541,389
9853,b-3_4607-5008_4769.wav,VTTS_b-3_4607-5008_4769.wav,5380,5248,132
9854,b-1_74-174_99.wav,VTTS_b-1_74-174_99.wav,2540,3332,-792
9855,b-4_2000-5164_3289.wav,VTTS_b-4_2000-5164_3289.wav,6338,11610,-5272
9856,b-4_2000-5164_2336.wav,VTTS_b-4_2000-5164_2336.wav,2895,2833,62
9857,b-1_4214-4285_4259.wav,VTTS_b-1_4214-4285_4259.wav,1740,1567,173
9858,b-1_1212-1312_1287.wav,VTTS_b-1_1212-1312_1287.wav,2650,3088,-438
9859,b-3_5745-5852_5781.wav,VTTS_b-3_5745-5852_5781.wav,4030,3587,443
9860,b-2_1597-1698_1602.wav,VTTS_b-2_1597-1698_1602.wav,4340,4063,277
9861,b-3_6801-6900_6854.wav,VTTS_b-3_6801-6900_6854.wav,1250,1149,101
9862,b-4_2000-5164_3759.wav,VTTS_b-4_2000-5164_3759.wav,6380,8835,-2455
9863,b-1_4034-4069_4047.wav,VTTS_b-1_4034-4069_4047.wav,2170,2531,-361
9864,b-3_294-391_325.wav,VTTS_b-3_294-391_325.wav,2620,2635,-15
9865,b-3_4607-5008_4614.wav,VTTS_b-3_4607-5008_4614.wav,5520,5433,87
9866,b-4_1506-1600_1557.wav,VTTS_b-4_1506-1600_1557.wav,7880,7814,66
9867,b-3_5853-5956_5884.wav,VTTS_b-3_5853-5956_5884.wav,6140,5956,184
9868,b-4_1601-1706_1603.wav,VTTS_b-4_1601-1706_1603.wav,3710,3924,-214
9869,b-1_1818-1918_1878.wav,VTTS_b-1_1818-1918_1878.wav,2450,2136,314
9870,b-3_4607-5008_4625.wav,VTTS_b-3_4607-5008_4625.wav,2980,3193,-213
9871,b-3_2177-2266_2218.wav,VTTS_b-3_2177-2266_2218.wav,6300,6002,298
9872,b-2_1325-1426_1369.wav,VTTS_b-2_1325-1426_1369.wav,1450,1358,92
9873,b-3_1321-1568_1420.wav,VTTS_b-3_1321-1568_1420.wav,8360,8464,-104
9874,b-3_2177-2266_2254.wav,VTTS_b-3_2177-2266_2254.wav,3470,3576,-106
9875,b-1_3733-3833_3782.wav,VTTS_b-1_3733-3833_3782.wav,1320,1277,43
9876,b-3_6900-7016_6956.wav,VTTS_b-3_6900-7016_6956.wav,4620,4830,-210
9877,b-3_1-97_38.wav,VTTS_b-3_1-97_38.wav,4030,3947,83
9878,b-4_2000-5164_4187.wav,VTTS_b-4_2000-5164_4187.wav,2843,2566,277
9879,b-2_1801-1902_1892.wav,VTTS_b-2_1801-1902_1892.wav,1930,1892,38
9880,b-2_2311-2412_2376.wav,VTTS_b-2_2311-2412_2376.wav,1270,1289,-19
9881,b-2_1801-1902_1884.wav,VTTS_b-2_1801-1902_1884.wav,2860,2171,689
9882,b-3_5639-5744_5713.wav,VTTS_b-3_5639-5744_5713.wav,4380,4528,-148
9883,b-2_1699-1800_1801.wav,VTTS_b-2_1699-1800_1801.wav,1790,1718,72
9884,b-2_1427-1562_1545.wav,VTTS_b-2_1427-1562_1545.wav,2090,2821,-731
9885,b-4_2000-5164_4045.wav,VTTS_b-4_2000-5164_4045.wav,2749,2740,9
9886,b-4_1707-1813_1771.wav,VTTS_b-4_1707-1813_1771.wav,3990,3866,124
9887,b-3_392-500_444.wav,VTTS_b-3_392-500_444.wav,5560,5433,127
9888,b-1_3632-3732_3663.wav,VTTS_b-1_3632-3732_3663.wav,1990,2159,-169
9889,b-4_2000-5164_4262.wav,VTTS_b-4_2000-5164_4262.wav,2339,1695,644
9890,b-1_794-1009_825.wav,VTTS_b-1_794-1009_825.wav,3030,2334,696
9891,b-4_2000-5164_2078.wav,VTTS_b-4_2000-5164_2078.wav,2370,2659,-289
9892,b-1_4142-4177_4154.wav,VTTS_b-1_4142-4177_4154.wav,1690,2241,-551
9893,b-1_794-1009_876.wav,VTTS_b-1_794-1009_876.wav,4230,5654,-1424
9894,b-1_1717-1817_1803.wav,VTTS_b-1_1717-1817_1803.wav,2540,2450,90
9895,b-1_2927-3025_3008.wav,VTTS_b-1_2927-3025_3008.wav,4220,4029,191
9896,b-3_2943-3024_2943.wav,VTTS_b-3_2943-3024_2943.wav,2580,2694,-114
9897,b-3_1568-1665_1612.wav,VTTS_b-3_1568-1665_1612.wav,4410,3947,463
9898,b-2_1121-1222_1131.wav,VTTS_b-2_1121-1222_1131.wav,2530,2101,429
9899,b-3_6401-6500_6452.wav,VTTS_b-3_6401-6500_6452.wav,5270,5445,-175
9900,b-3_3198-3278_3229.wav,VTTS_b-3_3198-3278_3229.wav,4020,4052,-32
9901,b-1_2018-2118_2072.wav,VTTS_b-1_2018-2118_2072.wav,2560,2171,389
9902,b-2_203-304_273.wav,VTTS_b-2_203-304_273.wav,2010,1974,36
9903,b-3_1862-1959_1913.wav,VTTS_b-3_1862-1959_1913.wav,4970,5503,-533
9904,b-3_501-930_911.wav,VTTS_b-3_501-930_911.wav,4060,3692,368
9905,b-3_4607-5008_4783.wav,VTTS_b-3_4607-5008_4783.wav,4060,4470,-410
9906,b-4_2000-5164_2541.wav,VTTS_b-4_2000-5164_2541.wav,7160,7221,-61
9907,b-4_2000-5164_3589.wav,VTTS_b-4_2000-5164_3589.wav,7472,7070,402
9908,b-2_713-814_755.wav,VTTS_b-2_713-814_755.wav,2480,2659,-179
9909,b-3_4425-4497_4482.wav,VTTS_b-3_4425-4497_4482.wav,7670,6548,1122
9910,b-3_6301-6400_6399.wav,VTTS_b-3_6301-6400_6399.wav,11700,10867,833
9911,b-1_478-578_524.wav,VTTS_b-1_478-578_524.wav,3790,4760,-970
9912,b-3_3279-3363_3347.wav,VTTS_b-3_3279-3363_3347.wav,6700,6861,-161
9913,b-3_4001-4103_4106.wav,VTTS_b-3_4001-4103_4106.wav,7790,8615,-825
9914,b-3_4607-5008_4836.wav,VTTS_b-3_4607-5008_4836.wav,1070,1115,-45
9915,b-3_3454-3537_3490.wav,VTTS_b-3_3454-3537_3490.wav,4610,4493,117
9916,b-3_4607-5008_4928.wav,VTTS_b-3_4607-5008_4928.wav,3310,3448,-138
9917,b-3_1321-1568_1556.wav,VTTS_b-3_1321-1568_1556.wav,2210,2101,109
9918,b-2_2209-2310_2302.wav,VTTS_b-2_2209-2310_2302.wav,1730,2020,-290
9919,b-1_3632-3732_3672.wav,VTTS_b-1_3632-3732_3672.wav,1590,1173,417
9920,b-3_6900-7016_6945.wav,VTTS_b-3_6900-7016_6945.wav,2810,2821,-11
9921,b-2_815-916_912.wav,VTTS_b-2_815-916_912.wav,4610,5387,-777
9922,b-3_3889-4000_3922.wav,VTTS_b-3_3889-4000_3922.wav,4830,4540,290
9923,b-3_3715-3802_3779.wav,VTTS_b-3_3715-3802_3779.wav,2570,2624,-54
9924,b-3_2524-2854_2528.wav,VTTS_b-3_2524-2854_2528.wav,6440,6037,403
9925,b-3_2350-2433_2361.wav,VTTS_b-3_2350-2433_2361.wav,4670,6281,-1611
9926,b-4_301-400_320.wav,VTTS_b-4_301-400_320.wav,6210,6316,-106
9927,b-1_1212-1312_1227.wav,VTTS_b-1_1212-1312_1227.wav,2680,2554,126
9928,b-4_2000-5164_3488.wav,VTTS_b-4_2000-5164_3488.wav,9334,10670,-1336
9929,b-3_6217-6274_6250.wav,VTTS_b-3_6217-6274_6250.wav,4200,4365,-165
9930,b-2_1427-1562_1438.wav,VTTS_b-2_1427-1562_1438.wav,2660,3088,-428
9931,b-4_2000-5164_3059.wav,VTTS_b-4_2000-5164_3059.wav,4833,5700,-867
9932,b-2_1699-1800_1745.wav,VTTS_b-2_1699-1800_1745.wav,4310,4075,235
9933,b-1_478-578_539.wav,VTTS_b-1_478-578_539.wav,2390,2310,80
9934,b-4_2000-5164_3244.wav,VTTS_b-4_2000-5164_3244.wav,5125,5004,121
9935,b-4_1814-1900_1866.wav,VTTS_b-4_1814-1900_1866.wav,7650,9439,-1789
9936,b-3_6701-6800_6726.wav,VTTS_b-3_6701-6800_6726.wav,3320,3506,-186
9937,b-4_53-150_124.wav,VTTS_b-4_53-150_124.wav,8660,8499,161
9938,b-1_794-1009_803.wav,VTTS_b-1_794-1009_803.wav,5770,7012,-1242
9939,b-1_3026-3126_3081.wav,VTTS_b-1_3026-3126_3081.wav,3090,2566,524
9940,b-3_2524-2854_2703.wav,VTTS_b-3_2524-2854_2703.wav,3170,3123,47
9941,b-3_5853-5956_5869.wav,VTTS_b-3_5853-5956_5869.wav,3990,3866,124
9942,b-1_650-685_671.wav,VTTS_b-1_650-685_671.wav,1600,1869,-269
9943,b-4_2000-5164_4567.wav,VTTS_b-4_2000-5164_4567.wav,2992,3297,-305
9944,b-4_2000-5164_3606.wav,VTTS_b-4_2000-5164_3606.wav,2426,2241,185
9945,b-4_151-300_238.wav,VTTS_b-4_151-300_238.wav,3260,2984,276
9946,b-3_4607-5008_4726.wav,VTTS_b-3_4607-5008_4726.wav,5900,7221,-1321
9947,b-3_5428-5533_5432.wav,VTTS_b-3_5428-5533_5432.wav,6780,7303,-523
9948,b-1_4070-4105_4079.wav,VTTS_b-1_4070-4105_4079.wav,4430,5387,-957
9949,b-1_3632-3732_3677.wav,VTTS_b-1_3632-3732_3677.wav,1850,1823,27
9950,b-1_1717-1817_1777.wav,VTTS_b-1_1717-1817_1777.wav,1960,1846,114
9951,b-1_794-1009_895.wav,VTTS_b-1_794-1009_895.wav,4640,4702,-62
9952,b-2_1121-1222_1207.wav,VTTS_b-2_1121-1222_1207.wav,7300,10519,-3219
9953,b-3_5428-5533_5510.wav,VTTS_b-3_5428-5533_5510.wav,6490,5898,592
9954,b-3_5853-5956_5885.wav,VTTS_b-3_5853-5956_5885.wav,4540,4412,128
9955,b-2_509-610_537.wav,VTTS_b-2_509-610_537.wav,2920,2485,435
9956,b-4_501-1014_979.wav,VTTS_b-4_501-1014_979.wav,7040,7256,-216
9957,b-3_6701-6800_6742.wav,VTTS_b-3_6701-6800_6742.wav,3690,3634,56
9958,b-1_276-376_290.wav,VTTS_b-1_276-376_290.wav,1520,1370,150
9959,b-3_501-930_727.wav,VTTS_b-3_501-930_727.wav,2860,3181,-321
9960,b-3_4425-4497_4448.wav,VTTS_b-3_4425-4497_4448.wav,5540,5828,-288
9961,b-1_579-649_648.wav,VTTS_b-1_579-649_648.wav,4020,4052,-32
9962,b-4_2000-5164_4631.wav,VTTS_b-4_2000-5164_4631.wav,4679,5724,-1045
9963,b-1_3632-3732_3676.wav,VTTS_b-1_3632-3732_3676.wav,3250,4412,-1162
9964,b-4_1401-1505_1462.wav,VTTS_b-4_1401-1505_1462.wav,6350,6502,-152
9965,b-2_1-100_73.wav,VTTS_b-2_1-100_73.wav,2670,4540,-1870
9966,b-3_4607-5008_4817.wav,VTTS_b-3_4607-5008_4817.wav,7290,7256,34
9967,b-1_2725-2825_2749.wav,VTTS_b-1_2725-2825_2749.wav,6310,5561,749
9968,b-1_2321-2421_2338.wav,VTTS_b-1_2321-2421_2338.wav,2060,3204,-1144
9969,b-3_6116-6215_6176.wav,VTTS_b-3_6116-6215_6176.wav,4900,5445,-545
9970,b-3_2000-2088_2014.wav,VTTS_b-3_2000-2088_2014.wav,8580,7396,1184
9971,b-2_101-202_106.wav,VTTS_b-2_101-202_106.wav,1480,1416,64
9972,b-4_2000-5164_2493.wav,VTTS_b-4_2000-5164_2493.wav,3590,3553,37
9973,b-2_2194-2208_2196.wav,VTTS_b-2_2194-2208_2196.wav,1060,1045,15
9974,b-4_2000-5164_3993.wav,VTTS_b-4_2000-5164_3993.wav,1615,1219,396
9975,b-3_3628-3714_3706.wav,VTTS_b-3_3628-3714_3706.wav,5090,3982,1108
9976,b-4_2000-5164_3031.wav,VTTS_b-4_2000-5164_3031.wav,4215,6188,-1973
9977,b-4_2000-5164_3521.wav,VTTS_b-4_2000-5164_3521.wav,1094,859,235
9978,b-4_2000-5164_3600.wav,VTTS_b-4_2000-5164_3600.wav,1186,998,188
9979,b-2_2311-2412_2317.wav,VTTS_b-2_2311-2412_2317.wav,1480,1405,75
9980,b-2_1223-1324_1277.wav,VTTS_b-2_1223-1324_1277.wav,3330,3228,102
9981,b-1_4034-4069_4040.wav,VTTS_b-1_4034-4069_4040.wav,3300,4249,-949
9982,b-4_2000-5164_4525.wav,VTTS_b-4_2000-5164_4525.wav,5422,5213,209
9983,b-3_4425-4497_4429.wav,VTTS_b-3_4425-4497_4429.wav,6540,5654,886
9984,b-4_2000-5164_3966.wav,VTTS_b-4_2000-5164_3966.wav,4320,6664,-2344
9985,b-2_2209-2310_2247.wav,VTTS_b-2_2209-2310_2247.wav,5470,5596,-126
9986,b-3_2855-2942_2874.wav,VTTS_b-3_2855-2942_2874.wav,4690,4795,-105
9987,b-2_1427-1562_1434.wav,VTTS_b-2_1427-1562_1434.wav,910,975,-65
9988,b-3_2855-2942_2906.wav,VTTS_b-3_2855-2942_2906.wav,3200,5410,-2210
9989,b-4_2000-5164_4059.wav,VTTS_b-4_2000-5164_4059.wav,5199,5515,-316
9990,b-3_4207-4314_4294.wav,VTTS_b-3_4207-4314_4294.wav,5680,6618,-938
9991,b-4_501-1014_804.wav,VTTS_b-4_501-1014_804.wav,5940,5828,112
9992,b-1_1616-1716_1692.wav,VTTS_b-1_1616-1716_1692.wav,3310,4992,-1682
9993,b-4_1101-1220_1199.wav,VTTS_b-4_1101-1220_1199.wav,11990,11610,380
9994,b-3_2524-2854_2757.wav,VTTS_b-3_2524-2854_2757.wav,7280,7430,-150
9995,b-1_3127-3227_3176.wav,VTTS_b-1_3127-3227_3176.wav,2040,3088,-1048
9996,b-4_2000-5164_4684.wav,VTTS_b-4_2000-5164_4684.wav,5066,4865,201
9997,b-3_2524-2854_2851.wav,VTTS_b-3_2524-2854_2851.wav,1900,1753,147
9998,b-3_4425-4497_4455.wav,VTTS_b-3_4425-4497_4455.wav,4510,4272,238
9999,b-3_4315-4424_4402.wav,VTTS_b-3_4315-4424_4402.wav,4680,4284,396
10000,b-4_1707-1813_1707.wav,VTTS_b-4_1707-1813_1707.wav,4570,4180,390
10001,b-3_3803-3888_3836.wav,VTTS_b-3_3803-3888_3836.wav,6200,6653,-453
10002,b-3_4104-4206_4129.wav,VTTS_b-3_4104-4206_4129.wav,2670,2543,127
10003,b-4_501-1014_660.wav,VTTS_b-4_501-1014_660.wav,6650,6258,392
10004,b-4_2000-5164_3622.wav,VTTS_b-4_2000-5164_3622.wav,4216,3796,420
10005,b-3_3112-3197_3125.wav,VTTS_b-3_3112-3197_3125.wav,5720,5735,-15
10006,b-1_2927-3025_2982.wav,VTTS_b-1_2927-3025_2982.wav,2540,2659,-119
10007,b-3_1321-1568_1371.wav,VTTS_b-3_1321-1568_1371.wav,3360,3762,-402
10008,b-1_2018-2118_2112.wav,VTTS_b-1_2018-2118_2112.wav,2790,2775,15
10009,b-3_6701-6800_6791.wav,VTTS_b-3_6701-6800_6791.wav,5750,5689,61
10010,b-1_478-578_499.wav,VTTS_b-1_478-578_499.wav,3620,3646,-26
10011,b-2_1223-1324_1313.wav,VTTS_b-2_1223-1324_1313.wav,1760,1846,-86
10012,b-2_1-100_85.wav,VTTS_b-2_1-100_85.wav,2350,2125,225
10013,b-3_3025-3111_3076.wav,VTTS_b-3_3025-3111_3076.wav,6700,6513,187
10014,b-1_2220-2320_2293.wav,VTTS_b-1_2220-2320_2293.wav,1970,1440,530
10015,b-1_3228-3328_3294.wav,VTTS_b-1_3228-3328_3294.wav,2860,3146,-286
10016,b-4_151-300_218.wav,VTTS_b-4_151-300_218.wav,6550,6118,432
10017,b-4_1814-1900_1879.wav,VTTS_b-4_1814-1900_1879.wav,2580,2345,235
10018,b-3_6016-6115_6111.wav,VTTS_b-3_6016-6115_6111.wav,7100,6815,285
10019,b-4_2000-5164_2363.wav,VTTS_b-4_2000-5164_2363.wav,5860,8231,-2371
10020,b-3_931-979_953.wav,VTTS_b-3_931-979_953.wav,5650,6095,-445
10021,b-4_2000-5164_4843.wav,VTTS_b-4_2000-5164_4843.wav,5318,4923,395
10022,b-3_4607-5008_4636.wav,VTTS_b-3_4607-5008_4636.wav,2700,2995,-295
10023,b-3_4315-4424_4382.wav,VTTS_b-3_4315-4424_4382.wav,4570,4133,437
10024,b-3_196-293_231.wav,VTTS_b-3_196-293_231.wav,4610,4284,326
10025,b-4_2000-5164_2866.wav,VTTS_b-4_2000-5164_2866.wav,6680,6327,353
10026,b-4_401-500_417.wav,VTTS_b-4_401-500_417.wav,7960,7454,506
10027,b-3_3889-4000_3965.wav,VTTS_b-3_3889-4000_3965.wav,6690,6304,386
10028,b-3_5009-5427_5151.wav,VTTS_b-3_5009-5427_5151.wav,3230,3146,84
10029,b-3_1-97_53.wav,VTTS_b-3_1-97_53.wav,2940,2810,130
10030,b-3_6801-6900_6846.wav,VTTS_b-3_6801-6900_6846.wav,1790,1660,130
10031,b-2_917-1018_1012.wav,VTTS_b-2_917-1018_1012.wav,2570,2229,341
10032,b-1_579-649_592.wav,VTTS_b-1_579-649_592.wav,8590,7477,1113
10033,b-4_2000-5164_3158.wav,VTTS_b-4_2000-5164_3158.wav,3373,3216,157
10034,b-4_2000-5164_4550.wav,VTTS_b-4_2000-5164_4550.wav,7642,8011,-369
10035,b-3_1079-1320_1080.wav,VTTS_b-3_1079-1320_1080.wav,2570,2601,-31
10036,b-4_2000-5164_3221.wav,VTTS_b-4_2000-5164_3221.wav,2242,2218,24
10037,b-3_392-500_468.wav,VTTS_b-3_392-500_468.wav,7440,8313,-873
10038,b-1_3026-3126_3032.wav,VTTS_b-1_3026-3126_3032.wav,1800,1602,198
10039,b-2_407-508_422.wav,VTTS_b-2_407-508_422.wav,2320,3855,-1535
10040,b-3_3364-3453_3452.wav,VTTS_b-3_3364-3453_3452.wav,3010,2833,177
10041,b-1_3834-3934_3837.wav,VTTS_b-1_3834-3934_3837.wav,1750,2009,-259
10042,b-2_917-1018_917.wav,VTTS_b-2_917-1018_917.wav,3280,4226,-946
10043,b-1_4214-4285_4267.wav,VTTS_b-1_4214-4285_4267.wav,1020,906,114
10044,b-3_1862-1959_1889.wav,VTTS_b-3_1862-1959_1889.wav,5530,5631,-101
10045,b-3_5428-5533_5521.wav,VTTS_b-3_5428-5533_5521.wav,6930,7175,-245
10046,b-3_2524-2854_2670.wav,VTTS_b-3_2524-2854_2670.wav,4960,4435,525
10047,b-4_1506-1600_1565.wav,VTTS_b-4_1506-1600_1565.wav,4370,3738,632
10048,b-3_5745-5852_5753.wav,VTTS_b-3_5745-5852_5753.wav,3640,3239,401
10049,b-3_6501-6600_6525.wav,VTTS_b-3_6501-6600_6525.wav,18030,11610,6420
10050,b-2_1019-1120_1069.wav,VTTS_b-2_1019-1120_1069.wav,2840,2125,715
10051,b-3_4607-5008_4921.wav,VTTS_b-3_4607-5008_4921.wav,8320,8742,-422
10052,b-1_478-578_556.wav,VTTS_b-1_478-578_556.wav,1310,1800,-490
10053,b-4_501-1014_654.wav,VTTS_b-4_501-1014_654.wav,4520,4319,201
10054,b-1_1717-1817_1811.wav,VTTS_b-1_1717-1817_1811.wav,3390,3158,232
10055,b-3_4498-4605_4575.wav,VTTS_b-3_4498-4605_4575.wav,2830,3088,-258
10056,b-3_6501-6600_6563.wav,VTTS_b-3_6501-6600_6563.wav,6050,5526,524
10057,b-3_294-391_382.wav,VTTS_b-3_294-391_382.wav,13070,11610,1460
10058,b-1_4106-4141_4123.wav,VTTS_b-1_4106-4141_4123.wav,2580,3460,-880
10059,b-1_794-1009_993.wav,VTTS_b-1_794-1009_993.wav,5880,9009,-3129
10060,b-3_2434-2523_2437.wav,VTTS_b-3_2434-2523_2437.wav,6720,5550,1170
10061,b-1_1-73_4.wav,VTTS_b-1_1-73_4.wav,3250,3204,46
10062,b-3_4425-4497_4430.wav,VTTS_b-3_4425-4497_4430.wav,6490,6536,-46
10063,b-3_294-391_318.wav,VTTS_b-3_294-391_318.wav,3590,3611,-21
10064,b-4_2000-5164_3858.wav,VTTS_b-4_2000-5164_3858.wav,5758,7256,-1498
10065,b-2_1699-1800_1775.wav,VTTS_b-2_1699-1800_1775.wav,860,592,268
10066,b-1_794-1009_979.wav,VTTS_b-1_794-1009_979.wav,2260,2101,159
10067,b-1_2624-2724_2683.wav,VTTS_b-1_2624-2724_2683.wav,4630,6223,-1593
10068,b-1_2119-2219_2140.wav,VTTS_b-1_2119-2219_2140.wav,2440,2485,-45
10069,b-4_2000-5164_4912.wav,VTTS_b-4_2000-5164_4912.wav,2182,2067,115
10070,b-3_5428-5533_5534.wav,VTTS_b-3_5428-5533_5534.wav,6080,5921,159
10071,b-3_2943-3024_3014.wav,VTTS_b-3_2943-3024_3014.wav,3620,3738,-118
10072,b-1_276-376_340.wav,VTTS_b-1_276-376_340.wav,1630,1985,-355
10073,b-1_3834-3934_3893.wav,VTTS_b-1_3834-3934_3893.wav,1350,1242,108
10074,b-3_2855-2942_2937.wav,VTTS_b-3_2855-2942_2937.wav,6080,6385,-305
10075,b-3_6016-6115_6029.wav,VTTS_b-3_6016-6115_6029.wav,6490,5654,836
10076,b-2_1699-1800_1738.wav,VTTS_b-2_1699-1800_1738.wav,3770,3390,380
10077,b-4_2000-5164_4879.wav,VTTS_b-4_2000-5164_4879.wav,2066,2148,-82
10078,b-3_4607-5008_4702.wav,VTTS_b-3_4607-5008_4702.wav,3440,3587,-147
10079,b-3_2524-2854_2732.wav,VTTS_b-3_2524-2854_2732.wav,7010,7001,9
10080,b-4_2000-5164_3104.wav,VTTS_b-4_2000-5164_3104.wav,5784,6606,-822
10081,b-3_6501-6600_6583.wav,VTTS_b-3_6501-6600_6583.wav,2270,1753,517
10082,b-3_4104-4206_4166.wav,VTTS_b-3_4104-4206_4166.wav,2030,1974,56
10083,b-1_478-578_500.wav,VTTS_b-1_478-578_500.wav,2530,2450,80
10084,b-3_1666-1763_1756.wav,VTTS_b-3_1666-1763_1756.wav,7180,7523,-343
10085,b-4_2000-5164_4588.wav,VTTS_b-4_2000-5164_4588.wav,2995,2670,325
10086,b-4_2000-5164_5003.wav,VTTS_b-4_2000-5164_5003.wav,5883,5666,217
10087,b-3_294-391_365.wav,VTTS_b-3_294-391_365.wav,12400,11610,790
10088,b-1_3430-3530_3445.wav,VTTS_b-1_3430-3530_3445.wav,3760,2926,834
10089,b-4_1401-1505_1434.wav,VTTS_b-4_1401-1505_1434.wav,3480,4075,-595
10090,b-4_2000-5164_4883.wav,VTTS_b-4_2000-5164_4883.wav,828,755,73
10091,b-4_2000-5164_3208.wav,VTTS_b-4_2000-5164_3208.wav,3020,2403,617
10092,b-3_6016-6115_6019.wav,VTTS_b-3_6016-6115_6019.wav,5690,4899,791
10093,b-1_1717-1817_1816.wav,VTTS_b-1_1717-1817_1816.wav,2400,2728,-328
10094,b-4_1814-1900_1862.wav,VTTS_b-4_1814-1900_1862.wav,6810,6536,274
10095,b-3_501-930_538.wav,VTTS_b-3_501-930_538.wav,7540,7605,-65
10096,b-4_2000-5164_2801.wav,VTTS_b-4_2000-5164_2801.wav,7520,9752,-2232
10097,b-1_1111-1211_1130.wav,VTTS_b-1_1111-1211_1130.wav,1110,1057,53
10098,b-3_1862-1959_1959.wav,VTTS_b-3_1862-1959_1959.wav,2190,3738,-1548
10099,b-3_196-293_243.wav,VTTS_b-3_196-293_243.wav,5380,4725,655
10100,b-3_2000-2088_2047.wav,VTTS_b-3_2000-2088_2047.wav,5680,5399,281
10101,b-4_2000-5164_2126.wav,VTTS_b-4_2000-5164_2126.wav,6302,6409,-107
10102,b-3_1079-1320_1082.wav,VTTS_b-3_1079-1320_1082.wav,5830,7175,-1345
10103,b-3_501-930_893.wav,VTTS_b-3_501-930_893.wav,5490,5968,-478
10104,b-3_5009-5427_5239.wav,VTTS_b-3_5009-5427_5239.wav,3260,3274,-14
10105,b-1_1212-1312_1298.wav,VTTS_b-1_1212-1312_1298.wav,3600,3344,256
10106,b-3_6900-7016_6931.wav,VTTS_b-3_6900-7016_6931.wav,8320,8998,-678
10107,b-4_2000-5164_5164.wav,VTTS_b-4_2000-5164_5164.wav,3371,3959,-588
10108,b-4_301-400_376.wav,VTTS_b-4_301-400_376.wav,4280,4505,-225
10109,b-2_2194-2208_2198.wav,VTTS_b-2_2194-2208_2198.wav,1690,1602,88
10110,b-3_980-1077_1059.wav,VTTS_b-3_980-1077_1059.wav,4490,4481,9
10111,b-3_6501-6600_6558.wav,VTTS_b-3_6501-6600_6558.wav,2220,2485,-265
10112,b-1_1-73_10.wav,VTTS_b-1_1-73_10.wav,2870,3982,-1112
10113,b-4_1601-1706_1666.wav,VTTS_b-4_1601-1706_1666.wav,5500,5573,-73
10114,b-1_3228-3328_3241.wav,VTTS_b-1_3228-3328_3241.wav,1830,1927,-97
10115,b-4_2000-5164_2197.wav,VTTS_b-4_2000-5164_2197.wav,6580,7372,-792
10116,b-3_3112-3197_3137.wav,VTTS_b-3_3112-3197_3137.wav,1070,1022,48
10117,b-4_2000-5164_4538.wav,VTTS_b-4_2000-5164_4538.wav,6054,5782,272
10118,b-4_2000-5164_2935.wav,VTTS_b-4_2000-5164_2935.wav,9047,8707,340
10119,b-3_6274-6300_6288.wav,VTTS_b-3_6274-6300_6288.wav,2870,3669,-799
10120,b-2_2107-2193_2148.wav,VTTS_b-2_2107-2193_2148.wav,4800,6223,-1423
10121,b-3_1321-1568_1471.wav,VTTS_b-3_1321-1568_1471.wav,6480,6235,245
10122,b-1_175-275_225.wav,VTTS_b-1_175-275_225.wav,1250,1126,124
10123,b-4_2000-5164_4730.wav,VTTS_b-4_2000-5164_4730.wav,5090,5004,86
10124,b-3_3364-3453_3428.wav,VTTS_b-3_3364-3453_3428.wav,4680,4656,24
10125,b-3_501-930_711.wav,VTTS_b-3_501-930_711.wav,2040,2009,31
10126,b-4_501-1014_908.wav,VTTS_b-4_501-1014_908.wav,6770,6107,663
10127,b-4_1601-1706_1687.wav,VTTS_b-4_1601-1706_1687.wav,2830,2995,-165
10128,b-1_794-1009_835.wav,VTTS_b-1_794-1009_835.wav,3640,4052,-412
10129,b-3_1079-1320_1241.wav,VTTS_b-3_1079-1320_1241.wav,4980,4725,255
10130,b-3_3538-3627_3546.wav,VTTS_b-3_3538-3627_3546.wav,5200,4865,335
10131,b-4_2000-5164_3741.wav,VTTS_b-4_2000-5164_3741.wav,2840,3843,-1003
10132,b-4_2000-5164_3097.wav,VTTS_b-4_2000-5164_3097.wav,3591,3228,363
10133,b-1_1111-1211_1140.wav,VTTS_b-1_1111-1211_1140.wav,1130,1033,97
10134,b-1_1616-1716_1654.wav,VTTS_b-1_1616-1716_1654.wav,1530,1254,276
10135,b-1_478-578_560.wav,VTTS_b-1_478-578_560.wav,2190,1985,205
10136,b-1_686-793_781.wav,VTTS_b-1_686-793_781.wav,1830,1730,100
10137,b-4_2000-5164_3945.wav,VTTS_b-4_2000-5164_3945.wav,6364,6920,-556
10138,b-3_6116-6215_6128.wav,VTTS_b-3_6116-6215_6128.wav,3390,3379,11
10139,b-1_4214-4285_4245.wav,VTTS_b-1_4214-4285_4245.wav,1910,1556,354
10140,b-4_1014-1100_1075.wav,VTTS_b-4_1014-1100_1075.wav,2140,2055,85
10141,b-4_1301-1400_1372.wav,VTTS_b-4_1301-1400_1372.wav,7540,6803,737
10142,b-1_1919-2017_1955.wav,VTTS_b-1_1919-2017_1955.wav,1470,1440,30
10143,b-4_2000-5164_3174.wav,VTTS_b-4_2000-5164_3174.wav,7177,6374,803
10144,b-4_2000-5164_4201.wav,VTTS_b-4_2000-5164_4201.wav,4695,4772,-77
10145,b-4_2000-5164_2672.wav,VTTS_b-4_2000-5164_2672.wav,6940,6757,183
10146,b-4_1707-1813_1800.wav,VTTS_b-4_1707-1813_1800.wav,5570,6803,-1233
10147,b-3_4001-4103_4063.wav,VTTS_b-3_4001-4103_4063.wav,4870,5190,-320
10148,b-3_196-293_237.wav,VTTS_b-3_196-293_237.wav,12630,11610,1020
10149,b-4_2000-5164_4475.wav,VTTS_b-4_2000-5164_4475.wav,7851,7221,630
10150,b-3_5009-5427_5431.wav,VTTS_b-3_5009-5427_5431.wav,3730,3646,84
10151,b-1_74-174_161.wav,VTTS_b-1_74-174_161.wav,1620,1579,41
10152,b-4_53-150_58.wav,VTTS_b-4_53-150_58.wav,8200,7152,1048
10153,b-3_4001-4103_4033.wav,VTTS_b-3_4001-4103_4033.wav,8840,8150,690
10154,b-4_2000-5164_3841.wav,VTTS_b-4_2000-5164_3841.wav,7350,7361,-11
10155,b-3_4001-4103_4010.wav,VTTS_b-3_4001-4103_4010.wav,1970,2113,-143
10156,b-4_2000-5164_2036.wav,VTTS_b-4_2000-5164_2036.wav,8720,8893,-173
10157,b-1_3228-3328_3250.wav,VTTS_b-1_3228-3328_3250.wav,1970,2171,-201
10158,b-3_1321-1568_1372.wav,VTTS_b-3_1321-1568_1372.wav,4940,4807,133
10159,b-1_794-1009_972.wav,VTTS_b-1_794-1009_972.wav,2550,3471,-921
10160,b-3_5957-6015_5975.wav,VTTS_b-3_5957-6015_5975.wav,4190,4156,34
10161,b-2_101-202_114.wav,VTTS_b-2_101-202_114.wav,1430,1637,-207
10162,b-3_4425-4497_4459.wav,VTTS_b-3_4425-4497_4459.wav,3560,3332,228
10163,b-1_3228-3328_3291.wav,VTTS_b-1_3228-3328_3291.wav,3170,3286,-116
10164,b-1_3329-3429_3359.wav,VTTS_b-1_3329-3429_3359.wav,2960,3007,-47
10165,b-1_2725-2825_2726.wav,VTTS_b-1_2725-2825_2726.wav,1210,1242,-32
10166,b-1_3632-3732_3683.wav,VTTS_b-1_3632-3732_3683.wav,2400,2566,-166
10167,b-1_686-793_722.wav,VTTS_b-1_686-793_722.wav,1970,1823,147
10168,b-3_5428-5533_5524.wav,VTTS_b-3_5428-5533_5524.wav,7630,7326,304
10169,b-1_175-275_274.wav,VTTS_b-1_175-275_274.wav,1580,1474,106
10170,b-1_3026-3126_3111.wav,VTTS_b-1_3026-3126_3111.wav,2780,2694,86
10171,b-3_1764-1861_1843.wav,VTTS_b-3_1764-1861_1843.wav,5400,5608,-208
10172,b-1_1616-1716_1708.wav,VTTS_b-1_1616-1716_1708.wav,1420,1312,108
10173,b-3_980-1077_1070.wav,VTTS_b-3_980-1077_1070.wav,3140,2647,493
10174,b-1_2523-2623_2566.wav,VTTS_b-1_2523-2623_2566.wav,820,906,-86
10175,b-1_2422-2522_2514.wav,VTTS_b-1_2422-2522_2514.wav,2530,2438,92
10176,b-3_6900-7016_6989.wav,VTTS_b-3_6900-7016_6989.wav,5000,4574,426
10177,b-3_501-930_646.wav,VTTS_b-3_501-930_646.wav,3480,3785,-305
10178,b-1_1818-1918_1869.wav,VTTS_b-1_1818-1918_1869.wav,2660,2786,-126
10179,b-4_2000-5164_3095.wav,VTTS_b-4_2000-5164_3095.wav,9025,8591,434
10180,b-3_5853-5956_5883.wav,VTTS_b-3_5853-5956_5883.wav,4170,4040,130
10181,b-3_6501-6600_6585.wav,VTTS_b-3_6501-6600_6585.wav,1870,1753,117
10182,b-4_2000-5164_3341.wav,VTTS_b-4_2000-5164_3341.wav,6085,5341,744
10183,b-4_2000-5164_3286.wav,VTTS_b-4_2000-5164_3286.wav,4524,4865,-341
10184,b-3_4498-4605_4589.wav,VTTS_b-3_4498-4605_4589.wav,8060,8824,-764
10185,b-4_2000-5164_4945.wav,VTTS_b-4_2000-5164_4945.wav,5626,5503,123
10186,b-3_4001-4103_4082.wav,VTTS_b-3_4001-4103_4082.wav,5000,5120,-120
10187,b-4_2000-5164_4210.wav,VTTS_b-4_2000-5164_4210.wav,6302,6629,-327
10188,b-3_6900-7016_7008.wav,VTTS_b-3_6900-7016_7008.wav,5080,4992,88
10189,b-4_2000-5164_4557.wav,VTTS_b-4_2000-5164_4557.wav,3305,3529,-224
10190,b-1_4466-4498_4495.wav,VTTS_b-1_4466-4498_4495.wav,2750,2868,-118
10191,b-3_5745-5852_5749.wav,VTTS_b-3_5745-5852_5749.wav,4740,5132,-392
10192,b-4_1601-1706_1652.wav,VTTS_b-4_1601-1706_1652.wav,7350,11610,-4260
10193,b-3_5009-5427_5356.wav,VTTS_b-3_5009-5427_5356.wav,5650,6211,-561
10194,b-4_2000-5164_2104.wav,VTTS_b-4_2000-5164_2104.wav,3520,3634,-114
10195,b-4_1101-1220_1103.wav,VTTS_b-4_1101-1220_1103.wav,4270,11610,-7340
10196,b-4_2000-5164_3038.wav,VTTS_b-4_2000-5164_3038.wav,8052,11610,-3558
10197,b-3_1764-1861_1836.wav,VTTS_b-3_1764-1861_1836.wav,5260,4226,1034
10198,b-4_1-52_25.wav,VTTS_b-4_1-52_25.wav,8390,8046,344
10199,b-4_501-1014_891.wav,VTTS_b-4_501-1014_891.wav,7080,7396,-316
10200,b-4_2000-5164_2102.wav,VTTS_b-4_2000-5164_2102.wav,4520,4598,-78
10201,b-1_794-1009_948.wav,VTTS_b-1_794-1009_948.wav,2700,2310,390
10202,b-3_3112-3197_3133.wav,VTTS_b-3_3112-3197_3133.wav,2220,2252,-32
10203,b-1_3430-3530_3474.wav,VTTS_b-1_3430-3530_3474.wav,2360,2043,317
10204,b-3_5009-5427_5320.wav,VTTS_b-3_5009-5427_5320.wav,12130,11401,729
10205,b-4_2000-5164_4473.wav,VTTS_b-4_2000-5164_4473.wav,8649,8499,150
10206,b-2_917-1018_974.wav,VTTS_b-2_917-1018_974.wav,1260,1231,29
10207,b-3_5009-5427_5196.wav,VTTS_b-3_5009-5427_5196.wav,6460,7384,-924
10208,b-1_2927-3025_3015.wav,VTTS_b-1_2927-3025_3015.wav,2900,2914,-14
10209,b-3_980-1077_983.wav,VTTS_b-3_980-1077_983.wav,6780,8510,-1730
10210,b-3_196-293_255.wav,VTTS_b-3_196-293_255.wav,2710,2647,63
10211,b-2_1121-1222_1216.wav,VTTS_b-2_1121-1222_1216.wav,2920,2926,-6
10212,b-4_1101-1220_1135.wav,VTTS_b-4_1101-1220_1135.wav,5570,4969,601
10213,b-3_5009-5427_5097.wav,VTTS_b-3_5009-5427_5097.wav,5120,4865,255
10214,b-4_2000-5164_4750.wav,VTTS_b-4_2000-5164_4750.wav,3642,3750,-108
10215,b-1_2826-2926_2873.wav,VTTS_b-1_2826-2926_2873.wav,5870,5399,471
10216,b-3_5639-5744_5654.wav,VTTS_b-3_5639-5744_5654.wav,2840,2844,-4
10217,b-1_1010-1110_1018.wav,VTTS_b-1_1010-1110_1018.wav,3390,2461,929
10218,b-3_2524-2854_2607.wav,VTTS_b-3_2524-2854_2607.wav,3890,3471,419
10219,b-1_377-477_406.wav,VTTS_b-1_377-477_406.wav,2820,3669,-849
10220,b-1_3834-3934_3930.wav,VTTS_b-1_3834-3934_3930.wav,2630,2450,180
10221,b-2_2311-2412_2320.wav,VTTS_b-2_2311-2412_2320.wav,2350,2380,-30
10222,b-3_1764-1861_1805.wav,VTTS_b-3_1764-1861_1805.wav,3270,3111,159
10223,b-1_1111-1211_1193.wav,VTTS_b-1_1111-1211_1193.wav,3610,3123,487
10224,b-4_2000-5164_3560.wav,VTTS_b-4_2000-5164_3560.wav,1192,1033,159
10225,b-1_276-376_369.wav,VTTS_b-1_276-376_369.wav,2630,2763,-133
10226,b-4_2000-5164_4479.wav,VTTS_b-4_2000-5164_4479.wav,3471,3239,232
10227,b-3_501-930_838.wav,VTTS_b-3_501-930_838.wav,4400,3820,580
10228,b-3_1321-1568_1507.wav,VTTS_b-3_1321-1568_1507.wav,3920,3123,797
10229,b-4_2000-5164_3748.wav,VTTS_b-4_2000-5164_3748.wav,4680,4377,303
10230,b-1_377-477_387.wav,VTTS_b-1_377-477_387.wav,3070,4992,-1922
10231,b-3_4104-4206_4120.wav,VTTS_b-3_4104-4206_4120.wav,5290,4319,971
10232,b-3_1079-1320_1269.wav,VTTS_b-3_1079-1320_1269.wav,6050,5399,651
10233,b-3_2943-3024_2979.wav,VTTS_b-3_2943-3024_2979.wav,9000,8603,397
10234,b-1_1818-1918_1831.wav,VTTS_b-1_1818-1918_1831.wav,3220,3077,143
10235,b-2_917-1018_959.wav,VTTS_b-2_917-1018_959.wav,1790,2694,-904
10236,b-3_1-97_92.wav,VTTS_b-3_1-97_92.wav,8750,8673,77
10237,b-1_3127-3227_3210.wav,VTTS_b-1_3127-3227_3210.wav,2160,3437,-1277
10238,b-4_401-500_408.wav,VTTS_b-4_401-500_408.wav,1530,1335,195
10239,b-2_1597-1698_1649.wav,VTTS_b-2_1597-1698_1649.wav,3710,4540,-830
10240,b-1_1515-1615_1545.wav,VTTS_b-1_1515-1615_1545.wav,3980,3611,369
10241,b-3_6701-6800_6755.wav,VTTS_b-3_6701-6800_6755.wav,3960,3959,1
10242,b-3_392-500_413.wav,VTTS_b-3_392-500_413.wav,3120,3193,-73
10243,b-4_2000-5164_4523.wav,VTTS_b-4_2000-5164_4523.wav,4818,4540,278
10244,b-1_1010-1110_1088.wav,VTTS_b-1_1010-1110_1088.wav,3310,3982,-672
10245,b-1_3531-3631_3557.wav,VTTS_b-1_3531-3631_3557.wav,5450,5190,260
10246,b-1_175-275_212.wav,VTTS_b-1_175-275_212.wav,1170,1509,-339
10247,b-4_2000-5164_3302.wav,VTTS_b-4_2000-5164_3302.wav,3728,4899,-1171
10248,b-4_2000-5164_3702.wav,VTTS_b-4_2000-5164_3702.wav,4053,4331,-278
10249,b-3_2267-2349_2303.wav,VTTS_b-3_2267-2349_2303.wav,4280,4702,-422
10250,b-1_579-649_630.wav,VTTS_b-1_579-649_630.wav,5560,6571,-1011
10251,b-3_501-930_763.wav,VTTS_b-3_501-930_763.wav,6870,5317,1553
10252,b-1_1010-1110_1101.wav,VTTS_b-1_1010-1110_1101.wav,3800,3994,-194
10253,b-3_5009-5427_5282.wav,VTTS_b-3_5009-5427_5282.wav,3440,3680,-240
10254,b-1_4034-4069_4066.wav,VTTS_b-1_4034-4069_4066.wav,2540,2740,-200
10255,b-1_1-73_41.wav,VTTS_b-1_1-73_41.wav,2560,3030,-470
10256,b-1_3329-3429_3416.wav,VTTS_b-1_3329-3429_3416.wav,5280,5027,253
10257,b-1_2523-2623_2582.wav,VTTS_b-1_2523-2623_2582.wav,1780,1776,4
10258,b-2_1699-1800_1706.wav,VTTS_b-2_1699-1800_1706.wav,4590,4865,-275
10259,b-1_2927-3025_2936.wav,VTTS_b-1_2927-3025_2936.wav,2210,2392,-182
10260,b-3_501-930_672.wav,VTTS_b-3_501-930_672.wav,2570,2601,-31
10261,b-4_2000-5164_4685.wav,VTTS_b-4_2000-5164_4685.wav,1814,1707,107
10262,b-3_2943-3024_2983.wav,VTTS_b-3_2943-3024_2983.wav,8930,9311,-381
10263,b-3_6301-6400_6338.wav,VTTS_b-3_6301-6400_6338.wav,10000,10066,-66
10264,b-1_3935-4033_4024.wav,VTTS_b-1_3935-4033_4024.wav,4030,3622,408
10265,b-3_3112-3197_3198.wav,VTTS_b-3_3112-3197_3198.wav,6900,6525,375
10266,b-1_2220-2320_2256.wav,VTTS_b-1_2220-2320_2256.wav,1640,1358,282
10267,b-2_1903-2038_1907.wav,VTTS_b-2_1903-2038_1907.wav,1980,1916,64
10268,b-1_3430-3530_3488.wav,VTTS_b-1_3430-3530_3488.wav,1090,1091,-1
10269,b-1_2725-2825_2741.wav,VTTS_b-1_2725-2825_2741.wav,1310,1254,56
10270,b-3_2177-2266_2231.wav,VTTS_b-3_2177-2266_2231.wav,4090,11610,-7520
10271,b-3_2177-2266_2217.wav,VTTS_b-3_2177-2266_2217.wav,1550,1776,-226
10272,b-4_53-150_59.wav,VTTS_b-4_53-150_59.wav,8880,6954,1926
10273,b-1_3026-3126_3033.wav,VTTS_b-1_3026-3126_3033.wav,3650,3785,-135
10274,b-3_5428-5533_5451.wav,VTTS_b-3_5428-5533_5451.wav,5540,5317,223
10275,b-1_3531-3631_3592.wav,VTTS_b-1_3531-3631_3592.wav,1730,1625,105
10276,b-3_4607-5008_4956.wav,VTTS_b-3_4607-5008_4956.wav,4520,4249,271
10277,b-4_501-1014_738.wav,VTTS_b-4_501-1014_738.wav,2100,2067,33
10278,b-1_4466-4498_4486.wav,VTTS_b-1_4466-4498_4486.wav,1480,1509,-29
10279,b-4_2000-5164_3299.wav,VTTS_b-4_2000-5164_3299.wav,5182,5050,132
10280,b-4_2000-5164_2556.wav,VTTS_b-4_2000-5164_2556.wav,5430,9776,-4346
10281,b-1_3430-3530_3443.wav,VTTS_b-1_3430-3530_3443.wav,3460,3262,198
10282,b-4_2000-5164_2770.wav,VTTS_b-4_2000-5164_2770.wav,1750,1544,206
10283,b-1_686-793_763.wav,VTTS_b-1_686-793_763.wav,6490,5851,639
10284,b-2_2311-2412_2335.wav,VTTS_b-2_2311-2412_2335.wav,1140,1324,-184
10285,b-3_1321-1568_1324.wav,VTTS_b-3_1321-1568_1324.wav,5130,4122,1008
10286,b-3_6116-6215_6205.wav,VTTS_b-3_6116-6215_6205.wav,5850,7082,-1232
10287,b-4_1814-1900_1894.wav,VTTS_b-4_1814-1900_1894.wav,4920,4505,415
10288,b-3_5745-5852_5792.wav,VTTS_b-3_5745-5852_5792.wav,3800,3750,50
10289,b-2_713-814_716.wav,VTTS_b-2_713-814_716.wav,1370,2206,-836
10290,b-3_294-391_301.wav,VTTS_b-3_294-391_301.wav,5020,5004,16
10291,b-4_1506-1600_1533.wav,VTTS_b-4_1506-1600_1533.wav,8400,7721,679
10292,b-1_1111-1211_1111.wav,VTTS_b-1_1111-1211_1111.wav,1800,3460,-1660
10293,b-3_4104-4206_4206.wav,VTTS_b-3_4104-4206_4206.wav,4200,3680,520
10294,b-1_1818-1918_1852.wav,VTTS_b-1_1818-1918_1852.wav,1210,1370,-160
10295,b-1_3834-3934_3881.wav,VTTS_b-1_3834-3934_3881.wav,1500,1660,-160
10296,b-4_1601-1706_1639.wav,VTTS_b-4_1601-1706_1639.wav,2760,2879,-119
10297,b-3_1321-1568_1478.wav,VTTS_b-3_1321-1568_1478.wav,3490,3704,-214
10298,b-1_3935-4033_3985.wav,VTTS_b-1_3935-4033_3985.wav,3440,3831,-391
10299,b-1_3026-3126_3034.wav,VTTS_b-1_3026-3126_3034.wav,1120,1080,40
10300,b-4_1301-1400_1400.wav,VTTS_b-4_1301-1400_1400.wav,9540,10194,-654
10301,b-4_1301-1400_1304.wav,VTTS_b-4_1301-1400_1304.wav,2660,2659,1
10302,b-3_1079-1320_1191.wav,VTTS_b-3_1079-1320_1191.wav,7400,7883,-483
10303,b-1_1616-1716_1622.wav,VTTS_b-1_1616-1716_1622.wav,1210,1149,61
10304,b-4_1601-1706_1685.wav,VTTS_b-4_1601-1706_1685.wav,4610,5027,-417
10305,b-4_2000-5164_3830.wav,VTTS_b-4_2000-5164_3830.wav,4123,3808,315
10306,b-3_3112-3197_3172.wav,VTTS_b-3_3112-3197_3172.wav,4380,5050,-670
10307,b-4_501-1014_531.wav,VTTS_b-4_501-1014_531.wav,2900,2728,172
10308,b-4_1014-1100_1033.wav,VTTS_b-4_1014-1100_1033.wav,4600,3262,1338
10309,b-1_3430-3530_3482.wav,VTTS_b-1_3430-3530_3482.wav,1820,1834,-14
10310,b-2_1903-2038_1961.wav,VTTS_b-2_1903-2038_1961.wav,2110,1683,427
10311,b-3_3454-3537_3456.wav,VTTS_b-3_3454-3537_3456.wav,5720,5433,287
10312,b-3_6501-6600_6594.wav,VTTS_b-3_6501-6600_6594.wav,7440,7361,79
10313,b-3_6501-6600_6505.wav,VTTS_b-3_6501-6600_6505.wav,5410,4737,673
10314,b-1_4106-4141_4114.wav,VTTS_b-1_4106-4141_4114.wav,1960,1881,79
10315,b-3_3803-3888_3869.wav,VTTS_b-3_3803-3888_3869.wav,4700,4795,-95
10316,b-1_175-275_191.wav,VTTS_b-1_175-275_191.wav,1680,1683,-3
10317,b-1_794-1009_998.wav,VTTS_b-1_794-1009_998.wav,4470,4563,-93
10318,b-2_1801-1902_1803.wav,VTTS_b-2_1801-1902_1803.wav,1280,1242,38
10319,b-3_3715-3802_3798.wav,VTTS_b-3_3715-3802_3798.wav,5190,5166,24
10320,b-2_2209-2310_2234.wav,VTTS_b-2_2209-2310_2234.wav,2000,1672,328
10321,b-3_4315-4424_4333.wav,VTTS_b-3_4315-4424_4333.wav,6950,5909,1041
10322,b-3_5853-5956_5956.wav,VTTS_b-3_5853-5956_5956.wav,4660,4168,492
10323,b-3_1079-1320_1087.wav,VTTS_b-3_1079-1320_1087.wav,6720,9381,-2661
10324,b-1_2422-2522_2435.wav,VTTS_b-1_2422-2522_2435.wav,3080,2937,143
10325,b-2_1121-1222_1209.wav,VTTS_b-2_1121-1222_1209.wav,3310,3587,-277
10326,b-3_4607-5008_4749.wav,VTTS_b-3_4607-5008_4749.wav,3690,4133,-443
10327,b-4_501-1014_906.wav,VTTS_b-4_501-1014_906.wav,3760,3680,80
10328,b-4_1301-1400_1354.wav,VTTS_b-4_1301-1400_1354.wav,11280,9810,1470
10329,b-3_1862-1959_1905.wav,VTTS_b-3_1862-1959_1905.wav,5010,5016,-6
10330,b-1_377-477_464.wav,VTTS_b-1_377-477_464.wav,3060,3042,18
10331,b-4_1401-1505_1404.wav,VTTS_b-4_1401-1505_1404.wav,4150,4017,133
10332,b-1_794-1009_980.wav,VTTS_b-1_794-1009_980.wav,1820,1672,148
10333,b-3_6601-6700_6695.wav,VTTS_b-3_6601-6700_6695.wav,7790,8464,-674
10334,b-4_2000-5164_2613.wav,VTTS_b-4_2000-5164_2613.wav,1525,1602,-77
10335,b-3_5639-5744_5676.wav,VTTS_b-3_5639-5744_5676.wav,4540,4458,82
10336,b-1_1515-1615_1610.wav,VTTS_b-1_1515-1615_1610.wav,1930,1753,177
10337,b-4_401-500_473.wav,VTTS_b-4_401-500_473.wav,7610,7163,447
10338,b-3_6501-6600_6566.wav,VTTS_b-3_6501-6600_6566.wav,3030,3019,11
10339,b-4_1814-1900_1881.wav,VTTS_b-4_1814-1900_1881.wav,2680,3727,-1047
10340,b-1_1313-1413_1349.wav,VTTS_b-1_1313-1413_1349.wav,2850,2508,342
10341,b-4_2000-5164_2199.wav,VTTS_b-4_2000-5164_2199.wav,2400,2485,-85
10342,b-2_713-814_725.wav,VTTS_b-2_713-814_725.wav,3880,3495,385
10343,b-1_3935-4033_3952.wav,VTTS_b-1_3935-4033_3952.wav,4170,4888,-718
10344,b-3_3889-4000_3946.wav,VTTS_b-3_3889-4000_3946.wav,9210,9358,-148
10345,b-1_2725-2825_2737.wav,VTTS_b-1_2725-2825_2737.wav,3730,3762,-32
10346,b-1_2422-2522_2484.wav,VTTS_b-1_2422-2522_2484.wav,1620,1463,157
10347,b-3_2524-2854_2695.wav,VTTS_b-3_2524-2854_2695.wav,8680,8057,623
10348,b-1_4214-4285_4243.wav,VTTS_b-1_4214-4285_4243.wav,2470,2786,-316
10349,b-3_501-930_633.wav,VTTS_b-3_501-930_633.wav,3730,3088,642
10350,b-3_4315-4424_4399.wav,VTTS_b-3_4315-4424_4399.wav,7920,7721,199
10351,b-3_4425-4497_4480.wav,VTTS_b-3_4425-4497_4480.wav,5590,4946,644
10352,b-1_377-477_398.wav,VTTS_b-1_377-477_398.wav,1160,1474,-314
10353,b-1_794-1009_950.wav,VTTS_b-1_794-1009_950.wav,3400,3495,-95
10354,b-4_2000-5164_2119.wav,VTTS_b-4_2000-5164_2119.wav,3440,3553,-113
10355,b-1_2826-2926_2874.wav,VTTS_b-1_2826-2926_2874.wav,3010,3135,-125
10356,b-3_3198-3278_3262.wav,VTTS_b-3_3198-3278_3262.wav,4380,4412,-32
10357,b-2_203-304_236.wav,VTTS_b-2_203-304_236.wav,1790,2183,-393
10358,b-1_579-649_601.wav,VTTS_b-1_579-649_601.wav,2300,2322,-22
10359,b-2_1597-1698_1631.wav,VTTS_b-2_1597-1698_1631.wav,3080,2461,619
10360,b-3_980-1077_997.wav,VTTS_b-3_980-1077_997.wav,7940,7535,405
10361,b-3_501-930_714.wav,VTTS_b-3_501-930_714.wav,8080,6885,1195
10362,b-4_2000-5164_2050.wav,VTTS_b-4_2000-5164_2050.wav,3780,4458,-678
10363,b-1_4394-4429_4421.wav,VTTS_b-1_4394-4429_4421.wav,2670,6560,-3890
10364,b-2_1-100_89.wav,VTTS_b-2_1-100_89.wav,1380,2183,-803
10365,b-2_1427-1562_1504.wav,VTTS_b-2_1427-1562_1504.wav,2620,2403,217
10366,b-1_2220-2320_2222.wav,VTTS_b-1_2220-2320_2222.wav,1860,1672,188
10367,b-1_3430-3530_3507.wav,VTTS_b-1_3430-3530_3507.wav,1330,1324,6
10368,b-3_4607-5008_4971.wav,VTTS_b-3_4607-5008_4971.wav,2260,2206,54
10369,b-4_2000-5164_4992.wav,VTTS_b-4_2000-5164_4992.wav,3324,3019,305
10370,b-2_1903-2038_1994.wav,VTTS_b-2_1903-2038_1994.wav,1750,1649,101
10371,b-1_1-73_56.wav,VTTS_b-1_1-73_56.wav,3470,3320,150
10372,b-3_5745-5852_5803.wav,VTTS_b-3_5745-5852_5803.wav,6710,6676,34
10373,b-1_2624-2724_2667.wav,VTTS_b-1_2624-2724_2667.wav,1680,1695,-15
10374,b-1_2119-2219_2184.wav,VTTS_b-1_2119-2219_2184.wav,790,743,47
10375,b-1_4106-4141_4124.wav,VTTS_b-1_4106-4141_4124.wav,4390,4609,-219
10376,b-2_2311-2412_2357.wav,VTTS_b-2_2311-2412_2357.wav,1130,1254,-124
10377,b-1_579-649_616.wav,VTTS_b-1_579-649_616.wav,2340,3262,-922
10378,b-1_3935-4033_4013.wav,VTTS_b-1_3935-4033_4013.wav,2570,2612,-42
10379,b-3_5745-5852_5824.wav,VTTS_b-3_5745-5852_5824.wav,4630,5863,-1233
10380,b-3_3198-3278_3208.wav,VTTS_b-3_3198-3278_3208.wav,8330,8243,87
10381,b-1_2018-2118_2110.wav,VTTS_b-1_2018-2118_2110.wav,2640,3390,-750
10382,b-4_2000-5164_3865.wav,VTTS_b-4_2000-5164_3865.wav,1236,1080,156
10383,b-3_6801-6900_6840.wav,VTTS_b-3_6801-6900_6840.wav,3640,2972,668
10384,b-2_1427-1562_1503.wav,VTTS_b-2_1427-1562_1503.wav,4240,3587,653
10385,b-3_98-195_180.wav,VTTS_b-3_98-195_180.wav,5240,4644,596
10386,b-2_2311-2412_2314.wav,VTTS_b-2_2311-2412_2314.wav,1300,2705,-1405
10387,b-4_1901-2000_1987.wav,VTTS_b-4_1901-2000_1987.wav,2510,2229,281
10388,b-3_1666-1763_1717.wav,VTTS_b-3_1666-1763_1717.wav,3140,3274,-134
10389,b-3_501-930_881.wav,VTTS_b-3_501-930_881.wav,6280,5909,371
10390,b-1_1414-1514_1453.wav,VTTS_b-1_1414-1514_1453.wav,4840,6374,-1534
10391,b-1_3127-3227_3185.wav,VTTS_b-1_3127-3227_3185.wav,2140,2276,-136
10392,b-3_5009-5427_5364.wav,VTTS_b-3_5009-5427_5364.wav,6200,9741,-3541
10393,b-3_4315-4424_4378.wav,VTTS_b-3_4315-4424_4378.wav,3780,3796,-16
10394,b-1_377-477_439.wav,VTTS_b-1_377-477_439.wav,1340,1358,-18
10395,b-1_2523-2623_2529.wav,VTTS_b-1_2523-2623_2529.wav,1130,1254,-124
10396,b-1_1616-1716_1667.wav,VTTS_b-1_1616-1716_1667.wav,5520,5944,-424
10397,b-3_196-293_221.wav,VTTS_b-3_196-293_221.wav,6730,6385,345
10398,b-4_2000-5164_4855.wav,VTTS_b-4_2000-5164_4855.wav,6298,7999,-1701
10399,b-3_5853-5956_5924.wav,VTTS_b-3_5853-5956_5924.wav,2780,2752,28
10400,b-2_1325-1426_1421.wav,VTTS_b-2_1325-1426_1421.wav,3300,3622,-322
10401,b-4_151-300_231.wav,VTTS_b-4_151-300_231.wav,4670,6107,-1437
10402,b-1_1515-1615_1597.wav,VTTS_b-1_1515-1615_1597.wav,4060,4656,-596
10403,b-4_1401-1505_1484.wav,VTTS_b-4_1401-1505_1484.wav,3710,3611,99
10404,b-3_5009-5427_5267.wav,VTTS_b-3_5009-5427_5267.wav,11510,11610,-100
10405,b-3_3628-3714_3650.wav,VTTS_b-3_3628-3714_3650.wav,3870,3622,248
10406,b-2_305-406_322.wav,VTTS_b-2_305-406_322.wav,4220,5108,-888
10407,b-4_2000-5164_2387.wav,VTTS_b-4_2000-5164_2387.wav,4580,5492,-912
10408,b-1_478-578_527.wav,VTTS_b-1_478-578_527.wav,2380,2682,-302
10409,b-3_3454-3537_3484.wav,VTTS_b-3_3454-3537_3484.wav,5390,5050,340
10410,b-4_1901-2000_1983.wav,VTTS_b-4_1901-2000_1983.wav,2850,3855,-1005
10411,b-2_1903-2038_1928.wav,VTTS_b-2_1903-2038_1928.wav,3020,2786,234
10412,b-1_3026-3126_3040.wav,VTTS_b-1_3026-3126_3040.wav,2760,2717,43
10413,b-3_5009-5427_5111.wav,VTTS_b-3_5009-5427_5111.wav,5930,6246,-316
10414,b-4_2000-5164_2121.wav,VTTS_b-4_2000-5164_2121.wav,4120,4087,33
10415,b-4_301-400_346.wav,VTTS_b-4_301-400_346.wav,5890,5677,213
10416,b-4_1401-1505_1413.wav,VTTS_b-4_1401-1505_1413.wav,1620,1707,-87
10417,b-2_1597-1698_1688.wav,VTTS_b-2_1597-1698_1688.wav,1690,1614,76
10418,b-3_1079-1320_1301.wav,VTTS_b-3_1079-1320_1301.wav,4010,3947,63
10419,b-3_3454-3537_3514.wav,VTTS_b-3_3454-3537_3514.wav,3550,3355,195
10420,b-1_1818-1918_1836.wav,VTTS_b-1_1818-1918_1836.wav,5020,4644,376
10421,b-4_2000-5164_4247.wav,VTTS_b-4_2000-5164_4247.wav,3396,3216,180
10422,b-3_501-930_835.wav,VTTS_b-3_501-930_835.wav,8210,8533,-323
10423,b-3_5428-5533_5439.wav,VTTS_b-3_5428-5533_5439.wav,7840,8975,-1135
10424,b-2_917-1018_956.wav,VTTS_b-2_917-1018_956.wav,2760,2577,183
10425,b-3_4607-5008_4837.wav,VTTS_b-3_4607-5008_4837.wav,4990,5108,-118
10426,b-1_74-174_163.wav,VTTS_b-1_74-174_163.wav,3330,3460,-130
10427,b-1_1717-1817_1737.wav,VTTS_b-1_1717-1817_1737.wav,1270,1231,39
10428,b-4_2000-5164_5071.wav,VTTS_b-4_2000-5164_5071.wav,9738,9276,462
10429,b-4_501-1014_941.wav,VTTS_b-4_501-1014_941.wav,5680,5399,281
10430,b-3_501-930_724.wav,VTTS_b-3_501-930_724.wav,6170,6931,-761
10431,b-3_5639-5744_5723.wav,VTTS_b-3_5639-5744_5723.wav,6970,11366,-4396
10432,b-3_6217-6274_6245.wav,VTTS_b-3_6217-6274_6245.wav,4700,5898,-1198
10433,b-3_501-930_503.wav,VTTS_b-3_501-930_503.wav,4590,3866,724
10434,b-4_1014-1100_1068.wav,VTTS_b-4_1014-1100_1068.wav,5920,4679,1241
10435,b-3_5957-6015_5971.wav,VTTS_b-3_5957-6015_5971.wav,9160,9009,151
10436,b-4_1707-1813_1792.wav,VTTS_b-4_1707-1813_1792.wav,11370,11610,-240
10437,b-2_611-712_620.wav,VTTS_b-2_611-712_620.wav,1810,1741,69
10438,b-2_1699-1800_1770.wav,VTTS_b-2_1699-1800_1770.wav,3290,3622,-332
10439,b-1_3834-3934_3886.wav,VTTS_b-1_3834-3934_3886.wav,2840,3053,-213
10440,b-2_2413-2500_2421.wav,VTTS_b-2_2413-2500_2421.wav,3260,3100,160
10441,b-4_1-52_45.wav,VTTS_b-4_1-52_45.wav,14760,11610,3150
10442,b-3_1666-1763_1704.wav,VTTS_b-3_1666-1763_1704.wav,6060,6478,-418
10443,b-3_4607-5008_4993.wav,VTTS_b-3_4607-5008_4993.wav,4600,4574,26
10444,b-3_6016-6115_6045.wav,VTTS_b-3_6016-6115_6045.wav,1040,987,53
10445,b-2_2413-2500_2471.wav,VTTS_b-2_2413-2500_2471.wav,1360,1881,-521
10446,b-2_1427-1562_1520.wav,VTTS_b-2_1427-1562_1520.wav,2260,2461,-201
10447,b-2_611-712_709.wav,VTTS_b-2_611-712_709.wav,1280,1149,131
10448,b-3_5533-5638_5620.wav,VTTS_b-3_5533-5638_5620.wav,11200,11610,-410
10449,b-1_2927-3025_2940.wav,VTTS_b-1_2927-3025_2940.wav,2270,2659,-389
10450,b-3_980-1077_1043.wav,VTTS_b-3_980-1077_1043.wav,1960,1904,56
10451,b-4_2000-5164_4930.wav,VTTS_b-4_2000-5164_4930.wav,5510,5097,413
10452,b-3_4001-4103_4061.wav,VTTS_b-3_4001-4103_4061.wav,3010,3019,-9
10453,b-3_1960-2000_1967.wav,VTTS_b-3_1960-2000_1967.wav,5870,5387,483
10454,b-1_1414-1514_1434.wav,VTTS_b-1_1414-1514_1434.wav,2500,2067,433
10455,b-3_5009-5427_5396.wav,VTTS_b-3_5009-5427_5396.wav,3610,3924,-314
10456,b-2_2107-2193_2142.wav,VTTS_b-2_2107-2193_2142.wav,1230,1173,57
10457,b-1_3430-3530_3517.wav,VTTS_b-1_3430-3530_3517.wav,2500,3855,-1355
10458,b-3_2267-2349_2295.wav,VTTS_b-3_2267-2349_2295.wav,4980,4992,-12
10459,b-4_501-1014_597.wav,VTTS_b-4_501-1014_597.wav,8290,7872,418
10460,b-1_3430-3530_3462.wav,VTTS_b-1_3430-3530_3462.wav,2320,2415,-95
10461,b-4_2000-5164_3944.wav,VTTS_b-4_2000-5164_3944.wav,6588,7245,-657
10462,b-4_2000-5164_4771.wav,VTTS_b-4_2000-5164_4771.wav,5516,6653,-1137
10463,b-2_2073-2106_2088.wav,VTTS_b-2_2073-2106_2088.wav,3230,3448,-218
10464,b-1_2422-2522_2504.wav,VTTS_b-1_2422-2522_2504.wav,3780,3750,30
10465,b-4_2000-5164_4157.wav,VTTS_b-4_2000-5164_4157.wav,3233,3518,-285
10466,b-3_6116-6215_6120.wav,VTTS_b-3_6116-6215_6120.wav,5680,5283,397
10467,b-3_6501-6600_6526.wav,VTTS_b-3_6501-6600_6526.wav,2850,2786,64
10468,b-2_203-304_266.wav,VTTS_b-2_203-304_266.wav,6150,6560,-410
10469,b-2_1597-1698_1607.wav,VTTS_b-2_1597-1698_1607.wav,1840,1765,75
10470,b-3_4001-4103_4049.wav,VTTS_b-3_4001-4103_4049.wav,5920,6385,-465
10471,b-2_509-610_601.wav,VTTS_b-2_509-610_601.wav,1250,1149,101
10472,b-2_2107-2193_2133.wav,VTTS_b-2_2107-2193_2133.wav,2980,2194,786
10473,b-2_611-712_621.wav,VTTS_b-2_611-712_621.wav,2390,2206,184
10474,b-3_2177-2266_2203.wav,VTTS_b-3_2177-2266_2203.wav,1820,1544,276
10475,b-2_2209-2310_2243.wav,VTTS_b-2_2209-2310_2243.wav,3970,4191,-221
10476,b-3_1862-1959_1957.wav,VTTS_b-3_1862-1959_1957.wav,7550,8173,-623
10477,b-1_4430-4465_4452.wav,VTTS_b-1_4430-4465_4452.wav,1390,1324,66
10478,b-3_4607-5008_4763.wav,VTTS_b-3_4607-5008_4763.wav,5540,8522,-2982
10479,b-3_5009-5427_5044.wav,VTTS_b-3_5009-5427_5044.wav,3290,4447,-1157
10480,b-3_1321-1568_1561.wav,VTTS_b-3_1321-1568_1561.wav,6200,5805,395
10481,b-3_2855-2942_2894.wav,VTTS_b-3_2855-2942_2894.wav,5000,5190,-190
10482,b-4_2000-5164_4816.wav,VTTS_b-4_2000-5164_4816.wav,4249,3796,453
10483,b-3_4607-5008_4926.wav,VTTS_b-3_4607-5008_4926.wav,3040,3262,-222
10484,b-1_2826-2926_2902.wav,VTTS_b-1_2826-2926_2902.wav,3420,3390,30
10485,b-3_4104-4206_4104.wav,VTTS_b-3_4104-4206_4104.wav,5720,5642,78
10486,b-3_5853-5956_5918.wav,VTTS_b-3_5853-5956_5918.wav,4640,4656,-16
10487,b-4_2000-5164_4600.wav,VTTS_b-4_2000-5164_4600.wav,3135,3146,-11
10488,b-3_196-293_215.wav,VTTS_b-3_196-293_215.wav,8540,7906,634
10489,b-1_579-649_604.wav,VTTS_b-1_579-649_604.wav,2270,2159,111
10490,b-4_501-1014_849.wav,VTTS_b-4_501-1014_849.wav,2760,2554,206
10491,b-3_4104-4206_4125.wav,VTTS_b-3_4104-4206_4125.wav,7410,8069,-659
10492,b-4_2000-5164_4673.wav,VTTS_b-4_2000-5164_4673.wav,6952,6745,207
10493,b-2_1699-1800_1715.wav,VTTS_b-2_1699-1800_1715.wav,6020,7546,-1526
10494,b-4_151-300_154.wav,VTTS_b-4_151-300_154.wav,4050,3727,323
10495,b-1_175-275_245.wav,VTTS_b-1_175-275_245.wav,2040,1974,66
10496,b-2_509-610_530.wav,VTTS_b-2_509-610_530.wav,1520,1115,405
10497,b-3_1-97_75.wav,VTTS_b-3_1-97_75.wav,5460,5538,-78
10498,b-2_1699-1800_1742.wav,VTTS_b-2_1699-1800_1742.wav,930,894,36
10499,b-3_501-930_664.wav,VTTS_b-3_501-930_664.wav,1430,1428,2
10500,b-1_686-793_769.wav,VTTS_b-1_686-793_769.wav,3210,3193,17
10501,b-3_1321-1568_1550.wav,VTTS_b-3_1321-1568_1550.wav,2110,2020,90
10502,b-4_2000-5164_2687.wav,VTTS_b-4_2000-5164_2687.wav,5765,10054,-4289
10503,b-1_3329-3429_3368.wav,VTTS_b-1_3329-3429_3368.wav,1240,1242,-2
10504,b-4_1101-1220_1146.wav,VTTS_b-4_1101-1220_1146.wav,6700,6850,-150
10505,b-3_1321-1568_1396.wav,VTTS_b-3_1321-1568_1396.wav,4630,4342,288
10506,b-2_1699-1800_1726.wav,VTTS_b-2_1699-1800_1726.wav,1990,2345,-355
10507,b-1_1616-1716_1664.wav,VTTS_b-1_1616-1716_1664.wav,4090,3762,328
10508,b-3_1764-1861_1823.wav,VTTS_b-3_1764-1861_1823.wav,3150,3448,-298
10509,b-1_4214-4285_4220.wav,VTTS_b-1_4214-4285_4220.wav,3440,3332,108
10510,b-3_501-930_703.wav,VTTS_b-3_501-930_703.wav,4900,4690,210
10511,b-3_1568-1665_1630.wav,VTTS_b-3_1568-1665_1630.wav,8260,7976,284
10512,b-2_1121-1222_1218.wav,VTTS_b-2_1121-1222_1218.wav,1940,2310,-370
10513,b-1_579-649_606.wav,VTTS_b-1_579-649_606.wav,3400,3390,10
10514,b-3_4104-4206_4148.wav,VTTS_b-3_4104-4206_4148.wav,4420,4284,136
10515,b-3_5428-5533_5445.wav,VTTS_b-3_5428-5533_5445.wav,8120,8649,-529
10516,b-1_1919-2017_1958.wav,VTTS_b-1_1919-2017_1958.wav,5490,6014,-524
10517,b-4_2000-5164_2968.wav,VTTS_b-4_2000-5164_2968.wav,5889,5921,-32
10518,b-3_4607-5008_4674.wav,VTTS_b-3_4607-5008_4674.wav,6970,7454,-484
10519,b-1_3026-3126_3041.wav,VTTS_b-1_3026-3126_3041.wav,5110,5341,-231
10520,b-3_5009-5427_5009.wav,VTTS_b-3_5009-5427_5009.wav,2120,1916,204
10521,b-2_2311-2412_2352.wav,VTTS_b-2_2311-2412_2352.wav,1880,1753,127
10522,b-3_4315-4424_4412.wav,VTTS_b-3_4315-4424_4412.wav,5680,5433,247
10523,b-3_6401-6500_6478.wav,VTTS_b-3_6401-6500_6478.wav,7750,7233,517
10524,b-4_2000-5164_3508.wav,VTTS_b-4_2000-5164_3508.wav,5794,5724,70
10525,b-3_3025-3111_3079.wav,VTTS_b-3_3025-3111_3079.wav,5710,6026,-316
10526,b-2_1801-1902_1898.wav,VTTS_b-2_1801-1902_1898.wav,1900,1405,495
10527,b-4_2000-5164_4645.wav,VTTS_b-4_2000-5164_4645.wav,3216,3065,151
10528,b-3_4607-5008_4887.wav,VTTS_b-3_4607-5008_4887.wav,5440,5898,-458
10529,b-1_1414-1514_1502.wav,VTTS_b-1_1414-1514_1502.wav,2670,2508,162
10530,b-3_4607-5008_4714.wav,VTTS_b-3_4607-5008_4714.wav,8140,8452,-312
10531,b-1_1313-1413_1404.wav,VTTS_b-1_1313-1413_1404.wav,1960,1811,149
10532,b-1_1515-1615_1586.wav,VTTS_b-1_1515-1615_1586.wav,2290,2287,3
10533,b-3_1666-1763_1708.wav,VTTS_b-3_1666-1763_1708.wav,4200,3657,543
10534,b-2_407-508_473.wav,VTTS_b-2_407-508_473.wav,2010,1393,617
10535,b-4_1301-1400_1338.wav,VTTS_b-4_1301-1400_1338.wav,5860,4830,1030
10536,b-3_2524-2854_2770.wav,VTTS_b-3_2524-2854_2770.wav,2840,3518,-678
10537,b-3_1079-1320_1133.wav,VTTS_b-3_1079-1320_1133.wav,2960,2519,441
10538,b-3_3454-3537_3496.wav,VTTS_b-3_3454-3537_3496.wav,4840,4888,-48
10539,b-2_815-916_817.wav,VTTS_b-2_815-916_817.wav,3340,3529,-189
10540,b-3_2434-2523_2469.wav,VTTS_b-3_2434-2523_2469.wav,4570,11610,-7040
10541,b-1_1212-1312_1217.wav,VTTS_b-1_1212-1312_1217.wav,5230,6246,-1016
10542,b-1_2321-2421_2406.wav,VTTS_b-1_2321-2421_2406.wav,1360,1312,48
10543,b-3_1321-1568_1367.wav,VTTS_b-3_1321-1568_1367.wav,7130,6525,605
10544,b-3_501-930_808.wav,VTTS_b-3_501-930_808.wav,2530,2322,208
10545,b-2_1597-1698_1616.wav,VTTS_b-2_1597-1698_1616.wav,920,1231,-311
10546,b-4_2000-5164_2325.wav,VTTS_b-4_2000-5164_2325.wav,5895,5329,566
10547,b-1_3127-3227_3147.wav,VTTS_b-1_3127-3227_3147.wav,4230,3646,584
10548,b-4_151-300_267.wav,VTTS_b-4_151-300_267.wav,2100,2125,-25
10549,b-2_611-712_615.wav,VTTS_b-2_611-712_615.wav,3080,2705,375
10550,b-3_1321-1568_1342.wav,VTTS_b-3_1321-1568_1342.wav,7360,11610,-4250
10551,b-1_3935-4033_3992.wav,VTTS_b-1_3935-4033_3992.wav,2360,2566,-206
10552,b-4_2000-5164_3065.wav,VTTS_b-4_2000-5164_3065.wav,3153,2833,320
10553,b-3_5009-5427_5178.wav,VTTS_b-3_5009-5427_5178.wav,6260,6536,-276
10554,b-3_501-930_508.wav,VTTS_b-3_501-930_508.wav,3630,3634,-4
10555,b-1_3834-3934_3875.wav,VTTS_b-1_3834-3934_3875.wav,890,848,42
10556,b-4_501-1014_954.wav,VTTS_b-4_501-1014_954.wav,2100,2055,45
10557,b-3_980-1077_1035.wav,VTTS_b-3_980-1077_1035.wav,3740,3901,-161
10558,b-1_3026-3126_3089.wav,VTTS_b-1_3026-3126_3089.wav,1520,1509,11
10559,b-2_2040-2072_2049.wav,VTTS_b-2_2040-2072_2049.wav,1600,1544,56
10560,b-4_2000-5164_4443.wav,VTTS_b-4_2000-5164_4443.wav,1900,2113,-213
10561,b-1_377-477_419.wav,VTTS_b-1_377-477_419.wav,2190,2020,170
10562,b-3_2267-2349_2343.wav,VTTS_b-3_2267-2349_2343.wav,8900,8998,-98
10563,b-1_2624-2724_2652.wav,VTTS_b-1_2624-2724_2652.wav,3850,3773,77
10564,b-2_1597-1698_1633.wav,VTTS_b-2_1597-1698_1633.wav,1390,1324,66
10565,b-4_501-1014_574.wav,VTTS_b-4_501-1014_574.wav,2880,2833,47
10566,b-3_2000-2088_2052.wav,VTTS_b-3_2000-2088_2052.wav,5630,5480,150
10567,b-2_1563-1596_1586.wav,VTTS_b-2_1563-1596_1586.wav,4460,3796,664
10568,b-4_1601-1706_1612.wav,VTTS_b-4_1601-1706_1612.wav,3150,3030,120
10569,b-3_5009-5427_5082.wav,VTTS_b-3_5009-5427_5082.wav,6090,11610,-5520
10570,b-3_5009-5427_5384.wav,VTTS_b-3_5009-5427_5384.wav,4450,4470,-20
10571,b-3_2524-2854_2731.wav,VTTS_b-3_2524-2854_2731.wav,7470,7581,-111
10572,b-4_501-1014_690.wav,VTTS_b-4_501-1014_690.wav,10990,10356,634
10573,b-4_2000-5164_3649.wav,VTTS_b-4_2000-5164_3649.wav,1889,1788,101
10574,b-3_501-930_801.wav,VTTS_b-3_501-930_801.wav,6820,6687,133
10575,b-1_1212-1312_1226.wav,VTTS_b-1_1212-1312_1226.wav,1350,1335,15
10576,b-3_1079-1320_1291.wav,VTTS_b-3_1079-1320_1291.wav,10660,10426,234
10577,b-2_1801-1902_1836.wav,VTTS_b-2_1801-1902_1836.wav,1480,1300,180
10578,b-4_2000-5164_2321.wav,VTTS_b-4_2000-5164_2321.wav,3910,3727,183
10579,b-2_509-610_557.wav,VTTS_b-2_509-610_557.wav,1650,2717,-1067
10580,b-1_2523-2623_2560.wav,VTTS_b-1_2523-2623_2560.wav,3050,2554,496
10581,b-2_305-406_325.wav,VTTS_b-2_305-406_325.wav,5740,6502,-762
10582,b-2_815-916_896.wav,VTTS_b-2_815-916_896.wav,1370,1567,-197
10583,b-1_2321-2421_2391.wav,VTTS_b-1_2321-2421_2391.wav,3710,3379,331
10584,b-3_98-195_171.wav,VTTS_b-3_98-195_171.wav,1990,2032,-42
10585,b-3_931-979_944.wav,VTTS_b-3_931-979_944.wav,5600,5387,213
10586,b-3_2350-2433_2416.wav,VTTS_b-3_2350-2433_2416.wav,3470,3495,-25
10587,b-3_1764-1861_1794.wav,VTTS_b-3_1764-1861_1794.wav,8370,8417,-47
10588,b-4_2000-5164_4535.wav,VTTS_b-4_2000-5164_4535.wav,6271,7790,-1519
10589,b-2_2107-2193_2173.wav,VTTS_b-2_2107-2193_2173.wav,7070,5735,1335
10590,b-4_2000-5164_2844.wav,VTTS_b-4_2000-5164_2844.wav,3820,3773,47
10591,b-4_1814-1900_1851.wav,VTTS_b-4_1814-1900_1851.wav,8920,8429,491
10592,b-4_2000-5164_4458.wav,VTTS_b-4_2000-5164_4458.wav,4600,4609,-9
10593,b-1_4142-4177_4170.wav,VTTS_b-1_4142-4177_4170.wav,1600,1358,242
10594,b-3_5009-5427_5141.wav,VTTS_b-3_5009-5427_5141.wav,5650,6095,-445
10595,b-3_3715-3802_3739.wav,VTTS_b-3_3715-3802_3739.wav,4900,4934,-34
10596,b-1_3026-3126_3088.wav,VTTS_b-1_3026-3126_3088.wav,2630,2624,6
10597,b-1_1616-1716_1638.wav,VTTS_b-1_1616-1716_1638.wav,4240,4621,-381
10598,b-1_2422-2522_2475.wav,VTTS_b-1_2422-2522_2475.wav,2160,2868,-708
10599,b-3_2524-2854_2839.wav,VTTS_b-3_2524-2854_2839.wav,5720,5561,159
10600,b-3_3112-3197_3196.wav,VTTS_b-3_3112-3197_3196.wav,4610,4447,163
10601,b-4_2000-5164_2764.wav,VTTS_b-4_2000-5164_2764.wav,6280,5561,719
10602,b-4_2000-5164_4305.wav,VTTS_b-4_2000-5164_4305.wav,5026,4818,208
10603,b-3_980-1077_993.wav,VTTS_b-3_980-1077_993.wav,8180,8522,-342
10604,b-2_1-100_97.wav,VTTS_b-2_1-100_97.wav,1760,1846,-86
10605,b-3_501-930_905.wav,VTTS_b-3_501-930_905.wav,4000,3831,169
10606,b-4_2000-5164_3125.wav,VTTS_b-4_2000-5164_3125.wav,11858,10635,1223
10607,b-4_301-400_348.wav,VTTS_b-4_301-400_348.wav,4550,4644,-94
10608,b-3_6501-6600_6541.wav,VTTS_b-3_6501-6600_6541.wav,1470,1486,-16
10609,b-1_478-578_520.wav,VTTS_b-1_478-578_520.wav,1200,1231,-31
10610,b-3_98-195_149.wav,VTTS_b-3_98-195_149.wav,2880,2740,140
10611,b-3_1-97_58.wav,VTTS_b-3_1-97_58.wav,8940,9392,-452
10612,b-3_6274-6300_6287.wav,VTTS_b-3_6274-6300_6287.wav,5740,5561,179
10613,b-4_2000-5164_2021.wav,VTTS_b-4_2000-5164_2021.wav,3445,3866,-421
10614,b-1_175-275_232.wav,VTTS_b-1_175-275_232.wav,1690,1881,-191
10615,b-3_501-930_611.wav,VTTS_b-3_501-930_611.wav,6900,6490,410
10616,b-3_4607-5008_4811.wav,VTTS_b-3_4607-5008_4811.wav,4300,4748,-448
10617,b-3_3198-3278_3276.wav,VTTS_b-3_3198-3278_3276.wav,9830,11610,-1780
10618,b-3_3628-3714_3711.wav,VTTS_b-3_3628-3714_3711.wav,5110,5596,-486
10619,b-1_2422-2522_2456.wav,VTTS_b-1_2422-2522_2456.wav,4600,5166,-566
10620,b-3_5853-5956_5908.wav,VTTS_b-3_5853-5956_5908.wav,3000,2810,190
10621,b-4_2000-5164_3029.wav,VTTS_b-4_2000-5164_3029.wav,5219,4957,262
10622,b-3_501-930_766.wav,VTTS_b-3_501-930_766.wav,7070,11610,-4540
10623,b-4_1301-1400_1325.wav,VTTS_b-4_1301-1400_1325.wav,5920,5422,498
10624,b-3_3279-3363_3338.wav,VTTS_b-3_3279-3363_3338.wav,1520,1788,-268
10625,b-4_1101-1220_1193.wav,VTTS_b-4_1101-1220_1193.wav,3890,3820,70
10626,b-2_1903-2038_1903.wav,VTTS_b-2_1903-2038_1903.wav,3150,3553,-403
10627,b-3_2089-2176_2168.wav,VTTS_b-3_2089-2176_2168.wav,3780,3483,297
10628,b-3_3112-3197_3120.wav,VTTS_b-3_3112-3197_3120.wav,7490,7221,269
10629,b-1_650-685_672.wav,VTTS_b-1_650-685_672.wav,1570,1869,-299
10630,b-3_2089-2176_2124.wav,VTTS_b-3_2089-2176_2124.wav,4170,3843,327
10631,b-3_2524-2854_2580.wav,VTTS_b-3_2524-2854_2580.wav,2660,2554,106
10632,b-1_3228-3328_3242.wav,VTTS_b-1_3228-3328_3242.wav,1110,1033,77
10633,b-2_203-304_295.wav,VTTS_b-2_203-304_295.wav,1880,2310,-430
10634,b-1_2927-3025_2985.wav,VTTS_b-1_2927-3025_2985.wav,1650,1869,-219
10635,b-1_1515-1615_1589.wav,VTTS_b-1_1515-1615_1589.wav,2230,2229,1
10636,b-3_2350-2433_2418.wav,VTTS_b-3_2350-2433_2418.wav,2900,2775,125
10637,b-1_4214-4285_4250.wav,VTTS_b-1_4214-4285_4250.wav,2350,2380,-30
10638,b-3_4207-4314_4238.wav,VTTS_b-3_4207-4314_4238.wav,4160,4098,62
10639,b-3_1079-1320_1292.wav,VTTS_b-3_1079-1320_1292.wav,2810,2577,233
10640,b-2_203-304_304.wav,VTTS_b-2_203-304_304.wav,5490,5329,161
10641,b-4_401-500_498.wav,VTTS_b-4_401-500_498.wav,3900,3913,-13
10642,b-1_2624-2724_2663.wav,VTTS_b-1_2624-2724_2663.wav,2850,2519,331
10643,b-3_501-930_833.wav,VTTS_b-3_501-930_833.wav,11560,9079,2481
10644,b-1_4034-4069_4062.wav,VTTS_b-1_4034-4069_4062.wav,3350,3587,-237
10645,b-1_4430-4465_4436.wav,VTTS_b-1_4430-4465_4436.wav,3930,4470,-540
10646,b-3_3279-3363_3327.wav,VTTS_b-3_3279-3363_3327.wav,3450,3495,-45
10647,b-4_2000-5164_4809.wav,VTTS_b-4_2000-5164_4809.wav,2999,3146,-147
10648,b-2_407-508_497.wav,VTTS_b-2_407-508_497.wav,1300,1265,35
10649,b-3_2000-2088_2077.wav,VTTS_b-3_2000-2088_2077.wav,3240,1997,1243
10650,b-4_1401-1505_1472.wav,VTTS_b-4_1401-1505_1472.wav,3930,3796,134
10651,b-3_6016-6115_6105.wav,VTTS_b-3_6016-6115_6105.wav,1630,1649,-19
10652,b-3_4001-4103_4075.wav,VTTS_b-3_4001-4103_4075.wav,3440,3576,-136
10653,b-4_2000-5164_2065.wav,VTTS_b-4_2000-5164_2065.wav,3330,3111,219
10654,b-4_2000-5164_3157.wav,VTTS_b-4_2000-5164_3157.wav,5276,5143,133
10655,b-3_2524-2854_2567.wav,VTTS_b-3_2524-2854_2567.wav,8460,7512,948
10656,b-3_1-97_61.wav,VTTS_b-3_1-97_61.wav,1850,1730,120
10657,b-3_6601-6700_6662.wav,VTTS_b-3_6601-6700_6662.wav,2160,2148,12
10658,b-1_74-174_116.wav,VTTS_b-1_74-174_116.wav,1760,1788,-28
10659,b-1_3127-3227_3197.wav,VTTS_b-1_3127-3227_3197.wav,1500,1765,-265
10660,b-1_1414-1514_1496.wav,VTTS_b-1_1414-1514_1496.wav,1670,1718,-48
10661,b-2_203-304_221.wav,VTTS_b-2_203-304_221.wav,2550,3553,-1003
10662,b-4_2000-5164_4759.wav,VTTS_b-4_2000-5164_4759.wav,6016,6420,-404
10663,b-4_2000-5164_3929.wav,VTTS_b-4_2000-5164_3929.wav,4312,4470,-158
10664,b-3_4207-4314_4314.wav,VTTS_b-3_4207-4314_4314.wav,1640,1591,49
10665,b-1_2018-2118_2025.wav,VTTS_b-1_2018-2118_2025.wav,3390,3367,23
10666,b-4_2000-5164_4558.wav,VTTS_b-4_2000-5164_4558.wav,6861,8127,-1266
10667,b-2_1597-1698_1674.wav,VTTS_b-2_1597-1698_1674.wav,1570,1892,-322
10668,b-1_3935-4033_3946.wav,VTTS_b-1_3935-4033_3946.wav,5410,5550,-140
10669,b-2_2073-2106_2092.wav,VTTS_b-2_2073-2106_2092.wav,1690,2763,-1073
10670,b-3_3025-3111_3056.wav,VTTS_b-3_3025-3111_3056.wav,4100,3866,234
10671,b-4_2000-5164_5142.wav,VTTS_b-4_2000-5164_5142.wav,5056,5654,-598
10672,b-2_815-916_883.wav,VTTS_b-2_815-916_883.wav,2590,2566,24
10673,b-1_1212-1312_1272.wav,VTTS_b-1_1212-1312_1272.wav,5740,5248,492
10674,b-1_4430-4465_4465.wav,VTTS_b-1_4430-4465_4465.wav,3800,5294,-1494
10675,b-3_5009-5427_5308.wav,VTTS_b-3_5009-5427_5308.wav,2860,3065,-205
10676,b-3_6900-7016_6974.wav,VTTS_b-3_6900-7016_6974.wav,5060,5016,44
10677,b-3_1764-1861_1852.wav,VTTS_b-3_1764-1861_1852.wav,4210,4145,65
10678,b-3_2524-2854_2655.wav,VTTS_b-3_2524-2854_2655.wav,8770,7825,945
10679,b-2_2311-2412_2367.wav,VTTS_b-2_2311-2412_2367.wav,1470,1730,-260
10680,b-4_2000-5164_3779.wav,VTTS_b-4_2000-5164_3779.wav,5620,5956,-336
10681,b-1_4034-4069_4050.wav,VTTS_b-1_4034-4069_4050.wav,4980,6269,-1289
10682,b-4_2000-5164_4746.wav,VTTS_b-4_2000-5164_4746.wav,3705,3297,408
10683,b-3_3715-3802_3752.wav,VTTS_b-3_3715-3802_3752.wav,8410,8847,-437
10684,b-3_6701-6800_6792.wav,VTTS_b-3_6701-6800_6792.wav,1780,2461,-681
10685,b-4_2000-5164_2226.wav,VTTS_b-4_2000-5164_2226.wav,2300,2241,59
10686,b-3_1960-2000_1975.wav,VTTS_b-3_1960-2000_1975.wav,4960,4377,583
10687,b-3_3538-3627_3560.wav,VTTS_b-3_3538-3627_3560.wav,2940,3529,-589
10688,b-2_1019-1120_1057.wav,VTTS_b-2_1019-1120_1057.wav,1100,1057,43
10689,b-1_2018-2118_2116.wav,VTTS_b-1_2018-2118_2116.wav,2190,2194,-4
10690,b-4_2000-5164_3241.wav,VTTS_b-4_2000-5164_3241.wav,3728,3216,512
10691,b-1_4070-4105_4074.wav,VTTS_b-1_4070-4105_4074.wav,2700,4261,-1561
10692,b-4_2000-5164_5075.wav,VTTS_b-4_2000-5164_5075.wav,6388,6235,153
10693,b-2_1-100_41.wav,VTTS_b-2_1-100_41.wav,4720,6502,-1782
10694,b-4_2000-5164_3051.wav,VTTS_b-4_2000-5164_3051.wav,6130,6490,-360
10695,b-2_611-712_633.wav,VTTS_b-2_611-712_633.wav,1300,1474,-174
10696,b-1_3026-3126_3055.wav,VTTS_b-1_3026-3126_3055.wav,3880,3704,176
10697,b-4_2000-5164_3452.wav,VTTS_b-4_2000-5164_3452.wav,6122,8591,-2469
10698,b-1_4142-4177_4145.wav,VTTS_b-1_4142-4177_4145.wav,4010,5828,-1818
10699,b-3_6401-6500_6410.wav,VTTS_b-3_6401-6500_6410.wav,6640,6130,510
10700,b-3_1862-1959_1891.wav,VTTS_b-3_1862-1959_1891.wav,3000,3135,-135
10701,b-3_3454-3537_3468.wav,VTTS_b-3_3454-3537_3468.wav,3160,3471,-311
10702,b-3_3538-3627_3559.wav,VTTS_b-3_3538-3627_3559.wav,3890,3680,210
10703,b-3_4498-4605_4554.wav,VTTS_b-3_4498-4605_4554.wav,6110,6444,-334
10704,b-4_2000-5164_3362.wav,VTTS_b-4_2000-5164_3362.wav,3837,3518,319
10705,b-4_2000-5164_4195.wav,VTTS_b-4_2000-5164_4195.wav,4921,5016,-95
10706,b-1_2018-2118_2109.wav,VTTS_b-1_2018-2118_2109.wav,4700,4331,369
10707,b-3_4001-4103_4073.wav,VTTS_b-3_4001-4103_4073.wav,5110,5201,-91
10708,b-3_2524-2854_2688.wav,VTTS_b-3_2524-2854_2688.wav,5520,5027,493
10709,b-2_1019-1120_1021.wav,VTTS_b-2_1019-1120_1021.wav,4400,6351,-1951
10710,b-4_2000-5164_2697.wav,VTTS_b-4_2000-5164_2697.wav,3405,3553,-148
10711,b-4_1707-1813_1807.wav,VTTS_b-4_1707-1813_1807.wav,6660,8127,-1467
10712,b-3_3112-3197_3152.wav,VTTS_b-3_3112-3197_3152.wav,4180,4226,-46
10713,b-3_4607-5008_4953.wav,VTTS_b-3_4607-5008_4953.wav,5510,5294,216
10714,b-3_2943-3024_3003.wav,VTTS_b-3_2943-3024_3003.wav,5860,5550,310
10715,b-3_1321-1568_1393.wav,VTTS_b-3_1321-1568_1393.wav,5640,5224,416
10716,b-4_1014-1100_1043.wav,VTTS_b-4_1014-1100_1043.wav,2490,2543,-53
10717,b-1_3733-3833_3747.wav,VTTS_b-1_3733-3833_3747.wav,4850,4191,659
10718,b-4_1401-1505_1437.wav,VTTS_b-4_1401-1505_1437.wav,3220,2949,271
10719,b-3_5009-5427_5399.wav,VTTS_b-3_5009-5427_5399.wav,4300,4098,202
10720,b-3_2089-2176_2137.wav,VTTS_b-3_2089-2176_2137.wav,2760,3123,-363
10721,b-4_2000-5164_4693.wav,VTTS_b-4_2000-5164_4693.wav,4606,4888,-282
10722,b-1_1111-1211_1112.wav,VTTS_b-1_1111-1211_1112.wav,3540,3158,382
10723,b-3_4607-5008_4998.wav,VTTS_b-3_4607-5008_4998.wav,2650,2728,-78
10724,b-2_1019-1120_1046.wav,VTTS_b-2_1019-1120_1046.wav,2050,2461,-411
10725,b-2_1427-1562_1432.wav,VTTS_b-2_1427-1562_1432.wav,5680,7581,-1901
10726,b-4_2000-5164_2378.wav,VTTS_b-4_2000-5164_2378.wav,2715,2496,219
10727,b-1_4214-4285_4269.wav,VTTS_b-1_4214-4285_4269.wav,4970,5224,-254
10728,b-4_501-1014_653.wav,VTTS_b-4_501-1014_653.wav,4410,4098,312
10729,b-2_1903-2038_1920.wav,VTTS_b-2_1903-2038_1920.wav,3240,3019,221
10730,b-4_53-150_105.wav,VTTS_b-4_53-150_105.wav,8210,6954,1256
10731,b-1_1-73_9.wav,VTTS_b-1_1-73_9.wav,3200,3320,-120
10732,b-4_2000-5164_3586.wav,VTTS_b-4_2000-5164_3586.wav,7311,7338,-27
10733,b-4_2000-5164_3391.wav,VTTS_b-4_2000-5164_3391.wav,2663,2403,260
10734,b-4_2000-5164_2422.wav,VTTS_b-4_2000-5164_2422.wav,4040,4168,-128
10735,b-1_3430-3530_3442.wav,VTTS_b-1_3430-3530_3442.wav,3160,3332,-172
10736,b-1_3228-3328_3255.wav,VTTS_b-1_3228-3328_3255.wav,2130,2496,-366
10737,b-2_2040-2072_2052.wav,VTTS_b-2_2040-2072_2052.wav,1700,1916,-216
10738,b-3_4607-5008_4895.wav,VTTS_b-3_4607-5008_4895.wav,5500,5294,206
10739,b-1_1212-1312_1258.wav,VTTS_b-1_1212-1312_1258.wav,2990,2519,471
10740,b-1_3026-3126_3091.wav,VTTS_b-1_3026-3126_3091.wav,2290,1939,351
10741,b-2_1801-1902_1817.wav,VTTS_b-2_1801-1902_1817.wav,2720,2125,595
10742,b-4_501-1014_886.wav,VTTS_b-4_501-1014_886.wav,2400,2241,159
10743,b-3_3889-4000_3928.wav,VTTS_b-3_3889-4000_3928.wav,5420,5724,-304
10744,b-1_3026-3126_3070.wav,VTTS_b-1_3026-3126_3070.wav,2610,2206,404
10745,b-1_3632-3732_3641.wav,VTTS_b-1_3632-3732_3641.wav,1060,1022,38
10746,b-4_1506-1600_1559.wav,VTTS_b-4_1506-1600_1559.wav,6460,6513,-53
10747,b-2_1699-1800_1794.wav,VTTS_b-2_1699-1800_1794.wav,4020,2984,1036
10748,b-3_2267-2349_2280.wav,VTTS_b-3_2267-2349_2280.wav,4540,4063,477
10749,b-1_2422-2522_2462.wav,VTTS_b-1_2422-2522_2462.wav,2250,2229,21
10750,b-3_4425-4497_4461.wav,VTTS_b-3_4425-4497_4461.wav,4760,4528,232
10751,b-4_1506-1600_1531.wav,VTTS_b-4_1506-1600_1531.wav,1110,964,146
10752,b-3_4607-5008_4894.wav,VTTS_b-3_4607-5008_4894.wav,4240,2984,1256
10753,b-3_1079-1320_1158.wav,VTTS_b-3_1079-1320_1158.wav,5110,6002,-892
10754,b-2_1699-1800_1734.wav,VTTS_b-2_1699-1800_1734.wav,2660,2786,-126
10755,b-3_3889-4000_3973.wav,VTTS_b-3_3889-4000_3973.wav,2710,2647,63
10756,b-3_3112-3197_3157.wav,VTTS_b-3_3112-3197_3157.wav,6120,6118,2
10757,b-4_2000-5164_4911.wav,VTTS_b-4_2000-5164_4911.wav,3831,3796,35
10758,b-2_2413-2500_2486.wav,VTTS_b-2_2413-2500_2486.wav,1190,1115,75
10759,b-3_4607-5008_4959.wav,VTTS_b-3_4607-5008_4959.wav,3440,4389,-949
10760,b-2_611-712_638.wav,VTTS_b-2_611-712_638.wav,2620,2009,611
10761,b-2_101-202_122.wav,VTTS_b-2_101-202_122.wav,2910,3204,-294
10762,b-4_501-1014_572.wav,VTTS_b-4_501-1014_572.wav,1820,1718,102
10763,b-4_2000-5164_4291.wav,VTTS_b-4_2000-5164_4291.wav,5315,7941,-2626
10764,b-4_1506-1600_1521.wav,VTTS_b-4_1506-1600_1521.wav,4030,4957,-927
10765,b-3_1079-1320_1094.wav,VTTS_b-3_1079-1320_1094.wav,2560,2786,-226
10766,b-3_2434-2523_2492.wav,VTTS_b-3_2434-2523_2492.wav,2900,2635,265
10767,b-3_5853-5956_5906.wav,VTTS_b-3_5853-5956_5906.wav,2580,2937,-357
10768,b-4_501-1014_554.wav,VTTS_b-4_501-1014_554.wav,4310,4354,-44
10769,b-1_1414-1514_1484.wav,VTTS_b-1_1414-1514_1484.wav,3560,7465,-3905
10770,b-4_2000-5164_3176.wav,VTTS_b-4_2000-5164_3176.wav,2835,2450,385
10771,b-4_401-500_428.wav,VTTS_b-4_401-500_428.wav,4840,4423,417
10772,b-4_53-150_60.wav,VTTS_b-4_53-150_60.wav,8470,9242,-772
10773,b-3_4607-5008_4936.wav,VTTS_b-3_4607-5008_4936.wav,3060,3344,-284
10774,b-3_2434-2523_2459.wav,VTTS_b-3_2434-2523_2459.wav,4310,4261,49
10775,b-4_2000-5164_3438.wav,VTTS_b-4_2000-5164_3438.wav,3341,4005,-664
10776,b-3_501-930_685.wav,VTTS_b-3_501-930_685.wav,4590,4272,318
10777,b-3_1666-1763_1695.wav,VTTS_b-3_1666-1763_1695.wav,6540,6130,410
10778,b-4_2000-5164_4978.wav,VTTS_b-4_2000-5164_4978.wav,3554,3286,268
10779,b-1_2220-2320_2313.wav,VTTS_b-1_2220-2320_2313.wav,1070,917,153
10780,b-3_1321-1568_1569.wav,VTTS_b-3_1321-1568_1569.wav,3310,3320,-10
10781,b-3_1079-1320_1178.wav,VTTS_b-3_1079-1320_1178.wav,5770,5306,464
10782,b-3_5009-5427_5201.wav,VTTS_b-3_5009-5427_5201.wav,2800,2891,-91
10783,b-4_2000-5164_3439.wav,VTTS_b-4_2000-5164_3439.wav,5918,6641,-723
10784,b-3_3364-3453_3404.wav,VTTS_b-3_3364-3453_3404.wav,9260,8394,866
10785,b-3_5853-5956_5896.wav,VTTS_b-3_5853-5956_5896.wav,1750,1173,577
10786,b-4_151-300_294.wav,VTTS_b-4_151-300_294.wav,1300,1347,-47
10787,b-1_377-477_437.wav,VTTS_b-1_377-477_437.wav,2960,3053,-93
10788,b-3_6601-6700_6651.wav,VTTS_b-3_6601-6700_6651.wav,3850,3913,-63
10789,b-2_1801-1902_1882.wav,VTTS_b-2_1801-1902_1882.wav,4770,6653,-1883
10790,b-4_2000-5164_4348.wav,VTTS_b-4_2000-5164_4348.wav,8230,8150,80
10791,b-4_2000-5164_2512.wav,VTTS_b-4_2000-5164_2512.wav,7925,8046,-121
10792,b-2_509-610_520.wav,VTTS_b-2_509-610_520.wav,3320,3053,267
10793,b-3_6401-6500_6432.wav,VTTS_b-3_6401-6500_6432.wav,5030,5074,-44
10794,b-3_3364-3453_3427.wav,VTTS_b-3_3364-3453_3427.wav,2260,2078,182
10795,b-2_1903-2038_1972.wav,VTTS_b-2_1903-2038_1972.wav,2640,1300,1340
10796,b-3_501-930_773.wav,VTTS_b-3_501-930_773.wav,6220,6235,-15
10797,b-4_151-300_188.wav,VTTS_b-4_151-300_188.wav,3390,3228,162
10798,b-2_1427-1562_1439.wav,VTTS_b-2_1427-1562_1439.wav,4190,3808,382
10799,b-1_3430-3530_3467.wav,VTTS_b-1_3430-3530_3467.wav,5640,6316,-676
10800,b-3_5639-5744_5724.wav,VTTS_b-3_5639-5744_5724.wav,9700,9300,400
10801,b-3_3112-3197_3148.wav,VTTS_b-3_3112-3197_3148.wav,1950,1904,46
10802,b-2_305-406_370.wav,VTTS_b-2_305-406_370.wav,1960,1950,10
10803,b-3_2434-2523_2455.wav,VTTS_b-3_2434-2523_2455.wav,6770,5828,942
10804,b-3_501-930_607.wav,VTTS_b-3_501-930_607.wav,7410,7570,-160
10805,b-1_377-477_444.wav,VTTS_b-1_377-477_444.wav,4810,5642,-832
10806,b-3_2177-2266_2243.wav,VTTS_b-3_2177-2266_2243.wav,3950,4040,-90
10807,b-3_3454-3537_3517.wav,VTTS_b-3_3454-3537_3517.wav,3570,3425,145
10808,b-4_2000-5164_2398.wav,VTTS_b-4_2000-5164_2398.wav,4125,4342,-217
10809,b-4_2000-5164_4063.wav,VTTS_b-4_2000-5164_4063.wav,5379,6293,-914
10810,b-3_1079-1320_1140.wav,VTTS_b-3_1079-1320_1140.wav,3990,11610,-7620
10811,b-3_3198-3278_3201.wav,VTTS_b-3_3198-3278_3201.wav,2510,2496,14
10812,b-1_1010-1110_1069.wav,VTTS_b-1_1010-1110_1069.wav,1650,1474,176
10813,b-2_1-100_29.wav,VTTS_b-2_1-100_29.wav,1290,1358,-68
10814,b-1_3733-3833_3813.wav,VTTS_b-1_3733-3833_3813.wav,1940,2101,-161
10815,b-2_101-202_175.wav,VTTS_b-2_101-202_175.wav,1280,1219,61
10816,b-2_305-406_343.wav,VTTS_b-2_305-406_343.wav,1760,2310,-550
10817,b-2_1903-2038_2031.wav,VTTS_b-2_1903-2038_2031.wav,1670,1811,-141
10818,b-1_2119-2219_2195.wav,VTTS_b-1_2119-2219_2195.wav,2870,3587,-717
10819,b-3_5957-6015_5962.wav,VTTS_b-3_5957-6015_5962.wav,8490,7605,885
10820,b-4_1601-1706_1631.wav,VTTS_b-4_1601-1706_1631.wav,3370,2879,491
10821,b-3_4104-4206_4109.wav,VTTS_b-3_4104-4206_4109.wav,3410,3204,206
10822,b-1_1818-1918_1871.wav,VTTS_b-1_1818-1918_1871.wav,1670,1521,149
10823,b-3_3112-3197_3138.wav,VTTS_b-3_3112-3197_3138.wav,6340,5747,593
10824,b-3_2434-2523_2477.wav,VTTS_b-3_2434-2523_2477.wav,6870,6316,554
10825,b-1_3430-3530_3508.wav,VTTS_b-1_3430-3530_3508.wav,1210,1057,153
10826,b-3_3454-3537_3462.wav,VTTS_b-3_3454-3537_3462.wav,6170,5561,609
10827,b-1_794-1009_981.wav,VTTS_b-1_794-1009_981.wav,2790,3286,-496
10828,b-1_579-649_595.wav,VTTS_b-1_579-649_595.wav,3160,3541,-381
10829,b-4_2000-5164_3495.wav,VTTS_b-4_2000-5164_3495.wav,4937,4493,444
10830,b-1_794-1009_871.wav,VTTS_b-1_794-1009_871.wav,1890,1834,56
10831,b-1_794-1009_843.wav,VTTS_b-1_794-1009_843.wav,3700,11610,-7910
10832,b-3_5428-5533_5438.wav,VTTS_b-3_5428-5533_5438.wav,2710,2914,-204
10833,b-2_305-406_366.wav,VTTS_b-2_305-406_366.wav,1910,1811,99
10834,b-3_98-195_181.wav,VTTS_b-3_98-195_181.wav,5280,5248,32
10835,b-3_2524-2854_2557.wav,VTTS_b-3_2524-2854_2557.wav,8870,9532,-662
10836,b-3_4498-4605_4562.wav,VTTS_b-3_4498-4605_4562.wav,1400,1126,274
10837,b-2_509-610_553.wav,VTTS_b-2_509-610_553.wav,1580,1474,106
10838,b-3_1-97_78.wav,VTTS_b-3_1-97_78.wav,11320,11610,-290
10839,b-4_2000-5164_2894.wav,VTTS_b-4_2000-5164_2894.wav,830,859,-29
10840,b-4_501-1014_559.wav,VTTS_b-4_501-1014_559.wav,3040,2786,254
10841,b-4_401-500_440.wav,VTTS_b-4_401-500_440.wav,3170,3320,-150
10842,b-4_1601-1706_1670.wav,VTTS_b-4_1601-1706_1670.wav,5510,4923,587
10843,b-4_2000-5164_3754.wav,VTTS_b-4_2000-5164_3754.wav,5680,6316,-636
10844,b-1_2624-2724_2692.wav,VTTS_b-1_2624-2724_2692.wav,1540,1440,100
10845,b-4_2000-5164_2841.wav,VTTS_b-4_2000-5164_2841.wav,4315,3936,379
10846,b-1_1717-1817_1764.wav,VTTS_b-1_1717-1817_1764.wav,1700,1800,-100
10847,b-3_6701-6800_6747.wav,VTTS_b-3_6701-6800_6747.wav,6270,6478,-208
10848,b-1_4358-4393_4372.wav,VTTS_b-1_4358-4393_4372.wav,2540,3158,-618
10849,b-2_1801-1902_1873.wav,VTTS_b-2_1801-1902_1873.wav,2590,2508,82
10850,b-1_1616-1716_1687.wav,VTTS_b-1_1616-1716_1687.wav,1520,1358,162
10851,b-2_1121-1222_1214.wav,VTTS_b-2_1121-1222_1214.wav,1910,1985,-75
10852,b-1_74-174_111.wav,VTTS_b-1_74-174_111.wav,5160,4586,574
10853,b-4_301-400_357.wav,VTTS_b-4_301-400_357.wav,4710,3646,1064
10854,b-2_1325-1426_1410.wav,VTTS_b-2_1325-1426_1410.wav,3540,2879,661
10855,b-3_5853-5956_5939.wav,VTTS_b-3_5853-5956_5939.wav,1450,1335,115
10856,b-1_1212-1312_1286.wav,VTTS_b-1_1212-1312_1286.wav,4910,4830,80
10857,b-3_4607-5008_4804.wav,VTTS_b-3_4607-5008_4804.wav,3150,3100,50
10858,b-2_1223-1324_1249.wav,VTTS_b-2_1223-1324_1249.wav,1550,1614,-64
10859,b-4_1506-1600_1537.wav,VTTS_b-4_1506-1600_1537.wav,7170,6385,785
10860,b-1_3834-3934_3869.wav,VTTS_b-1_3834-3934_3869.wav,2990,3123,-133
10861,b-3_294-391_387.wav,VTTS_b-3_294-391_387.wav,12380,11610,770
10862,b-1_2119-2219_2152.wav,VTTS_b-1_2119-2219_2152.wav,1530,1544,-14
10863,b-3_294-391_305.wav,VTTS_b-3_294-391_305.wav,2020,2148,-128
10864,b-1_276-376_331.wav,VTTS_b-1_276-376_331.wav,1410,1184,226
10865,b-3_1764-1861_1778.wav,VTTS_b-3_1764-1861_1778.wav,8530,8382,148
10866,b-4_1401-1505_1412.wav,VTTS_b-4_1401-1505_1412.wav,4520,4621,-101
10867,b-3_1568-1665_1598.wav,VTTS_b-3_1568-1665_1598.wav,8200,8255,-55
10868,b-3_2524-2854_2663.wav,VTTS_b-3_2524-2854_2663.wav,4590,5944,-1354
10869,b-3_1079-1320_1208.wav,VTTS_b-3_1079-1320_1208.wav,5050,4679,371
10870,b-3_5533-5638_5561.wav,VTTS_b-3_5533-5638_5561.wav,3630,3309,321
10871,b-4_2000-5164_3279.wav,VTTS_b-4_2000-5164_3279.wav,7751,7384,367
10872,b-4_2000-5164_3641.wav,VTTS_b-4_2000-5164_3641.wav,7782,8359,-577
10873,b-1_2220-2320_2255.wav,VTTS_b-1_2220-2320_2255.wav,1810,1602,208
10874,b-4_2000-5164_2341.wav,VTTS_b-4_2000-5164_2341.wav,10860,11610,-750
10875,b-1_4214-4285_4268.wav,VTTS_b-1_4214-4285_4268.wav,2730,2624,106
10876,b-4_2000-5164_3457.wav,VTTS_b-4_2000-5164_3457.wav,4122,4458,-336
10877,b-4_151-300_287.wav,VTTS_b-4_151-300_287.wav,4140,3576,564
10878,b-4_2000-5164_2022.wav,VTTS_b-4_2000-5164_2022.wav,2465,2635,-170
10879,b-1_4034-4069_4064.wav,VTTS_b-1_4034-4069_4064.wav,3960,4145,-185
10880,b-1_1717-1817_1801.wav,VTTS_b-1_1717-1817_1801.wav,4310,6653,-2343
10881,b-2_815-916_891.wav,VTTS_b-2_815-916_891.wav,1060,1509,-449
10882,b-1_3632-3732_3726.wav,VTTS_b-1_3632-3732_3726.wav,1270,1231,39
10883,b-4_2000-5164_5039.wav,VTTS_b-4_2000-5164_5039.wav,2666,2670,-4
10884,b-4_151-300_165.wav,VTTS_b-4_151-300_165.wav,9790,11192,-1402
10885,b-1_3430-3530_3470.wav,VTTS_b-1_3430-3530_3470.wav,1480,1265,215
10886,b-1_1-73_73.wav,VTTS_b-1_1-73_73.wav,3990,5190,-1200
10887,b-3_4607-5008_4931.wav,VTTS_b-3_4607-5008_4931.wav,5450,6235,-785
10888,b-3_4207-4314_4253.wav,VTTS_b-3_4207-4314_4253.wav,3210,3123,87
10889,b-3_4607-5008_4618.wav,VTTS_b-3_4607-5008_4618.wav,3760,4145,-385
10890,b-3_98-195_107.wav,VTTS_b-3_98-195_107.wav,4470,4656,-186
10891,b-1_3026-3126_3122.wav,VTTS_b-1_3026-3126_3122.wav,3340,3146,194
10892,b-1_3733-3833_3808.wav,VTTS_b-1_3733-3833_3808.wav,1450,1556,-106
10893,b-3_5428-5533_5525.wav,VTTS_b-3_5428-5533_5525.wav,1570,1474,96
10894,b-1_1818-1918_1868.wav,VTTS_b-1_1818-1918_1868.wav,1010,1045,-35
10895,b-3_4315-4424_4410.wav,VTTS_b-3_4315-4424_4410.wav,3000,2647,353
10896,b-3_6900-7016_6908.wav,VTTS_b-3_6900-7016_6908.wav,10360,9741,619
10897,b-1_3733-3833_3830.wav,VTTS_b-1_3733-3833_3830.wav,3200,2647,553
10898,b-2_2209-2310_2217.wav,VTTS_b-2_2209-2310_2217.wav,1270,1184,86
10899,b-3_501-930_819.wav,VTTS_b-3_501-930_819.wav,9690,9149,541
10900,b-4_2000-5164_2692.wav,VTTS_b-4_2000-5164_2692.wav,8617,9555,-938
10901,b-1_4466-4498_4481.wav,VTTS_b-1_4466-4498_4481.wav,2740,2682,58
10902,b-3_6701-6800_6701.wav,VTTS_b-3_6701-6800_6701.wav,3690,4191,-501
10903,b-1_650-685_675.wav,VTTS_b-1_650-685_675.wav,1020,1138,-118
10904,b-4_1601-1706_1702.wav,VTTS_b-4_1601-1706_1702.wav,7290,6432,858
10905,b-4_1901-2000_1903.wav,VTTS_b-4_1901-2000_1903.wav,3390,3413,-23
10906,b-2_1597-1698_1664.wav,VTTS_b-2_1597-1698_1664.wav,7750,7314,436
10907,b-2_101-202_153.wav,VTTS_b-2_101-202_153.wav,3610,3947,-337
10908,b-3_980-1077_1012.wav,VTTS_b-3_980-1077_1012.wav,3820,3495,325
10909,b-1_1313-1413_1408.wav,VTTS_b-1_1313-1413_1408.wav,1480,1416,64
10910,b-1_175-275_216.wav,VTTS_b-1_175-275_216.wav,1960,1776,184
10911,b-3_196-293_287.wav,VTTS_b-3_196-293_287.wav,9430,9636,-206
10912,b-2_203-304_229.wav,VTTS_b-2_203-304_229.wav,3810,4284,-474
10913,b-4_2000-5164_3076.wav,VTTS_b-4_2000-5164_3076.wav,3571,3367,204
10914,b-2_815-916_859.wav,VTTS_b-2_815-916_859.wav,2390,2612,-222
10915,b-4_2000-5164_2028.wav,VTTS_b-4_2000-5164_2028.wav,5550,5921,-371
10916,b-3_3364-3453_3430.wav,VTTS_b-3_3364-3453_3430.wav,3330,3495,-165
10917,b-3_5009-5427_5145.wav,VTTS_b-3_5009-5427_5145.wav,5500,6130,-630
10918,b-4_53-150_121.wav,VTTS_b-4_53-150_121.wav,6640,6606,34
10919,b-4_2000-5164_2638.wav,VTTS_b-4_2000-5164_2638.wav,3780,3773,7
10920,b-3_4607-5008_4756.wav,VTTS_b-3_4607-5008_4756.wav,4130,4528,-398
10921,b-1_377-477_435.wav,VTTS_b-1_377-477_435.wav,2290,2287,3
10922,b-2_611-712_651.wav,VTTS_b-2_611-712_651.wav,1410,2473,-1063
10923,b-3_5745-5852_5807.wav,VTTS_b-3_5745-5852_5807.wav,6500,6757,-257
10924,b-3_1079-1320_1309.wav,VTTS_b-3_1079-1320_1309.wav,6220,6200,20
10925,b-1_1010-1110_1112.wav,VTTS_b-1_1010-1110_1112.wav,4200,2461,1739
10926,b-2_1019-1120_1083.wav,VTTS_b-2_1019-1120_1083.wav,5880,7895,-2015
10927,b-3_5428-5533_5533.wav,VTTS_b-3_5428-5533_5533.wav,8280,8185,95
10928,b-3_2350-2433_2384.wav,VTTS_b-3_2350-2433_2384.wav,3850,4029,-179
10929,b-1_4178-4213_4201.wav,VTTS_b-1_4178-4213_4201.wav,2730,3773,-1043
10930,b-2_203-304_275.wav,VTTS_b-2_203-304_275.wav,4110,6304,-2194
10931,b-4_2000-5164_4706.wav,VTTS_b-4_2000-5164_4706.wav,7833,7047,786
10932,b-4_2000-5164_4618.wav,VTTS_b-4_2000-5164_4618.wav,4097,3808,289
10933,b-1_2220-2320_2227.wav,VTTS_b-1_2220-2320_2227.wav,1710,1649,61
10934,b-4_501-1014_759.wav,VTTS_b-4_501-1014_759.wav,4890,4865,25
10935,b-1_650-685_664.wav,VTTS_b-1_650-685_664.wav,3110,2334,776
10936,b-2_1121-1222_1133.wav,VTTS_b-2_1121-1222_1133.wav,1630,4029,-2399
10937,b-3_5009-5427_5279.wav,VTTS_b-3_5009-5427_5279.wav,4840,4621,219
10938,b-2_1801-1902_1869.wav,VTTS_b-2_1801-1902_1869.wav,2070,1695,375
10939,b-3_2350-2433_2405.wav,VTTS_b-3_2350-2433_2405.wav,5300,5074,226
10940,b-3_1079-1320_1194.wav,VTTS_b-3_1079-1320_1194.wav,5700,6211,-511
10941,b-3_1321-1568_1391.wav,VTTS_b-3_1321-1568_1391.wav,10210,11552,-1342
10942,b-3_1321-1568_1381.wav,VTTS_b-3_1321-1568_1381.wav,2150,2299,-149
10943,b-2_815-916_853.wav,VTTS_b-2_815-916_853.wav,2470,2450,20
10944,b-4_2000-5164_2372.wav,VTTS_b-4_2000-5164_2372.wav,5800,5759,41
10945,b-1_3531-3631_3607.wav,VTTS_b-1_3531-3631_3607.wav,2490,3007,-517
10946,b-3_294-391_389.wav,VTTS_b-3_294-391_389.wav,10750,11610,-860
10947,b-4_1506-1600_1572.wav,VTTS_b-4_1506-1600_1572.wav,1950,1834,116
10948,b-4_53-150_136.wav,VTTS_b-4_53-150_136.wav,8110,9903,-1793
10949,b-4_2000-5164_4014.wav,VTTS_b-4_2000-5164_4014.wav,1713,1451,262
10950,b-3_2855-2942_2864.wav,VTTS_b-3_2855-2942_2864.wav,7900,7964,-64
10951,b-2_1223-1324_1242.wav,VTTS_b-2_1223-1324_1242.wav,3850,4992,-1142
10952,b-3_1764-1861_1825.wav,VTTS_b-3_1764-1861_1825.wav,5160,5085,75
10953,b-3_501-930_826.wav,VTTS_b-3_501-930_826.wav,3500,3274,226
10954,b-4_2000-5164_5020.wav,VTTS_b-4_2000-5164_5020.wav,4397,4238,159
10955,b-4_1101-1220_1133.wav,VTTS_b-4_1101-1220_1133.wav,3060,2972,88
10956,b-4_2000-5164_4434.wav,VTTS_b-4_2000-5164_4434.wav,1231,1161,70
10957,b-3_501-930_501.wav,VTTS_b-3_501-930_501.wav,2800,2577,223
10958,b-3_4315-4424_4420.wav,VTTS_b-3_4315-4424_4420.wav,4670,4342,328
10959,b-3_6601-6700_6646.wav,VTTS_b-3_6601-6700_6646.wav,5070,5004,66
10960,b-4_1101-1220_1145.wav,VTTS_b-4_1101-1220_1145.wav,7360,7384,-24
10961,b-1_3531-3631_3624.wav,VTTS_b-1_3531-3631_3624.wav,1870,1846,24
10962,b-4_301-400_311.wav,VTTS_b-4_301-400_311.wav,5540,4969,571
10963,b-2_1-100_15.wav,VTTS_b-2_1-100_15.wav,3030,2566,464
10964,b-3_2524-2854_2565.wav,VTTS_b-3_2524-2854_2565.wav,4630,4911,-281
10965,b-1_478-578_537.wav,VTTS_b-1_478-578_537.wav,4460,4702,-242
10966,b-4_2000-5164_3354.wav,VTTS_b-4_2000-5164_3354.wav,5388,5666,-278
10967,b-2_1427-1562_1551.wav,VTTS_b-2_1427-1562_1551.wav,1590,1591,-1
10968,b-4_1301-1400_1313.wav,VTTS_b-4_1301-1400_1313.wav,7730,7070,660
10969,b-3_5009-5427_5385.wav,VTTS_b-3_5009-5427_5385.wav,3650,4133,-483
10970,b-3_501-930_885.wav,VTTS_b-3_501-930_885.wav,2960,2496,464
10971,b-3_3279-3363_3321.wav,VTTS_b-3_3279-3363_3321.wav,8290,7895,395
10972,b-4_2000-5164_3204.wav,VTTS_b-4_2000-5164_3204.wav,3383,3762,-379
10973,b-3_4001-4103_4072.wav,VTTS_b-3_4001-4103_4072.wav,6710,8940,-2230
10974,b-2_917-1018_944.wav,VTTS_b-2_917-1018_944.wav,2480,2670,-190
10975,b-1_2624-2724_2704.wav,VTTS_b-1_2624-2724_2704.wav,2240,2496,-256
10976,b-1_2927-3025_2965.wav,VTTS_b-1_2927-3025_2965.wav,1990,2067,-77
10977,b-3_1568-1665_1645.wav,VTTS_b-3_1568-1665_1645.wav,1090,1068,22
10978,b-4_2000-5164_4144.wav,VTTS_b-4_2000-5164_4144.wav,4547,4505,42
10979,b-4_1221-1300_1293.wav,VTTS_b-4_1221-1300_1293.wav,6240,7430,-1190
10980,b-2_2311-2412_2312.wav,VTTS_b-2_2311-2412_2312.wav,2160,2357,-197
10981,b-3_2350-2433_2404.wav,VTTS_b-3_2350-2433_2404.wav,4080,7953,-3873
10982,b-4_2000-5164_2351.wav,VTTS_b-4_2000-5164_2351.wav,3525,4052,-527
10983,b-4_2000-5164_2347.wav,VTTS_b-4_2000-5164_2347.wav,15175,11610,3565
10984,b-1_3329-3429_3404.wav,VTTS_b-1_3329-3429_3404.wav,1570,1567,3
10985,b-3_1666-1763_1686.wav,VTTS_b-3_1666-1763_1686.wav,4790,4609,181
10986,b-4_2000-5164_4381.wav,VTTS_b-4_2000-5164_4381.wav,3911,4040,-129
10987,b-3_4607-5008_4788.wav,VTTS_b-3_4607-5008_4788.wav,3130,3332,-202
10988,b-1_3733-3833_3783.wav,VTTS_b-1_3733-3833_3783.wav,2230,2287,-57
10989,b-1_175-275_248.wav,VTTS_b-1_175-275_248.wav,1400,1463,-63
10990,b-1_4070-4105_4082.wav,VTTS_b-1_4070-4105_4082.wav,1900,1440,460
10991,b-3_2089-2176_2099.wav,VTTS_b-3_2089-2176_2099.wav,4210,4365,-155
10992,b-4_501-1014_688.wav,VTTS_b-4_501-1014_688.wav,7710,7384,326
10993,b-3_4001-4103_4001.wav,VTTS_b-3_4001-4103_4001.wav,3150,3901,-751
10994,b-1_2422-2522_2505.wav,VTTS_b-1_2422-2522_2505.wav,4900,4377,523
10995,b-3_3025-3111_3033.wav,VTTS_b-3_3025-3111_3033.wav,4890,4644,246
10996,b-1_686-793_725.wav,VTTS_b-1_686-793_725.wav,1430,1440,-10
10997,b-4_1707-1813_1758.wav,VTTS_b-4_1707-1813_1758.wav,1600,1625,-25
10998,b-1_2321-2421_2368.wav,VTTS_b-1_2321-2421_2368.wav,1160,1184,-24
10999,b-4_2000-5164_2085.wav,VTTS_b-4_2000-5164_2085.wav,3640,2902,738
11000,b-1_175-275_210.wav,VTTS_b-1_175-275_210.wav,4940,1579,3361
11001,b-2_305-406_354.wav,VTTS_b-2_305-406_354.wav,3590,4238,-648
11002,b-4_2000-5164_2719.wav,VTTS_b-4_2000-5164_2719.wav,1455,1416,39
11003,b-2_2311-2412_2375.wav,VTTS_b-2_2311-2412_2375.wav,1880,1602,278
11004,b-1_1515-1615_1581.wav,VTTS_b-1_1515-1615_1581.wav,3670,11610,-7940
11005,b-2_917-1018_925.wav,VTTS_b-2_917-1018_925.wav,3900,5608,-1708
11006,b-1_2321-2421_2341.wav,VTTS_b-1_2321-2421_2341.wav,1070,813,257
11007,b-4_2000-5164_3169.wav,VTTS_b-4_2000-5164_3169.wav,1572,1428,144
11008,b-3_501-930_571.wav,VTTS_b-3_501-930_571.wav,5090,4853,237
11009,b-3_501-930_818.wav,VTTS_b-3_501-930_818.wav,5110,4632,478
11010,b-4_301-400_350.wav,VTTS_b-4_301-400_350.wav,7360,7605,-245
11011,b-2_2107-2193_2118.wav,VTTS_b-2_2107-2193_2118.wav,1150,1138,12
11012,b-3_3889-4000_3977.wav,VTTS_b-3_3889-4000_3977.wav,3800,3820,-20
11013,b-1_4394-4429_4412.wav,VTTS_b-1_4394-4429_4412.wav,2740,3657,-917
11014,b-4_501-1014_526.wav,VTTS_b-4_501-1014_526.wav,4770,4284,486
11015,b-2_1019-1120_1038.wav,VTTS_b-2_1019-1120_1038.wav,3710,4029,-319
11016,b-1_1212-1312_1266.wav,VTTS_b-1_1212-1312_1266.wav,5420,4865,555
11017,b-1_3531-3631_3542.wav,VTTS_b-1_3531-3631_3542.wav,4880,5062,-182
11018,b-1_1919-2017_1942.wav,VTTS_b-1_1919-2017_1942.wav,2530,2728,-198
11019,b-3_4001-4103_4079.wav,VTTS_b-3_4001-4103_4079.wav,2620,3274,-654
11020,b-4_2000-5164_3986.wav,VTTS_b-4_2000-5164_3986.wav,3540,3587,-47
11021,b-2_101-202_145.wav,VTTS_b-2_101-202_145.wav,1330,1521,-191
11022,b-3_1-97_41.wav,VTTS_b-3_1-97_41.wav,3820,4075,-255
11023,b-3_3628-3714_3661.wav,VTTS_b-3_3628-3714_3661.wav,6050,6362,-312
11024,b-4_501-1014_788.wav,VTTS_b-4_501-1014_788.wav,4730,4319,411
11025,b-4_2000-5164_3531.wav,VTTS_b-4_2000-5164_3531.wav,6405,6560,-155
11026,b-4_2000-5164_3253.wav,VTTS_b-4_2000-5164_3253.wav,5763,6606,-843
11027,b-3_1666-1763_1699.wav,VTTS_b-3_1666-1763_1699.wav,2790,4447,-1657
11028,b-4_2000-5164_4824.wav,VTTS_b-4_2000-5164_4824.wav,9379,10217,-838
11029,b-1_686-793_686.wav,VTTS_b-1_686-793_686.wav,3250,2949,301
11030,b-3_6401-6500_6418.wav,VTTS_b-3_6401-6500_6418.wav,6340,6327,13
11031,b-2_509-610_575.wav,VTTS_b-2_509-610_575.wav,5220,5538,-318
11032,b-3_2524-2854_2619.wav,VTTS_b-3_2524-2854_2619.wav,5070,4795,275
11033,b-2_611-712_666.wav,VTTS_b-2_611-712_666.wav,2960,2380,580
11034,b-3_6217-6274_6223.wav,VTTS_b-3_6217-6274_6223.wav,5540,5283,257
11035,b-2_1223-1324_1239.wav,VTTS_b-2_1223-1324_1239.wav,3140,2914,226
11036,b-1_794-1009_942.wav,VTTS_b-1_794-1009_942.wav,3760,3843,-83
11037,b-3_2267-2349_2290.wav,VTTS_b-3_2267-2349_2290.wav,10650,11610,-960
11038,b-3_501-930_688.wav,VTTS_b-3_501-930_688.wav,2050,2229,-179
11039,b-1_3531-3631_3623.wav,VTTS_b-1_3531-3631_3623.wav,1890,1579,311
11040,b-4_1101-1220_1105.wav,VTTS_b-4_1101-1220_1105.wav,3930,3924,6
11041,b-4_2000-5164_3224.wav,VTTS_b-4_2000-5164_3224.wav,6277,11610,-5333
11042,b-4_2000-5164_3549.wav,VTTS_b-4_2000-5164_3549.wav,5550,5735,-185
11043,b-4_2000-5164_4075.wav,VTTS_b-4_2000-5164_4075.wav,4723,4458,265
11044,b-4_1101-1220_1147.wav,VTTS_b-4_1101-1220_1147.wav,4790,7593,-2803
11045,b-2_2413-2500_2478.wav,VTTS_b-2_2413-2500_2478.wav,1940,1939,1
11046,b-1_3531-3631_3587.wav,VTTS_b-1_3531-3631_3587.wav,2030,2055,-25
11047,b-1_794-1009_873.wav,VTTS_b-1_794-1009_873.wav,3420,3274,146
11048,b-3_501-930_875.wav,VTTS_b-3_501-930_875.wav,9730,11610,-1880
11049,b-4_501-1014_711.wav,VTTS_b-4_501-1014_711.wav,4950,6978,-2028
11050,b-4_501-1014_534.wav,VTTS_b-4_501-1014_534.wav,5100,4853,247
11051,b-3_501-930_603.wav,VTTS_b-3_501-930_603.wav,10050,9822,228
11052,b-3_3364-3453_3376.wav,VTTS_b-3_3364-3453_3376.wav,3620,3796,-176
11053,b-1_1-73_2.wav,VTTS_b-1_1-73_2.wav,2270,1927,343
11054,b-4_2000-5164_4223.wav,VTTS_b-4_2000-5164_4223.wav,2322,2125,197
11055,b-4_1101-1220_1151.wav,VTTS_b-4_1101-1220_1151.wav,10910,11111,-201
11056,b-4_2000-5164_2327.wav,VTTS_b-4_2000-5164_2327.wav,3160,2844,316
11057,b-1_2422-2522_2426.wav,VTTS_b-1_2422-2522_2426.wav,1870,1788,82
11058,b-4_2000-5164_3396.wav,VTTS_b-4_2000-5164_3396.wav,3813,3831,-18
11059,b-3_2524-2854_2529.wav,VTTS_b-3_2524-2854_2529.wav,5190,5027,163
11060,b-1_74-174_81.wav,VTTS_b-1_74-174_81.wav,1870,1533,337
11061,b-1_3632-3732_3678.wav,VTTS_b-1_3632-3732_3678.wav,1640,1730,-90
11062,b-4_1707-1813_1782.wav,VTTS_b-4_1707-1813_1782.wav,1910,1950,-40
11063,b-2_2413-2500_2480.wav,VTTS_b-2_2413-2500_2480.wav,2010,1765,245
11064,b-3_2350-2433_2375.wav,VTTS_b-3_2350-2433_2375.wav,5490,5596,-106
11065,b-3_3364-3453_3440.wav,VTTS_b-3_3364-3453_3440.wav,5610,5642,-32
11066,b-4_2000-5164_3751.wav,VTTS_b-4_2000-5164_3751.wav,7320,6037,1283
11067,b-1_2119-2219_2153.wav,VTTS_b-1_2119-2219_2153.wav,3360,3309,51
11068,b-1_4358-4393_4387.wav,VTTS_b-1_4358-4393_4387.wav,1610,1788,-178
11069,b-4_401-500_463.wav,VTTS_b-4_401-500_463.wav,1670,1753,-83
11070,b-4_2000-5164_2158.wav,VTTS_b-4_2000-5164_2158.wav,4410,4354,56
11071,b-4_1221-1300_1294.wav,VTTS_b-4_1221-1300_1294.wav,5410,6269,-859
11072,b-3_2524-2854_2735.wav,VTTS_b-3_2524-2854_2735.wav,6570,7117,-547
11073,b-1_794-1009_831.wav,VTTS_b-1_794-1009_831.wav,4370,4551,-181
11074,b-1_2422-2522_2481.wav,VTTS_b-1_2422-2522_2481.wav,5020,4226,794
11075,b-3_2524-2854_2563.wav,VTTS_b-3_2524-2854_2563.wav,9820,10577,-757
11076,b-1_686-793_687.wav,VTTS_b-1_686-793_687.wav,1420,1265,155
11077,b-3_5009-5427_5169.wav,VTTS_b-3_5009-5427_5169.wav,2890,2496,394
11078,b-3_501-930_615.wav,VTTS_b-3_501-930_615.wav,2690,3320,-630
11079,b-3_98-195_108.wav,VTTS_b-3_98-195_108.wav,9090,9044,46
11080,b-1_1717-1817_1800.wav,VTTS_b-1_1717-1817_1800.wav,2620,2380,240
11081,b-1_2523-2623_2531.wav,VTTS_b-1_2523-2623_2531.wav,3880,4760,-880
11082,b-4_2000-5164_2051.wav,VTTS_b-4_2000-5164_2051.wav,7610,7930,-320
11083,b-3_1568-1665_1594.wav,VTTS_b-3_1568-1665_1594.wav,5000,3529,1471
11084,b-1_2119-2219_2183.wav,VTTS_b-1_2119-2219_2183.wav,1870,1858,12
11085,b-3_1666-1763_1719.wav,VTTS_b-3_1666-1763_1719.wav,4550,5921,-1371
11086,b-3_980-1077_1006.wav,VTTS_b-3_980-1077_1006.wav,5350,4389,961
11087,b-4_151-300_258.wav,VTTS_b-4_151-300_258.wav,7930,7384,546
11088,b-3_4001-4103_4034.wav,VTTS_b-3_4001-4103_4034.wav,3750,5213,-1463
11089,b-3_2350-2433_2358.wav,VTTS_b-3_2350-2433_2358.wav,9920,8835,1085
11090,b-4_2000-5164_2297.wav,VTTS_b-4_2000-5164_2297.wav,3840,4017,-177
11091,b-4_2000-5164_2245.wav,VTTS_b-4_2000-5164_2245.wav,4140,4412,-272
11092,b-3_4001-4103_4067.wav,VTTS_b-3_4001-4103_4067.wav,3230,3379,-149
11093,b-3_4607-5008_4942.wav,VTTS_b-3_4607-5008_4942.wav,3210,3088,122
11094,b-1_3329-3429_3414.wav,VTTS_b-1_3329-3429_3414.wav,2140,1776,364
11095,b-4_1506-1600_1546.wav,VTTS_b-4_1506-1600_1546.wav,6100,5561,539
11096,b-2_509-610_544.wav,VTTS_b-2_509-610_544.wav,2740,3855,-1115
11097,b-4_1101-1220_1214.wav,VTTS_b-4_1101-1220_1214.wav,3540,3529,11
11098,b-3_2524-2854_2535.wav,VTTS_b-3_2524-2854_2535.wav,3100,4632,-1532
11099,b-1_2624-2724_2659.wav,VTTS_b-1_2624-2724_2659.wav,960,998,-38
11100,b-3_6701-6800_6756.wav,VTTS_b-3_6701-6800_6756.wav,3530,3204,326
11101,b-4_2000-5164_2630.wav,VTTS_b-4_2000-5164_2630.wav,5440,7651,-2211
11102,b-2_611-712_713.wav,VTTS_b-2_611-712_713.wav,1350,1173,177
11103,b-3_3628-3714_3634.wav,VTTS_b-3_3628-3714_3634.wav,5250,6409,-1159
11104,b-4_2000-5164_4327.wav,VTTS_b-4_2000-5164_4327.wav,3913,4017,-104
11105,b-3_5009-5427_5065.wav,VTTS_b-3_5009-5427_5065.wav,6780,6084,696
11106,b-4_2000-5164_4079.wav,VTTS_b-4_2000-5164_4079.wav,6438,6536,-98
11107,b-3_2943-3024_3016.wav,VTTS_b-3_2943-3024_3016.wav,3610,4122,-512
11108,b-3_3889-4000_3972.wav,VTTS_b-3_3889-4000_3972.wav,7400,7814,-414
11109,b-3_3364-3453_3408.wav,VTTS_b-3_3364-3453_3408.wav,7780,6896,884
11110,b-4_2000-5164_4242.wav,VTTS_b-4_2000-5164_4242.wav,2487,3042,-555
11111,b-3_5533-5638_5548.wav,VTTS_b-3_5533-5638_5548.wav,4970,4447,523
11112,b-4_1014-1100_1070.wav,VTTS_b-4_1014-1100_1070.wav,7150,7895,-745
11113,b-1_377-477_469.wav,VTTS_b-1_377-477_469.wav,3530,3379,151
11114,b-2_305-406_353.wav,VTTS_b-2_305-406_353.wav,5960,7326,-1366
11115,b-3_1321-1568_1356.wav,VTTS_b-3_1321-1568_1356.wav,4200,3785,415
11116,b-4_151-300_299.wav,VTTS_b-4_151-300_299.wav,2590,2043,547
11117,b-1_3430-3530_3455.wav,VTTS_b-1_3430-3530_3455.wav,2100,2113,-13
11118,b-1_2220-2320_2226.wav,VTTS_b-1_2220-2320_2226.wav,2270,2171,99
11119,b-3_5853-5956_5876.wav,VTTS_b-3_5853-5956_5876.wav,6880,5584,1296
11120,b-3_3454-3537_3507.wav,VTTS_b-3_3454-3537_3507.wav,8410,8533,-123
11121,b-3_6501-6600_6517.wav,VTTS_b-3_6501-6600_6517.wav,2800,2670,130
11122,b-4_501-1014_696.wav,VTTS_b-4_501-1014_696.wav,14600,11610,2990
11123,b-3_3198-3278_3238.wav,VTTS_b-3_3198-3278_3238.wav,2960,2844,116
11124,b-4_2000-5164_3067.wav,VTTS_b-4_2000-5164_3067.wav,6090,5492,598
11125,b-3_5009-5427_5139.wav,VTTS_b-3_5009-5427_5139.wav,7770,8034,-264
11126,b-1_1818-1918_1901.wav,VTTS_b-1_1818-1918_1901.wav,1710,1718,-8
11127,b-4_2000-5164_2908.wav,VTTS_b-4_2000-5164_2908.wav,4008,3994,14
11128,b-3_6301-6400_6395.wav,VTTS_b-3_6301-6400_6395.wav,4620,4888,-268
11129,b-4_501-1014_744.wav,VTTS_b-4_501-1014_744.wav,2510,2067,443
11130,b-2_1903-2038_1918.wav,VTTS_b-2_1903-2038_1918.wav,1810,2543,-733
11131,b-1_2725-2825_2781.wav,VTTS_b-1_2725-2825_2781.wav,3310,3808,-498
11132,b-4_1707-1813_1717.wav,VTTS_b-4_1707-1813_1717.wav,2110,1974,136
11133,b-2_305-406_403.wav,VTTS_b-2_305-406_403.wav,1510,1509,1
11134,b-2_1223-1324_1290.wav,VTTS_b-2_1223-1324_1290.wav,1550,1347,203
11135,b-4_1506-1600_1550.wav,VTTS_b-4_1506-1600_1550.wav,5700,5236,464
11136,b-2_1121-1222_1193.wav,VTTS_b-2_1121-1222_1193.wav,3760,2902,858
11137,b-4_2000-5164_3909.wav,VTTS_b-4_2000-5164_3909.wav,7022,6502,520
11138,b-1_2422-2522_2454.wav,VTTS_b-1_2422-2522_2454.wav,1280,1057,223
11139,b-3_6801-6900_6839.wav,VTTS_b-3_6801-6900_6839.wav,6320,6072,248
11140,b-3_2434-2523_2445.wav,VTTS_b-3_2434-2523_2445.wav,4810,5016,-206
11141,b-1_2624-2724_2631.wav,VTTS_b-1_2624-2724_2631.wav,1560,1660,-100
11142,b-4_1506-1600_1560.wav,VTTS_b-4_1506-1600_1560.wav,7940,8696,-756
11143,b-3_5009-5427_5112.wav,VTTS_b-3_5009-5427_5112.wav,4870,4888,-18
11144,b-1_1616-1716_1658.wav,VTTS_b-1_1616-1716_1658.wav,1500,1533,-33
11145,b-4_2000-5164_2942.wav,VTTS_b-4_2000-5164_2942.wav,5012,5039,-27
11146,b-4_1707-1813_1720.wav,VTTS_b-4_1707-1813_1720.wav,8350,7291,1059
11147,b-3_6016-6115_6070.wav,VTTS_b-3_6016-6115_6070.wav,4200,4122,78
11148,b-3_5009-5427_5340.wav,VTTS_b-3_5009-5427_5340.wav,10790,11331,-541
11149,b-3_1764-1861_1801.wav,VTTS_b-3_1764-1861_1801.wav,2400,2055,345
11150,b-3_3112-3197_3189.wav,VTTS_b-3_3112-3197_3189.wav,2460,2461,-1
11151,b-3_1666-1763_1755.wav,VTTS_b-3_1666-1763_1755.wav,4800,4528,272
11152,b-3_5533-5638_5615.wav,VTTS_b-3_5533-5638_5615.wav,12300,11366,934
11153,b-3_3112-3197_3161.wav,VTTS_b-3_3112-3197_3161.wav,4380,3889,491
11154,b-3_1079-1320_1118.wav,VTTS_b-3_1079-1320_1118.wav,2430,2218,212
11155,b-3_3279-3363_3329.wav,VTTS_b-3_3279-3363_3329.wav,1540,1544,-4
11156,b-1_1-73_46.wav,VTTS_b-1_1-73_46.wav,2890,3425,-535
11157,b-1_794-1009_820.wav,VTTS_b-1_794-1009_820.wav,1470,1753,-283
11158,b-3_392-500_461.wav,VTTS_b-3_392-500_461.wav,5920,5480,440
11159,b-4_501-1014_735.wav,VTTS_b-4_501-1014_735.wav,1700,1556,144
11160,b-4_2000-5164_2608.wav,VTTS_b-4_2000-5164_2608.wav,3500,3402,98
11161,b-4_1901-2000_1984.wav,VTTS_b-4_1901-2000_1984.wav,3880,4203,-323
11162,b-1_2826-2926_2917.wav,VTTS_b-1_2826-2926_2917.wav,2930,2775,155
11163,b-4_2000-5164_5042.wav,VTTS_b-4_2000-5164_5042.wav,4157,3889,268
11164,b-3_2524-2854_2605.wav,VTTS_b-3_2524-2854_2605.wav,4880,4621,259
11165,b-3_6900-7016_6948.wav,VTTS_b-3_6900-7016_6948.wav,2910,2392,518
11166,b-3_1321-1568_1534.wav,VTTS_b-3_1321-1568_1534.wav,2790,2891,-101
11167,b-1_3834-3934_3887.wav,VTTS_b-1_3834-3934_3887.wav,2290,3936,-1646
11168,b-1_2018-2118_2100.wav,VTTS_b-1_2018-2118_2100.wav,5070,6060,-990
11169,b-4_2000-5164_4758.wav,VTTS_b-4_2000-5164_4758.wav,7755,7814,-59
11170,b-4_2000-5164_2340.wav,VTTS_b-4_2000-5164_2340.wav,2485,3170,-685
11171,b-3_2267-2349_2332.wav,VTTS_b-3_2267-2349_2332.wav,4840,4609,231
11172,b-1_1111-1211_1124.wav,VTTS_b-1_1111-1211_1124.wav,1600,1521,79
11173,b-1_3127-3227_3226.wav,VTTS_b-1_3127-3227_3226.wav,2110,1451,659
11174,b-2_2209-2310_2309.wav,VTTS_b-2_2209-2310_2309.wav,2100,2125,-25
11175,b-1_3127-3227_3167.wav,VTTS_b-1_3127-3227_3167.wav,3470,2984,486
11176,b-2_509-610_609.wav,VTTS_b-2_509-610_609.wav,1080,1149,-69
11177,b-3_294-391_307.wav,VTTS_b-3_294-391_307.wav,4420,4354,66
11178,b-3_4607-5008_4627.wav,VTTS_b-3_4607-5008_4627.wav,1930,1916,14
11179,b-4_1814-1900_1830.wav,VTTS_b-4_1814-1900_1830.wav,2980,2473,507
11180,b-3_5853-5956_5895.wav,VTTS_b-3_5853-5956_5895.wav,3750,3982,-232
11181,b-4_2000-5164_3766.wav,VTTS_b-4_2000-5164_3766.wav,5720,6049,-329
11182,b-3_4607-5008_4910.wav,VTTS_b-3_4607-5008_4910.wav,3850,3634,216
11183,b-2_1223-1324_1278.wav,VTTS_b-2_1223-1324_1278.wav,1970,3170,-1200
11184,b-1_2018-2118_2022.wav,VTTS_b-1_2018-2118_2022.wav,1090,1184,-94
11185,b-3_6801-6900_6802.wav,VTTS_b-3_6801-6900_6802.wav,6430,7198,-768
11186,b-3_3112-3197_3132.wav,VTTS_b-3_3112-3197_3132.wav,9000,7697,1303
11187,b-3_5853-5956_5932.wav,VTTS_b-3_5853-5956_5932.wav,9110,10089,-979
11188,b-1_377-477_445.wav,VTTS_b-1_377-477_445.wav,5320,7372,-2052
11189,b-1_3430-3530_3466.wav,VTTS_b-1_3430-3530_3466.wav,1670,1718,-48
11190,b-4_2000-5164_4977.wav,VTTS_b-4_2000-5164_4977.wav,2962,2276,686
11191,b-2_407-508_507.wav,VTTS_b-2_407-508_507.wav,6790,5608,1182
11192,b-3_6401-6500_6421.wav,VTTS_b-3_6401-6500_6421.wav,5140,5132,8
11193,b-4_501-1014_581.wav,VTTS_b-4_501-1014_581.wav,15570,11610,3960
11194,b-3_2267-2349_2297.wav,VTTS_b-3_2267-2349_2297.wav,7620,7047,573
11195,b-2_1325-1426_1372.wav,VTTS_b-2_1325-1426_1372.wav,3670,4481,-811
11196,b-3_3715-3802_3788.wav,VTTS_b-3_3715-3802_3788.wav,6080,6327,-247
11197,b-4_2000-5164_4530.wav,VTTS_b-4_2000-5164_4530.wav,2565,2531,34
11198,b-3_3889-4000_3951.wav,VTTS_b-3_3889-4000_3951.wav,5960,5433,527
11199,b-1_4142-4177_4142.wav,VTTS_b-1_4142-4177_4142.wav,1000,964,36
11200,b-4_1814-1900_1875.wav,VTTS_b-4_1814-1900_1875.wav,4870,4354,516
11201,b-3_501-930_537.wav,VTTS_b-3_501-930_537.wav,4230,4470,-240
11202,b-4_1901-2000_1931.wav,VTTS_b-4_1901-2000_1931.wav,4770,4586,184
11203,b-3_6016-6115_6084.wav,VTTS_b-3_6016-6115_6084.wav,6480,5956,524
11204,b-1_1414-1514_1429.wav,VTTS_b-1_1414-1514_1429.wav,2910,2496,414
11205,b-2_1801-1902_1885.wav,VTTS_b-2_1801-1902_1885.wav,2390,1474,916
11206,b-4_2000-5164_4428.wav,VTTS_b-4_2000-5164_4428.wav,8020,8324,-304
11207,b-4_2000-5164_3960.wav,VTTS_b-4_2000-5164_3960.wav,3174,2937,237
11208,b-3_1079-1320_1276.wav,VTTS_b-3_1079-1320_1276.wav,9620,8394,1226
11209,b-3_196-293_229.wav,VTTS_b-3_196-293_229.wav,2430,2450,-20
11210,b-4_2000-5164_3988.wav,VTTS_b-4_2000-5164_3988.wav,4973,4145,828
11211,b-4_2000-5164_2279.wav,VTTS_b-4_2000-5164_2279.wav,6020,5956,64
11212,b-3_5428-5533_5506.wav,VTTS_b-3_5428-5533_5506.wav,8630,9613,-983
11213,b-1_2523-2623_2571.wav,VTTS_b-1_2523-2623_2571.wav,4190,4656,-466
11214,b-1_1111-1211_1185.wav,VTTS_b-1_1111-1211_1185.wav,1410,1324,86
11215,b-3_3198-3278_3278.wav,VTTS_b-3_3198-3278_3278.wav,6760,7221,-461
11216,b-1_3127-3227_3153.wav,VTTS_b-1_3127-3227_3153.wav,970,998,-28
11217,b-4_2000-5164_3530.wav,VTTS_b-4_2000-5164_3530.wav,5328,5399,-71
11218,b-4_2000-5164_3977.wav,VTTS_b-4_2000-5164_3977.wav,6433,6513,-80
11219,b-3_4001-4103_4069.wav,VTTS_b-3_4001-4103_4069.wav,2300,2368,-68
11220,b-3_4498-4605_4502.wav,VTTS_b-3_4498-4605_4502.wav,4980,4133,847
11221,b-1_650-685_685.wav,VTTS_b-1_650-685_685.wav,2070,1916,154
11222,b-1_4466-4498_4498.wav,VTTS_b-1_4466-4498_4498.wav,3340,3947,-607
11223,b-3_3889-4000_3912.wav,VTTS_b-3_3889-4000_3912.wav,5060,4981,79
11224,b-2_101-202_172.wav,VTTS_b-2_101-202_172.wav,3190,4284,-1094
11225,b-1_2119-2219_2161.wav,VTTS_b-1_2119-2219_2161.wav,3280,2961,319
11226,b-2_1019-1120_1027.wav,VTTS_b-2_1019-1120_1027.wav,4550,5503,-953
11227,b-4_2000-5164_2217.wav,VTTS_b-4_2000-5164_2217.wav,10470,10043,427
11228,b-1_2018-2118_2107.wav,VTTS_b-1_2018-2118_2107.wav,2220,2380,-160
11229,b-4_1221-1300_1228.wav,VTTS_b-4_1221-1300_1228.wav,3680,3692,-12
11230,b-3_6601-6700_6639.wav,VTTS_b-3_6601-6700_6639.wav,7370,8313,-943
11231,b-4_2000-5164_3375.wav,VTTS_b-4_2000-5164_3375.wav,3791,3518,273
11232,b-4_1301-1400_1344.wav,VTTS_b-4_1301-1400_1344.wav,5140,6084,-944
11233,b-4_2000-5164_3449.wav,VTTS_b-4_2000-5164_3449.wav,3620,3715,-95
11234,b-2_713-814_770.wav,VTTS_b-2_713-814_770.wav,900,917,-17
11235,b-1_794-1009_969.wav,VTTS_b-1_794-1009_969.wav,4460,5538,-1078
11236,b-2_1019-1120_1120.wav,VTTS_b-2_1019-1120_1120.wav,2690,1498,1192
11237,b-1_2725-2825_2797.wav,VTTS_b-1_2725-2825_2797.wav,2280,2125,155
11238,b-3_4607-5008_4944.wav,VTTS_b-3_4607-5008_4944.wav,4380,4342,38
11239,b-4_2000-5164_4865.wav,VTTS_b-4_2000-5164_4865.wav,2506,2368,138
11240,b-2_1903-2038_2033.wav,VTTS_b-2_1903-2038_2033.wav,2270,2287,-17
11241,b-4_2000-5164_4258.wav,VTTS_b-4_2000-5164_4258.wav,1042,836,206
11242,b-3_2267-2349_2289.wav,VTTS_b-3_2267-2349_2289.wav,7670,11610,-3940
11243,b-3_5009-5427_5386.wav,VTTS_b-3_5009-5427_5386.wav,1460,1498,-38
11244,b-4_2000-5164_5084.wav,VTTS_b-4_2000-5164_5084.wav,4025,4203,-178
11245,b-2_101-202_120.wav,VTTS_b-2_101-202_120.wav,1350,1753,-403
11246,b-3_5533-5638_5575.wav,VTTS_b-3_5533-5638_5575.wav,4050,4191,-141
11247,b-4_2000-5164_2485.wav,VTTS_b-4_2000-5164_2485.wav,2220,2136,84
11248,b-1_794-1009_953.wav,VTTS_b-1_794-1009_953.wav,1790,1811,-21
11249,b-4_53-150_141.wav,VTTS_b-4_53-150_141.wav,7700,6873,827
11250,b-2_611-712_643.wav,VTTS_b-2_611-712_643.wav,2930,2206,724
11251,b-4_2000-5164_2294.wav,VTTS_b-4_2000-5164_2294.wav,5360,5027,333
11252,b-3_4315-4424_4387.wav,VTTS_b-3_4315-4424_4387.wav,10740,11064,-324
11253,b-4_1707-1813_1805.wav,VTTS_b-4_1707-1813_1805.wav,6850,6432,418
11254,b-4_2000-5164_2572.wav,VTTS_b-4_2000-5164_2572.wav,4480,4644,-164
11255,b-3_5428-5533_5478.wav,VTTS_b-3_5428-5533_5478.wav,3810,4075,-265
11256,b-3_1321-1568_1506.wav,VTTS_b-3_1321-1568_1506.wav,6290,5410,880
11257,b-1_2523-2623_2558.wav,VTTS_b-1_2523-2623_2558.wav,1750,1904,-154
11258,b-3_3112-3197_3150.wav,VTTS_b-3_3112-3197_3150.wav,2580,2403,177
11259,b-4_2000-5164_3406.wav,VTTS_b-4_2000-5164_3406.wav,5573,5805,-232
11260,b-1_478-578_570.wav,VTTS_b-1_478-578_570.wav,1700,1533,167
11261,b-1_2119-2219_2160.wav,VTTS_b-1_2119-2219_2160.wav,1400,1382,18
11262,b-2_1903-2038_1980.wav,VTTS_b-2_1903-2038_1980.wav,2330,2159,171
11263,b-1_1010-1110_1081.wav,VTTS_b-1_1010-1110_1081.wav,3270,3379,-109
11264,b-3_5745-5852_5826.wav,VTTS_b-3_5745-5852_5826.wav,6780,6513,267
11265,b-4_2000-5164_2780.wav,VTTS_b-4_2000-5164_2780.wav,2020,1997,23
11266,b-2_1223-1324_1310.wav,VTTS_b-2_1223-1324_1310.wav,1410,1335,75
11267,b-4_501-1014_853.wav,VTTS_b-4_501-1014_853.wav,7580,7848,-268
11268,b-3_5639-5744_5653.wav,VTTS_b-3_5639-5744_5653.wav,6610,6722,-112
11269,b-4_2000-5164_3010.wav,VTTS_b-4_2000-5164_3010.wav,1724,1834,-110
11270,b-1_1919-2017_1919.wav,VTTS_b-1_1919-2017_1919.wav,4010,2937,1073
11271,b-4_1707-1813_1788.wav,VTTS_b-4_1707-1813_1788.wav,4450,3483,967
11272,b-1_377-477_468.wav,VTTS_b-1_377-477_468.wav,2610,2577,33
11273,b-1_1313-1413_1405.wav,VTTS_b-1_1313-1413_1405.wav,2040,1834,206
11274,b-4_2000-5164_4321.wav,VTTS_b-4_2000-5164_4321.wav,3849,3913,-64
11275,b-3_1-97_5.wav,VTTS_b-3_1-97_5.wav,8340,9509,-1169
11276,b-1_276-376_277.wav,VTTS_b-1_276-376_277.wav,1530,1393,137
11277,b-1_175-275_221.wav,VTTS_b-1_175-275_221.wav,1350,1207,143
11278,b-1_3632-3732_3713.wav,VTTS_b-1_3632-3732_3713.wav,2690,4272,-1582
11279,b-2_305-406_334.wav,VTTS_b-2_305-406_334.wav,1260,1149,111
11280,b-1_4466-4498_4484.wav,VTTS_b-1_4466-4498_4484.wav,5200,6444,-1244
11281,b-2_1597-1698_1604.wav,VTTS_b-2_1597-1698_1604.wav,2890,3332,-442
11282,b-4_2000-5164_3445.wav,VTTS_b-4_2000-5164_3445.wav,2528,4145,-1617
11283,b-2_815-916_837.wav,VTTS_b-2_815-916_837.wav,1360,1370,-10
11284,b-4_1707-1813_1768.wav,VTTS_b-4_1707-1813_1768.wav,1190,998,192
11285,b-2_713-814_803.wav,VTTS_b-2_713-814_803.wav,7150,11610,-4460
11286,b-3_6301-6400_6390.wav,VTTS_b-3_6301-6400_6390.wav,3340,3286,54
11287,b-4_2000-5164_4694.wav,VTTS_b-4_2000-5164_4694.wav,9103,8533,570
11288,b-1_794-1009_932.wav,VTTS_b-1_794-1009_932.wav,3650,3379,271
11289,b-3_5533-5638_5549.wav,VTTS_b-3_5533-5638_5549.wav,3500,3587,-87
11290,b-3_4498-4605_4512.wav,VTTS_b-3_4498-4605_4512.wav,6110,5689,421
11291,b-1_1212-1312_1295.wav,VTTS_b-1_1212-1312_1295.wav,1360,1196,164
11292,b-3_5428-5533_5435.wav,VTTS_b-3_5428-5533_5435.wav,5380,5004,376
11293,b-3_2000-2088_2083.wav,VTTS_b-3_2000-2088_2083.wav,7550,7396,154
11294,b-1_4286-4321_4298.wav,VTTS_b-1_4286-4321_4298.wav,1550,1660,-110
11295,b-2_1427-1562_1492.wav,VTTS_b-2_1427-1562_1492.wav,1940,2624,-684
11296,b-3_3538-3627_3626.wav,VTTS_b-3_3538-3627_3626.wav,2360,2009,351
11297,b-2_407-508_463.wav,VTTS_b-2_407-508_463.wav,1280,1486,-206
11298,b-3_5639-5744_5693.wav,VTTS_b-3_5639-5744_5693.wav,4370,5004,-634
11299,b-1_1616-1716_1716.wav,VTTS_b-1_1616-1716_1716.wav,2960,3262,-302
11300,b-2_2311-2412_2318.wav,VTTS_b-2_2311-2412_2318.wav,1400,1974,-574
11301,b-4_2000-5164_2311.wav,VTTS_b-4_2000-5164_2311.wav,9025,8220,805
11302,b-4_2000-5164_4424.wav,VTTS_b-4_2000-5164_4424.wav,5320,6989,-1669
11303,b-3_501-930_830.wav,VTTS_b-3_501-930_830.wav,6620,6026,594
11304,b-1_2826-2926_2844.wav,VTTS_b-1_2826-2926_2844.wav,5230,4470,760
11305,b-3_5745-5852_5750.wav,VTTS_b-3_5745-5852_5750.wav,4400,4342,58
11306,b-3_980-1077_1031.wav,VTTS_b-3_980-1077_1031.wav,4200,3982,218
11307,b-3_2524-2854_2817.wav,VTTS_b-3_2524-2854_2817.wav,3370,3901,-531
11308,b-1_2119-2219_2124.wav,VTTS_b-1_2119-2219_2124.wav,1380,1904,-524
11309,b-3_4001-4103_4083.wav,VTTS_b-3_4001-4103_4083.wav,8410,11610,-3200
11310,b-3_2855-2942_2936.wav,VTTS_b-3_2855-2942_2936.wav,8510,9892,-1382
11311,b-4_2000-5164_4398.wav,VTTS_b-4_2000-5164_4398.wav,5223,5410,-187
11312,b-3_6274-6300_6296.wav,VTTS_b-3_6274-6300_6296.wav,2350,2276,74
11313,b-2_1427-1562_1442.wav,VTTS_b-2_1427-1562_1442.wav,5280,6745,-1465
11314,b-3_3538-3627_3586.wav,VTTS_b-3_3538-3627_3586.wav,1960,2067,-107
11315,b-1_2826-2926_2847.wav,VTTS_b-1_2826-2926_2847.wav,2110,2322,-212
11316,b-3_1321-1568_1573.wav,VTTS_b-3_1321-1568_1573.wav,4920,4331,589
11317,b-1_1212-1312_1236.wav,VTTS_b-1_1212-1312_1236.wav,2510,2299,211
11318,b-4_301-400_363.wav,VTTS_b-4_301-400_363.wav,3690,3019,671
11319,b-4_1901-2000_1976.wav,VTTS_b-4_1901-2000_1976.wav,4640,4156,484
11320,b-4_2000-5164_3879.wav,VTTS_b-4_2000-5164_3879.wav,5830,7036,-1206
11321,b-1_276-376_286.wav,VTTS_b-1_276-376_286.wav,1320,1219,101
11322,b-2_1019-1120_1115.wav,VTTS_b-2_1019-1120_1115.wav,6310,5677,633
11323,b-3_1079-1320_1265.wav,VTTS_b-3_1079-1320_1265.wav,7820,7419,401
11324,b-4_2000-5164_4154.wav,VTTS_b-4_2000-5164_4154.wav,4011,4458,-447
11325,b-3_2350-2433_2425.wav,VTTS_b-3_2350-2433_2425.wav,1110,1033,77
11326,b-3_3538-3627_3549.wav,VTTS_b-3_3538-3627_3549.wav,4000,4075,-75
11327,b-3_1862-1959_1912.wav,VTTS_b-3_1862-1959_1912.wav,5700,11610,-5910
11328,b-2_1-100_50.wav,VTTS_b-2_1-100_50.wav,3150,4841,-1691
11329,b-2_1223-1324_1319.wav,VTTS_b-2_1223-1324_1319.wav,1390,1533,-143
11330,b-4_2000-5164_3730.wav,VTTS_b-4_2000-5164_3730.wav,1935,3518,-1583
11331,b-4_2000-5164_4306.wav,VTTS_b-4_2000-5164_4306.wav,2757,3344,-587
11332,b-3_4607-5008_4734.wav,VTTS_b-3_4607-5008_4734.wav,3000,3065,-65
11333,b-3_6701-6800_6750.wav,VTTS_b-3_6701-6800_6750.wav,3990,3843,147
11334,b-3_501-930_862.wav,VTTS_b-3_501-930_862.wav,2210,2078,132
11335,b-2_407-508_432.wav,VTTS_b-2_407-508_432.wav,1130,1091,39
11336,b-1_3026-3126_3071.wav,VTTS_b-1_3026-3126_3071.wav,1920,2101,-181
11337,b-3_501-930_650.wav,VTTS_b-3_501-930_650.wav,4810,4447,363
11338,b-3_294-391_373.wav,VTTS_b-3_294-391_373.wav,4080,4145,-65
11339,b-1_3733-3833_3769.wav,VTTS_b-1_3733-3833_3769.wav,1360,1265,95
11340,b-4_501-1014_699.wav,VTTS_b-4_501-1014_699.wav,3060,3111,-51
11341,b-4_2000-5164_3732.wav,VTTS_b-4_2000-5164_3732.wav,6100,6014,86
11342,b-1_74-174_78.wav,VTTS_b-1_74-174_78.wav,2030,1927,103
11343,b-2_815-916_874.wav,VTTS_b-2_815-916_874.wav,1340,1265,75
11344,b-4_2000-5164_2420.wav,VTTS_b-4_2000-5164_2420.wav,5830,5480,350
11345,b-3_6016-6115_6100.wav,VTTS_b-3_6016-6115_6100.wav,4920,4656,264
11346,b-4_501-1014_877.wav,VTTS_b-4_501-1014_877.wav,4190,3855,335
11347,b-4_2000-5164_2538.wav,VTTS_b-4_2000-5164_2538.wav,6710,7198,-488
11348,b-3_4001-4103_4018.wav,VTTS_b-3_4001-4103_4018.wav,2990,3553,-563
11349,b-3_4001-4103_4037.wav,VTTS_b-3_4001-4103_4037.wav,5420,4783,637
11350,b-3_6701-6800_6739.wav,VTTS_b-3_6701-6800_6739.wav,2540,2601,-61
11351,b-4_1301-1400_1330.wav,VTTS_b-4_1301-1400_1330.wav,8210,7755,455
11352,b-3_6601-6700_6632.wav,VTTS_b-3_6601-6700_6632.wav,4030,3506,524
11353,b-3_5639-5744_5652.wav,VTTS_b-3_5639-5744_5652.wav,3030,3100,-70
11354,b-2_1563-1596_1590.wav,VTTS_b-2_1563-1596_1590.wav,1380,1033,347
11355,b-1_3026-3126_3125.wav,VTTS_b-1_3026-3126_3125.wav,4420,6560,-2140
11356,b-3_6116-6215_6194.wav,VTTS_b-3_6116-6215_6194.wav,6980,6629,351
11357,b-4_2000-5164_4605.wav,VTTS_b-4_2000-5164_4605.wav,3553,3019,534
11358,b-3_501-930_723.wav,VTTS_b-3_501-930_723.wav,2510,2635,-125
11359,b-1_2018-2118_2026.wav,VTTS_b-1_2018-2118_2026.wav,5810,5306,504
11360,b-3_5009-5427_5154.wav,VTTS_b-3_5009-5427_5154.wav,6560,6362,198
11361,b-3_2177-2266_2249.wav,VTTS_b-3_2177-2266_2249.wav,4400,3750,650
11362,b-3_4498-4605_4588.wav,VTTS_b-3_4498-4605_4588.wav,5490,5492,-2
11363,b-3_5639-5744_5708.wav,VTTS_b-3_5639-5744_5708.wav,2400,2926,-526
11364,b-4_2000-5164_5159.wav,VTTS_b-4_2000-5164_5159.wav,11419,11575,-156
11365,b-3_5853-5956_5946.wav,VTTS_b-3_5853-5956_5946.wav,7740,7349,391
11366,b-2_1-100_31.wav,VTTS_b-2_1-100_31.wav,3270,3762,-492
11367,b-4_2000-5164_4946.wav,VTTS_b-4_2000-5164_4946.wav,5612,11610,-5998
11368,b-4_2000-5164_3336.wav,VTTS_b-4_2000-5164_3336.wav,5091,5213,-122
11369,b-1_794-1009_966.wav,VTTS_b-1_794-1009_966.wav,1880,1428,452
11370,b-1_1212-1312_1284.wav,VTTS_b-1_1212-1312_1284.wav,2500,2403,97
11371,b-4_2000-5164_4668.wav,VTTS_b-4_2000-5164_4668.wav,2645,2821,-176
11372,b-2_2311-2412_2351.wav,VTTS_b-2_2311-2412_2351.wav,6860,4609,2251
11373,b-3_1079-1320_1106.wav,VTTS_b-3_1079-1320_1106.wav,6960,7047,-87
11374,b-4_2000-5164_4796.wav,VTTS_b-4_2000-5164_4796.wav,3349,3437,-88
11375,b-4_501-1014_716.wav,VTTS_b-4_501-1014_716.wav,5880,5747,133
11376,b-4_2000-5164_4317.wav,VTTS_b-4_2000-5164_4317.wav,3795,3785,10
11377,b-3_5639-5744_5641.wav,VTTS_b-3_5639-5744_5641.wav,4090,3796,294
11378,b-4_151-300_203.wav,VTTS_b-4_151-300_203.wav,6630,6850,-220
11379,b-3_4001-4103_4007.wav,VTTS_b-3_4001-4103_4007.wav,5490,6374,-884
11380,b-2_1427-1562_1514.wav,VTTS_b-2_1427-1562_1514.wav,1480,1382,98
11381,b-4_401-500_464.wav,VTTS_b-4_401-500_464.wav,5350,4656,694
11382,b-3_1321-1568_1469.wav,VTTS_b-3_1321-1568_1469.wav,8790,8394,396
11383,b-3_3454-3537_3464.wav,VTTS_b-3_3454-3537_3464.wav,8340,8150,190
11384,b-2_2311-2412_2388.wav,VTTS_b-2_2311-2412_2388.wav,4110,5968,-1858
11385,b-3_4104-4206_4154.wav,VTTS_b-3_4104-4206_4154.wav,9740,9160,580
11386,b-4_2000-5164_2474.wav,VTTS_b-4_2000-5164_2474.wav,2580,2670,-90
11387,b-3_5009-5427_5261.wav,VTTS_b-3_5009-5427_5261.wav,3280,3216,64
11388,b-3_501-930_865.wav,VTTS_b-3_501-930_865.wav,6230,6467,-237
11389,b-3_3628-3714_3647.wav,VTTS_b-3_3628-3714_3647.wav,3840,4052,-212
11390,b-1_3935-4033_3947.wav,VTTS_b-1_3935-4033_3947.wav,1850,2171,-321
11391,b-4_2000-5164_2335.wav,VTTS_b-4_2000-5164_2335.wav,2800,2717,83
11392,b-2_611-712_707.wav,VTTS_b-2_611-712_707.wav,1950,2276,-326
11393,b-3_6900-7016_6962.wav,VTTS_b-3_6900-7016_6962.wav,5370,4853,517
11394,b-4_2000-5164_2367.wav,VTTS_b-4_2000-5164_2367.wav,7220,7465,-245
11395,b-2_2107-2193_2128.wav,VTTS_b-2_2107-2193_2128.wav,1460,1416,44
11396,b-4_2000-5164_2315.wav,VTTS_b-4_2000-5164_2315.wav,7915,7802,113
11397,b-1_2119-2219_2147.wav,VTTS_b-1_2119-2219_2147.wav,1350,1358,-8
11398,b-3_3279-3363_3361.wav,VTTS_b-3_3279-3363_3361.wav,6200,6815,-615
11399,b-3_6900-7016_6902.wav,VTTS_b-3_6900-7016_6902.wav,8270,9033,-763
11400,b-1_794-1009_806.wav,VTTS_b-1_794-1009_806.wav,4390,3634,756
11401,b-3_5009-5427_5126.wav,VTTS_b-3_5009-5427_5126.wav,5510,8522,-3012
11402,b-4_2000-5164_2261.wav,VTTS_b-4_2000-5164_2261.wav,6920,7047,-127
11403,b-4_1101-1220_1150.wav,VTTS_b-4_1101-1220_1150.wav,7990,8824,-834
11404,b-1_4358-4393_4384.wav,VTTS_b-1_4358-4393_4384.wav,3010,3448,-438
11405,b-3_4607-5008_4638.wav,VTTS_b-3_4607-5008_4638.wav,8200,7152,1048
11406,b-4_1301-1400_1388.wav,VTTS_b-4_1301-1400_1388.wav,7100,7070,30
11407,b-3_4607-5008_4764.wav,VTTS_b-3_4607-5008_4764.wav,5680,5526,154
11408,b-3_931-979_963.wav,VTTS_b-3_931-979_963.wav,3140,2949,191
11409,b-4_1301-1400_1379.wav,VTTS_b-4_1301-1400_1379.wav,3880,5306,-1426
11410,b-1_3228-3328_3292.wav,VTTS_b-1_3228-3328_3292.wav,4060,4005,55
11411,b-4_2000-5164_4225.wav,VTTS_b-4_2000-5164_4225.wav,6022,4551,1471
11412,b-1_377-477_459.wav,VTTS_b-1_377-477_459.wav,1700,1765,-65
11413,b-4_2000-5164_3411.wav,VTTS_b-4_2000-5164_3411.wav,6882,9102,-2220
11414,b-4_2000-5164_4136.wav,VTTS_b-4_2000-5164_4136.wav,8889,10228,-1339
11415,b-4_53-150_139.wav,VTTS_b-4_53-150_139.wav,9240,8928,312
11416,b-4_2000-5164_3921.wav,VTTS_b-4_2000-5164_3921.wav,8020,8057,-37
11417,b-4_1301-1400_1383.wav,VTTS_b-4_1301-1400_1383.wav,5280,4807,473
11418,b-3_2089-2176_2171.wav,VTTS_b-3_2089-2176_2171.wav,9610,9950,-340
11419,b-3_4425-4497_4494.wav,VTTS_b-3_4425-4497_4494.wav,5680,11157,-5477
11420,b-4_2000-5164_4503.wav,VTTS_b-4_2000-5164_4503.wav,2214,2252,-38
11421,b-4_2000-5164_4869.wav,VTTS_b-4_2000-5164_4869.wav,7615,8905,-1290
11422,b-4_2000-5164_4597.wav,VTTS_b-4_2000-5164_4597.wav,11902,11610,292
11423,b-4_2000-5164_3137.wav,VTTS_b-4_2000-5164_3137.wav,3131,2543,588
11424,b-3_3112-3197_3163.wav,VTTS_b-3_3112-3197_3163.wav,3550,3239,311
11425,b-3_5639-5744_5651.wav,VTTS_b-3_5639-5744_5651.wav,3410,3460,-50
11426,b-3_3889-4000_3932.wav,VTTS_b-3_3889-4000_3932.wav,760,697,63
11427,b-3_6301-6400_6353.wav,VTTS_b-3_6301-6400_6353.wav,5380,5689,-309
11428,b-3_4498-4605_4535.wav,VTTS_b-3_4498-4605_4535.wav,7500,8081,-581
11429,b-3_1960-2000_1985.wav,VTTS_b-3_1960-2000_1985.wav,4640,4180,460
11430,b-3_4607-5008_4938.wav,VTTS_b-3_4607-5008_4938.wav,4500,4760,-260
11431,b-4_2000-5164_2986.wav,VTTS_b-4_2000-5164_2986.wav,6418,6513,-95
11432,b-4_501-1014_936.wav,VTTS_b-4_501-1014_936.wav,2490,2310,180
11433,b-2_713-814_782.wav,VTTS_b-2_713-814_782.wav,3400,3843,-443
11434,b-1_4430-4465_4461.wav,VTTS_b-1_4430-4465_4461.wav,1990,1950,40
11435,b-1_3834-3934_3880.wav,VTTS_b-1_3834-3934_3880.wav,1520,1614,-94
11436,b-2_1019-1120_1052.wav,VTTS_b-2_1019-1120_1052.wav,1520,1022,498
11437,b-4_501-1014_601.wav,VTTS_b-4_501-1014_601.wav,2400,2252,148
11438,b-4_151-300_161.wav,VTTS_b-4_151-300_161.wav,1690,1556,134
11439,b-1_2826-2926_2898.wav,VTTS_b-1_2826-2926_2898.wav,6490,6653,-163
11440,b-3_1079-1320_1151.wav,VTTS_b-3_1079-1320_1151.wav,5720,5782,-62
11441,b-4_2000-5164_3416.wav,VTTS_b-4_2000-5164_3416.wav,7072,11610,-4538
11442,b-1_2624-2724_2711.wav,VTTS_b-1_2624-2724_2711.wav,1580,1707,-127
11443,b-4_2000-5164_2767.wav,VTTS_b-4_2000-5164_2767.wav,7320,7036,284
11444,b-3_392-500_498.wav,VTTS_b-3_392-500_498.wav,4580,4690,-110
11445,b-1_1616-1716_1683.wav,VTTS_b-1_1616-1716_1683.wav,1640,1591,49
11446,b-3_5009-5427_5332.wav,VTTS_b-3_5009-5427_5332.wav,4350,4412,-62
11447,b-2_2311-2412_2386.wav,VTTS_b-2_2311-2412_2386.wav,2230,1858,372
11448,b-3_392-500_447.wav,VTTS_b-3_392-500_447.wav,3750,3680,70
11449,b-3_5009-5427_5088.wav,VTTS_b-3_5009-5427_5088.wav,8870,9265,-395
11450,b-3_5009-5427_5208.wav,VTTS_b-3_5009-5427_5208.wav,3970,4029,-59
11451,b-4_1506-1600_1564.wav,VTTS_b-4_1506-1600_1564.wav,2600,3053,-453
11452,b-1_4214-4285_4242.wav,VTTS_b-1_4214-4285_4242.wav,2660,3042,-382
11453,b-1_1212-1312_1294.wav,VTTS_b-1_1212-1312_1294.wav,1680,1509,171
11454,b-3_2524-2854_2676.wav,VTTS_b-3_2524-2854_2676.wav,4280,4272,8
11455,b-4_2000-5164_3524.wav,VTTS_b-4_2000-5164_3524.wav,2864,2322,542
11456,b-4_2000-5164_2103.wav,VTTS_b-4_2000-5164_2103.wav,4620,3913,707
11457,b-4_1221-1300_1225.wav,VTTS_b-4_1221-1300_1225.wav,4750,5027,-277
11458,b-4_2000-5164_2922.wav,VTTS_b-4_2000-5164_2922.wav,7123,7210,-87
11459,b-3_2855-2942_2863.wav,VTTS_b-3_2855-2942_2863.wav,3100,3158,-58
11460,b-1_1313-1413_1319.wav,VTTS_b-1_1313-1413_1319.wav,4020,4551,-531
11461,b-1_2725-2825_2783.wav,VTTS_b-1_2725-2825_2783.wav,2940,11610,-8670
11462,b-1_2523-2623_2604.wav,VTTS_b-1_2523-2623_2604.wav,1660,1892,-232
11463,b-4_2000-5164_3373.wav,VTTS_b-4_2000-5164_3373.wav,3141,3100,41
11464,b-2_1801-1902_1848.wav,VTTS_b-2_1801-1902_1848.wav,1190,1057,133
11465,b-4_2000-5164_3747.wav,VTTS_b-4_2000-5164_3747.wav,5760,5573,187
11466,b-3_5639-5744_5680.wav,VTTS_b-3_5639-5744_5680.wav,5740,5236,504
11467,b-4_2000-5164_3936.wav,VTTS_b-4_2000-5164_3936.wav,1185,1149,36
11468,b-1_2826-2926_2890.wav,VTTS_b-1_2826-2926_2890.wav,3590,3425,165
11469,b-3_2524-2854_2820.wav,VTTS_b-3_2524-2854_2820.wav,2960,4876,-1916
11470,b-4_151-300_187.wav,VTTS_b-4_151-300_187.wav,2080,1765,315
11471,b-3_6701-6800_6800.wav,VTTS_b-3_6701-6800_6800.wav,6290,5956,334
11472,b-4_1301-1400_1318.wav,VTTS_b-4_1301-1400_1318.wav,7870,9381,-1511
11473,b-2_1121-1222_1217.wav,VTTS_b-2_1121-1222_1217.wav,6540,7442,-902
11474,b-4_2000-5164_2385.wav,VTTS_b-4_2000-5164_2385.wav,1820,5608,-3788
11475,b-3_5009-5427_5159.wav,VTTS_b-3_5009-5427_5159.wav,2880,2531,349
11476,b-1_2725-2825_2776.wav,VTTS_b-1_2725-2825_2776.wav,3970,4168,-198
11477,b-4_2000-5164_3994.wav,VTTS_b-4_2000-5164_3994.wav,3232,11610,-8378
11478,b-4_301-400_308.wav,VTTS_b-4_301-400_308.wav,4460,4377,83
11479,b-1_650-685_653.wav,VTTS_b-1_650-685_653.wav,1940,1811,129
11480,b-3_5745-5852_5811.wav,VTTS_b-3_5745-5852_5811.wav,6960,7396,-436
11481,b-1_3329-3429_3369.wav,VTTS_b-1_3329-3429_3369.wav,2030,1939,91
11482,b-2_713-814_814.wav,VTTS_b-2_713-814_814.wav,1440,1324,116
11483,b-2_1-100_91.wav,VTTS_b-2_1-100_91.wav,2160,3007,-847
11484,b-1_2422-2522_2503.wav,VTTS_b-1_2422-2522_2503.wav,1100,998,102
11485,b-1_74-174_137.wav,VTTS_b-1_74-174_137.wav,4110,5201,-1091
11486,b-3_3279-3363_3319.wav,VTTS_b-3_3279-3363_3319.wav,7370,7291,79
11487,b-3_4498-4605_4565.wav,VTTS_b-3_4498-4605_4565.wav,3850,3727,123
11488,b-1_4106-4141_4120.wav,VTTS_b-1_4106-4141_4120.wav,1640,1741,-101
11489,b-4_2000-5164_2691.wav,VTTS_b-4_2000-5164_2691.wav,2508,2670,-162
11490,b-3_5957-6015_5964.wav,VTTS_b-3_5957-6015_5964.wav,5350,5596,-246
11491,b-4_2000-5164_4539.wav,VTTS_b-4_2000-5164_4539.wav,3590,3228,362
11492,b-1_4214-4285_4226.wav,VTTS_b-1_4214-4285_4226.wav,1870,1904,-34
11493,b-1_1010-1110_1035.wav,VTTS_b-1_1010-1110_1035.wav,1330,1219,111
11494,b-3_2524-2854_2636.wav,VTTS_b-3_2524-2854_2636.wav,4530,4714,-184
11495,b-4_2000-5164_2718.wav,VTTS_b-4_2000-5164_2718.wav,2115,2310,-195
11496,b-4_2000-5164_2023.wav,VTTS_b-4_2000-5164_2023.wav,5090,5492,-402
11497,b-1_276-376_313.wav,VTTS_b-1_276-376_313.wav,1410,1358,52
11498,b-3_98-195_167.wav,VTTS_b-3_98-195_167.wav,2050,2020,30
11499,b-2_1325-1426_1401.wav,VTTS_b-2_1325-1426_1401.wav,2470,2926,-456
11500,b-4_2000-5164_3105.wav,VTTS_b-4_2000-5164_3105.wav,6426,6757,-331
11501,b-4_1601-1706_1607.wav,VTTS_b-4_1601-1706_1607.wav,2980,2891,89
11502,b-2_917-1018_989.wav,VTTS_b-2_917-1018_989.wav,1590,1556,34
11503,b-1_377-477_463.wav,VTTS_b-1_377-477_463.wav,3490,5689,-2199
11504,b-1_4214-4285_4241.wav,VTTS_b-1_4214-4285_4241.wav,1620,1382,238
11505,b-4_1221-1300_1223.wav,VTTS_b-4_1221-1300_1223.wav,8640,8696,-56
11506,b-2_917-1018_1017.wav,VTTS_b-2_917-1018_1017.wav,4640,4690,-50
11507,b-2_917-1018_1009.wav,VTTS_b-2_917-1018_1009.wav,4040,3715,325
11508,b-1_579-649_593.wav,VTTS_b-1_579-649_593.wav,2640,2531,109
11509,b-3_3364-3453_3375.wav,VTTS_b-3_3364-3453_3375.wav,7670,6978,692
11510,b-4_501-1014_562.wav,VTTS_b-4_501-1014_562.wav,5380,5399,-19
11511,b-4_2000-5164_4917.wav,VTTS_b-4_2000-5164_4917.wav,4509,4284,225
11512,b-1_3026-3126_3079.wav,VTTS_b-1_3026-3126_3079.wav,4840,4563,277
11513,b-4_2000-5164_4020.wav,VTTS_b-4_2000-5164_4020.wav,6084,11610,-5526
11514,b-1_1818-1918_1904.wav,VTTS_b-1_1818-1918_1904.wav,1440,1335,105
11515,b-3_5639-5744_5721.wav,VTTS_b-3_5639-5744_5721.wav,6100,5433,667
11516,b-3_5009-5427_5361.wav,VTTS_b-3_5009-5427_5361.wav,5120,5039,81
11517,b-4_2000-5164_2723.wav,VTTS_b-4_2000-5164_2723.wav,2240,2612,-372
11518,b-1_2321-2421_2335.wav,VTTS_b-1_2321-2421_2335.wav,1380,1312,68
11519,b-2_1903-2038_1945.wav,VTTS_b-2_1903-2038_1945.wav,1530,1614,-84
11520,b-3_6601-6700_6673.wav,VTTS_b-3_6601-6700_6673.wav,3790,5445,-1655
11521,b-4_2000-5164_2475.wav,VTTS_b-4_2000-5164_2475.wav,3060,3657,-597
11522,b-3_3364-3453_3411.wav,VTTS_b-3_3364-3453_3411.wav,2840,2937,-97
11523,b-3_4104-4206_4182.wav,VTTS_b-3_4104-4206_4182.wav,3840,9741,-5901
11524,b-3_501-930_507.wav,VTTS_b-3_501-930_507.wav,9400,10298,-898
11525,b-3_3112-3197_3139.wav,VTTS_b-3_3112-3197_3139.wav,3860,5259,-1399
11526,b-3_3112-3197_3171.wav,VTTS_b-3_3112-3197_3171.wav,4130,4122,8
11527,b-3_4607-5008_4626.wav,VTTS_b-3_4607-5008_4626.wav,3880,4238,-358
11528,b-2_1597-1698_1696.wav,VTTS_b-2_1597-1698_1696.wav,2410,2461,-51
11529,b-3_501-930_700.wav,VTTS_b-3_501-930_700.wav,7540,6664,876
11530,b-3_5745-5852_5761.wav,VTTS_b-3_5745-5852_5761.wav,3430,3216,214
11531,b-1_4466-4498_4466.wav,VTTS_b-1_4466-4498_4466.wav,2950,3228,-278
11532,b-4_2000-5164_3997.wav,VTTS_b-4_2000-5164_3997.wav,5632,5863,-231
11533,b-4_1101-1220_1167.wav,VTTS_b-4_1101-1220_1167.wav,1940,1811,129
11534,b-3_931-979_931.wav,VTTS_b-3_931-979_931.wav,8360,10809,-2449
11535,b-1_276-376_282.wav,VTTS_b-1_276-376_282.wav,1080,1115,-35
11536,b-4_1601-1706_1634.wav,VTTS_b-4_1601-1706_1634.wav,4390,4389,1
11537,b-4_501-1014_646.wav,VTTS_b-4_501-1014_646.wav,7770,8301,-531
11538,b-3_2524-2854_2668.wav,VTTS_b-3_2524-2854_2668.wav,2630,2624,6
11539,b-2_2413-2500_2458.wav,VTTS_b-2_2413-2500_2458.wav,2310,2171,139
11540,b-4_1401-1505_1445.wav,VTTS_b-4_1401-1505_1445.wav,1680,1393,287
11541,b-2_1699-1800_1790.wav,VTTS_b-2_1699-1800_1790.wav,2690,2473,217
11542,b-3_3454-3537_3487.wav,VTTS_b-3_3454-3537_3487.wav,3890,3785,105
11543,b-4_1901-2000_1951.wav,VTTS_b-4_1901-2000_1951.wav,2780,2647,133
11544,b-2_305-406_346.wav,VTTS_b-2_305-406_346.wav,4160,5480,-1320
11545,b-4_2000-5164_3160.wav,VTTS_b-4_2000-5164_3160.wav,4701,4400,301
11546,b-4_151-300_260.wav,VTTS_b-4_151-300_260.wav,6790,6594,196
11547,b-2_305-406_317.wav,VTTS_b-2_305-406_317.wav,5990,6803,-813
11548,b-3_6601-6700_6644.wav,VTTS_b-3_6601-6700_6644.wav,4130,4284,-154
11549,b-3_3198-3278_3215.wav,VTTS_b-3_3198-3278_3215.wav,8220,7953,267
11550,b-4_2000-5164_4607.wav,VTTS_b-4_2000-5164_4607.wav,3129,4063,-934
11551,b-3_2267-2349_2287.wav,VTTS_b-3_2267-2349_2287.wav,7280,11610,-4330
11552,b-4_501-1014_973.wav,VTTS_b-4_501-1014_973.wav,1130,1022,108
11553,b-4_2000-5164_2835.wav,VTTS_b-4_2000-5164_2835.wav,4360,4110,250
11554,b-3_98-195_132.wav,VTTS_b-3_98-195_132.wav,5840,5898,-58
11555,b-4_2000-5164_2712.wav,VTTS_b-4_2000-5164_2712.wav,3360,3611,-251
11556,b-2_2107-2193_2125.wav,VTTS_b-2_2107-2193_2125.wav,6610,10252,-3642
11557,b-3_6601-6700_6659.wav,VTTS_b-3_6601-6700_6659.wav,1360,1277,83
11558,b-3_5533-5638_5606.wav,VTTS_b-3_5533-5638_5606.wav,6480,6037,443
11559,b-4_2000-5164_5054.wav,VTTS_b-4_2000-5164_5054.wav,7527,6896,631
11560,b-1_276-376_321.wav,VTTS_b-1_276-376_321.wav,3770,4470,-700
11561,b-3_4607-5008_4771.wav,VTTS_b-3_4607-5008_4771.wav,2150,2635,-485
11562,b-1_2927-3025_2961.wav,VTTS_b-1_2927-3025_2961.wav,1980,2055,-75
11563,b-4_301-400_340.wav,VTTS_b-4_301-400_340.wav,6920,9439,-2519
11564,b-3_1666-1763_1726.wav,VTTS_b-3_1666-1763_1726.wav,7380,7558,-178
11565,b-1_2826-2926_2924.wav,VTTS_b-1_2826-2926_2924.wav,1970,2101,-131
11566,b-3_2855-2942_2925.wav,VTTS_b-3_2855-2942_2925.wav,3700,3924,-224
11567,b-3_6801-6900_6801.wav,VTTS_b-3_6801-6900_6801.wav,6800,6246,554
11568,b-4_2000-5164_4991.wav,VTTS_b-4_2000-5164_4991.wav,10089,9973,116
11569,b-4_1014-1100_1090.wav,VTTS_b-4_1014-1100_1090.wav,5620,5178,442
11570,b-3_501-930_858.wav,VTTS_b-3_501-930_858.wav,4110,3471,639
11571,b-3_980-1077_1021.wav,VTTS_b-3_980-1077_1021.wav,5870,6339,-469
11572,b-3_2943-3024_3017.wav,VTTS_b-3_2943-3024_3017.wav,1910,2090,-180
11573,b-4_2000-5164_2264.wav,VTTS_b-4_2000-5164_2264.wav,13980,11610,2370
11574,b-3_4425-4497_4490.wav,VTTS_b-3_4425-4497_4490.wav,3490,3367,123
11575,b-2_1223-1324_1323.wav,VTTS_b-2_1223-1324_1323.wav,7980,8754,-774
11576,b-2_1223-1324_1247.wav,VTTS_b-2_1223-1324_1247.wav,3550,4888,-1338
11577,b-1_794-1009_965.wav,VTTS_b-1_794-1009_965.wav,2580,2543,37
11578,b-2_2194-2208_2194.wav,VTTS_b-2_2194-2208_2194.wav,2730,2252,478
11579,b-4_501-1014_609.wav,VTTS_b-4_501-1014_609.wav,3480,2856,624
11580,b-4_2000-5164_3783.wav,VTTS_b-4_2000-5164_3783.wav,4480,3680,800
11581,b-3_1-97_20.wav,VTTS_b-3_1-97_20.wav,6070,5770,300
11582,b-4_401-500_437.wav,VTTS_b-4_401-500_437.wav,5370,5445,-75
11583,b-4_401-500_495.wav,VTTS_b-4_401-500_495.wav,3120,2856,264
11584,b-3_2524-2854_2643.wav,VTTS_b-3_2524-2854_2643.wav,3910,3855,55
11585,b-1_1717-1817_1781.wav,VTTS_b-1_1717-1817_1781.wav,2220,2252,-32
11586,b-4_2000-5164_4346.wav,VTTS_b-4_2000-5164_4346.wav,5636,4934,702
11587,b-3_1-97_67.wav,VTTS_b-3_1-97_67.wav,3350,3320,30
11588,b-1_794-1009_800.wav,VTTS_b-1_794-1009_800.wav,3730,3262,468
11589,b-1_4430-4465_4433.wav,VTTS_b-1_4430-4465_4433.wav,4000,4737,-737
11590,b-1_4070-4105_4090.wav,VTTS_b-1_4070-4105_4090.wav,1640,1741,-101
11591,b-3_4207-4314_4298.wav,VTTS_b-3_4207-4314_4298.wav,4450,3820,630
11592,b-1_1919-2017_1952.wav,VTTS_b-1_1919-2017_1952.wav,3080,2961,119
11593,b-2_1121-1222_1134.wav,VTTS_b-2_1121-1222_1134.wav,4220,3669,551
11594,b-1_3329-3429_3361.wav,VTTS_b-1_3329-3429_3361.wav,2550,2682,-132
11595,b-1_1010-1110_1067.wav,VTTS_b-1_1010-1110_1067.wav,1750,1730,20
11596,b-3_4001-4103_4035.wav,VTTS_b-3_4001-4103_4035.wav,9120,7918,1202
11597,b-4_2000-5164_3745.wav,VTTS_b-4_2000-5164_3745.wav,4500,4168,332
11598,b-3_3889-4000_3926.wav,VTTS_b-3_3889-4000_3926.wav,3540,3216,324
11599,b-2_713-814_765.wav,VTTS_b-2_713-814_765.wav,2140,2009,131
11600,b-1_794-1009_837.wav,VTTS_b-1_794-1009_837.wav,1100,1010,90
11601,b-3_1960-2000_1963.wav,VTTS_b-3_1960-2000_1963.wav,2900,2914,-14
11602,b-1_377-477_424.wav,VTTS_b-1_377-477_424.wav,1430,1382,48
11603,b-1_579-649_596.wav,VTTS_b-1_579-649_596.wav,4860,4865,-5
11604,b-3_6801-6900_6856.wav,VTTS_b-3_6801-6900_6856.wav,2660,3553,-893
11605,b-3_1321-1568_1533.wav,VTTS_b-3_1321-1568_1533.wav,3800,3634,166
11606,b-3_1079-1320_1156.wav,VTTS_b-3_1079-1320_1156.wav,6770,7059,-289
11607,b-4_1401-1505_1467.wav,VTTS_b-4_1401-1505_1467.wav,6550,6304,246
11608,b-3_4607-5008_4846.wav,VTTS_b-3_4607-5008_4846.wav,4350,4481,-131
11609,b-3_5533-5638_5612.wav,VTTS_b-3_5533-5638_5612.wav,10470,8870,1600
11610,b-1_2119-2219_2138.wav,VTTS_b-1_2119-2219_2138.wav,2780,3959,-1179
11611,b-3_98-195_166.wav,VTTS_b-3_98-195_166.wav,5110,6687,-1577
11612,b-4_2000-5164_3408.wav,VTTS_b-4_2000-5164_3408.wav,2188,2032,156
11613,b-3_1960-2000_1998.wav,VTTS_b-3_1960-2000_1998.wav,6160,5364,796
11614,b-4_501-1014_745.wav,VTTS_b-4_501-1014_745.wav,5850,5561,289
11615,b-4_1101-1220_1183.wav,VTTS_b-4_1101-1220_1183.wav,7510,7140,370
11616,b-4_2000-5164_2181.wav,VTTS_b-4_2000-5164_2181.wav,5280,4435,845
11617,b-3_6301-6400_6336.wav,VTTS_b-3_6301-6400_6336.wav,3440,2810,630
11618,b-2_203-304_260.wav,VTTS_b-2_203-304_260.wav,5350,6409,-1059
11619,b-4_2000-5164_3073.wav,VTTS_b-4_2000-5164_3073.wav,6816,6200,616
11620,b-2_1597-1698_1597.wav,VTTS_b-2_1597-1698_1597.wav,3610,3541,69
11621,b-4_1401-1505_1493.wav,VTTS_b-4_1401-1505_1493.wav,4330,3994,336
11622,b-4_2000-5164_3025.wav,VTTS_b-4_2000-5164_3025.wav,10133,11610,-1477
11623,b-4_2000-5164_4392.wav,VTTS_b-4_2000-5164_4392.wav,2284,2554,-270
11624,b-3_1321-1568_1392.wav,VTTS_b-3_1321-1568_1392.wav,5400,5492,-92
11625,b-2_305-406_330.wav,VTTS_b-2_305-406_330.wav,1440,1579,-139
11626,b-4_501-1014_541.wav,VTTS_b-4_501-1014_541.wav,3430,3460,-30
11627,b-2_2107-2193_2171.wav,VTTS_b-2_2107-2193_2171.wav,5870,4412,1458
11628,b-1_1717-1817_1774.wav,VTTS_b-1_1717-1817_1774.wav,1780,1695,85
11629,b-1_377-477_403.wav,VTTS_b-1_377-477_403.wav,3070,3320,-250
11630,b-3_5009-5427_5012.wav,VTTS_b-3_5009-5427_5012.wav,7210,6954,256
11631,b-3_1862-1959_1867.wav,VTTS_b-3_1862-1959_1867.wav,7800,9149,-1349
11632,b-3_6601-6700_6654.wav,VTTS_b-3_6601-6700_6654.wav,4160,4110,50
11633,b-4_2000-5164_4584.wav,VTTS_b-4_2000-5164_4584.wav,4336,4052,284
11634,b-4_501-1014_1000.wav,VTTS_b-4_501-1014_1000.wav,3790,3541,249
11635,b-2_1121-1222_1208.wav,VTTS_b-2_1121-1222_1208.wav,5190,5642,-452
11636,b-3_1764-1861_1809.wav,VTTS_b-3_1764-1861_1809.wav,5570,6711,-1141
11637,b-1_794-1009_870.wav,VTTS_b-1_794-1009_870.wav,1560,1393,167
11638,b-1_3329-3429_3353.wav,VTTS_b-1_3329-3429_3353.wav,4820,4075,745
11639,b-2_203-304_296.wav,VTTS_b-2_203-304_296.wav,4140,5236,-1096
11640,b-3_6801-6900_6872.wav,VTTS_b-3_6801-6900_6872.wav,4850,4899,-49
11641,b-2_713-814_750.wav,VTTS_b-2_713-814_750.wav,1160,964,196
11642,b-3_2855-2942_2941.wav,VTTS_b-3_2855-2942_2941.wav,5120,4957,163
11643,b-3_4104-4206_4153.wav,VTTS_b-3_4104-4206_4153.wav,7630,7163,467
11644,b-4_2000-5164_4784.wav,VTTS_b-4_2000-5164_4784.wav,7287,6385,902
11645,b-3_980-1077_1041.wav,VTTS_b-3_980-1077_1041.wav,3980,3878,102
11646,b-3_501-930_781.wav,VTTS_b-3_501-930_781.wav,5400,5085,315
11647,b-1_2523-2623_2598.wav,VTTS_b-1_2523-2623_2598.wav,2110,2229,-119
11648,b-3_1079-1320_1246.wav,VTTS_b-3_1079-1320_1246.wav,7020,7082,-62
11649,b-4_2000-5164_2746.wav,VTTS_b-4_2000-5164_2746.wav,3565,3262,303
11650,b-3_5639-5744_5698.wav,VTTS_b-3_5639-5744_5698.wav,7070,6606,464
11651,b-3_3198-3278_3237.wav,VTTS_b-3_3198-3278_3237.wav,3430,3855,-425
11652,b-3_501-930_728.wav,VTTS_b-3_501-930_728.wav,6140,5422,718
11653,b-1_1111-1211_1162.wav,VTTS_b-1_1111-1211_1162.wav,3570,3982,-412
11654,b-1_1010-1110_1061.wav,VTTS_b-1_1010-1110_1061.wav,7420,7105,315
11655,b-2_1121-1222_1212.wav,VTTS_b-2_1121-1222_1212.wav,1250,1149,101
11656,b-4_501-1014_805.wav,VTTS_b-4_501-1014_805.wav,5660,4981,679
11657,b-4_2000-5164_2720.wav,VTTS_b-4_2000-5164_2720.wav,3380,3785,-405
11658,b-4_151-300_219.wav,VTTS_b-4_151-300_219.wav,4950,10368,-5418
11659,b-3_1321-1568_1481.wav,VTTS_b-3_1321-1568_1481.wav,6400,6118,282
11660,b-1_4178-4213_4209.wav,VTTS_b-1_4178-4213_4209.wav,2110,1974,136
11661,b-4_501-1014_903.wav,VTTS_b-4_501-1014_903.wav,4070,3437,633
11662,b-1_4034-4069_4043.wav,VTTS_b-1_4034-4069_4043.wav,4330,4783,-453
11663,b-1_2725-2825_2746.wav,VTTS_b-1_2725-2825_2746.wav,1780,1916,-136
11664,b-3_3628-3714_3699.wav,VTTS_b-3_3628-3714_3699.wav,8700,8220,480
11665,b-3_3803-3888_3831.wav,VTTS_b-3_3803-3888_3831.wav,2770,2763,7
11666,b-3_6116-6215_6154.wav,VTTS_b-3_6116-6215_6154.wav,6850,7674,-824
11667,b-3_4104-4206_4133.wav,VTTS_b-3_4104-4206_4133.wav,9040,8998,42
11668,b-2_509-610_596.wav,VTTS_b-2_509-610_596.wav,1340,1428,-88
11669,b-3_5009-5427_5245.wav,VTTS_b-3_5009-5427_5245.wav,8680,8092,588
11670,b-3_501-930_751.wav,VTTS_b-3_501-930_751.wav,3960,3437,523
11671,b-4_1101-1220_1192.wav,VTTS_b-4_1101-1220_1192.wav,3720,4226,-506
11672,b-4_1707-1813_1746.wav,VTTS_b-4_1707-1813_1746.wav,6560,6084,476
11673,b-3_5639-5744_5744.wav,VTTS_b-3_5639-5744_5744.wav,2720,2937,-217
11674,b-4_2000-5164_4990.wav,VTTS_b-4_2000-5164_4990.wav,2803,2926,-123
11675,b-1_1010-1110_1083.wav,VTTS_b-1_1010-1110_1083.wav,4240,4087,153
11676,b-3_196-293_293.wav,VTTS_b-3_196-293_293.wav,4530,4296,234
11677,b-4_2000-5164_3044.wav,VTTS_b-4_2000-5164_3044.wav,3576,2891,685
11678,b-3_1321-1568_1337.wav,VTTS_b-3_1321-1568_1337.wav,8550,7988,562
11679,b-3_6801-6900_6827.wav,VTTS_b-3_6801-6900_6827.wav,4110,3657,453
11680,b-3_6501-6600_6506.wav,VTTS_b-3_6501-6600_6506.wav,3550,3646,-96
11681,b-3_3364-3453_3388.wav,VTTS_b-3_3364-3453_3388.wav,5380,5457,-77
11682,b-3_5957-6015_6010.wav,VTTS_b-3_5957-6015_6010.wav,4160,4307,-147
11683,b-2_1-100_7.wav,VTTS_b-2_1-100_7.wav,1030,1138,-108
11684,b-3_6116-6215_6130.wav,VTTS_b-3_6116-6215_6130.wav,6140,5248,892
11685,b-2_1325-1426_1347.wav,VTTS_b-2_1325-1426_1347.wav,9340,11297,-1957
11686,b-4_1601-1706_1625.wav,VTTS_b-4_1601-1706_1625.wav,2690,3344,-654
11687,b-3_3279-3363_3334.wav,VTTS_b-3_3279-3363_3334.wav,8050,7094,956
11688,b-3_501-930_582.wav,VTTS_b-3_501-930_582.wav,7350,6803,547
11689,b-3_2000-2088_2042.wav,VTTS_b-3_2000-2088_2042.wav,2670,2694,-24
11690,b-3_4001-4103_4008.wav,VTTS_b-3_4001-4103_4008.wav,3150,3077,73
11691,b-3_4315-4424_4321.wav,VTTS_b-3_4315-4424_4321.wav,2710,3239,-529
11692,b-4_2000-5164_4515.wav,VTTS_b-4_2000-5164_4515.wav,6039,5503,536
11693,b-1_3127-3227_3180.wav,VTTS_b-1_3127-3227_3180.wav,2520,2798,-278
11694,b-3_1321-1568_1465.wav,VTTS_b-3_1321-1568_1465.wav,6490,5724,766
11695,b-3_3279-3363_3363.wav,VTTS_b-3_3279-3363_3363.wav,4470,4516,-46
11696,b-1_4286-4321_4296.wav,VTTS_b-1_4286-4321_4296.wav,1690,1753,-63
11697,b-2_1121-1222_1178.wav,VTTS_b-2_1121-1222_1178.wav,2140,2752,-612
11698,b-4_2000-5164_2154.wav,VTTS_b-4_2000-5164_2154.wav,3905,11610,-7705
11699,b-3_2089-2176_2140.wav,VTTS_b-3_2089-2176_2140.wav,4100,4214,-114
11700,b-3_2350-2433_2393.wav,VTTS_b-3_2350-2433_2393.wav,13070,11610,1460
11701,b-1_74-174_169.wav,VTTS_b-1_74-174_169.wav,2030,2844,-814
11702,b-3_4104-4206_4201.wav,VTTS_b-3_4104-4206_4201.wav,7230,11610,-4380
11703,b-1_2422-2522_2500.wav,VTTS_b-1_2422-2522_2500.wav,2180,2009,171
11704,b-4_2000-5164_4775.wav,VTTS_b-4_2000-5164_4775.wav,5018,4783,235
11705,b-3_2350-2433_2403.wav,VTTS_b-3_2350-2433_2403.wav,3070,2995,75
11706,b-3_5009-5427_5051.wav,VTTS_b-3_5009-5427_5051.wav,5110,4714,396
11707,b-4_501-1014_520.wav,VTTS_b-4_501-1014_520.wav,3760,3123,637
11708,b-4_2000-5164_2470.wav,VTTS_b-4_2000-5164_2470.wav,2220,2159,61
11709,b-3_6401-6500_6405.wav,VTTS_b-3_6401-6500_6405.wav,6090,6107,-17
11710,b-3_2524-2854_2793.wav,VTTS_b-3_2524-2854_2793.wav,6850,7396,-546
11711,b-3_6301-6400_6343.wav,VTTS_b-3_6301-6400_6343.wav,2920,2752,168
11712,b-1_2725-2825_2801.wav,VTTS_b-1_2725-2825_2801.wav,4190,5004,-814
11713,b-3_4104-4206_4112.wav,VTTS_b-3_4104-4206_4112.wav,7200,8545,-1345
11714,b-4_2000-5164_3595.wav,VTTS_b-4_2000-5164_3595.wav,7795,7477,318
11715,b-1_1717-1817_1788.wav,VTTS_b-1_1717-1817_1788.wav,1590,1498,92
11716,b-1_3935-4033_3978.wav,VTTS_b-1_3935-4033_3978.wav,2750,3146,-396
11717,b-2_203-304_253.wav,VTTS_b-2_203-304_253.wav,1300,1451,-151
11718,b-1_377-477_404.wav,VTTS_b-1_377-477_404.wav,2040,2020,20
11719,b-4_1707-1813_1718.wav,VTTS_b-4_1707-1813_1718.wav,5500,5341,159
11720,b-4_2000-5164_4401.wav,VTTS_b-4_2000-5164_4401.wav,6580,5584,996
11721,b-4_53-150_123.wav,VTTS_b-4_53-150_123.wav,7850,8243,-393
11722,b-4_2000-5164_2574.wav,VTTS_b-4_2000-5164_2574.wav,3390,3390,0
11723,b-3_2000-2088_2002.wav,VTTS_b-3_2000-2088_2002.wav,4320,4249,71
11724,b-3_4607-5008_4655.wav,VTTS_b-3_4607-5008_4655.wav,3450,4087,-637
11725,b-3_1321-1568_1539.wav,VTTS_b-3_1321-1568_1539.wav,5920,5503,417
11726,b-3_6601-6700_6672.wav,VTTS_b-3_6601-6700_6672.wav,5720,5817,-97
11727,b-4_1014-1100_1086.wav,VTTS_b-4_1014-1100_1086.wav,4380,4075,305
11728,b-2_2311-2412_2349.wav,VTTS_b-2_2311-2412_2349.wav,1310,1231,79
11729,b-1_1313-1413_1355.wav,VTTS_b-1_1313-1413_1355.wav,1250,1219,31
11730,b-3_6900-7016_6929.wav,VTTS_b-3_6900-7016_6929.wav,3460,3320,140
11731,b-4_2000-5164_4451.wav,VTTS_b-4_2000-5164_4451.wav,7753,9149,-1396
11732,b-2_1597-1698_1665.wav,VTTS_b-2_1597-1698_1665.wav,2790,2705,85
11733,b-3_5533-5638_5586.wav,VTTS_b-3_5533-5638_5586.wav,5350,5352,-2
11734,b-3_501-930_601.wav,VTTS_b-3_501-930_601.wav,8480,7872,608
11735,b-1_4286-4321_4289.wav,VTTS_b-1_4286-4321_4289.wav,5620,5584,36
11736,b-2_1019-1120_1060.wav,VTTS_b-2_1019-1120_1060.wav,1430,1451,-21
11737,b-3_3279-3363_3324.wav,VTTS_b-3_3279-3363_3324.wav,11540,11610,-70
11738,b-3_3279-3363_3289.wav,VTTS_b-3_3279-3363_3289.wav,3740,4923,-1183
11739,b-4_2000-5164_2300.wav,VTTS_b-4_2000-5164_2300.wav,8290,8266,24
11740,b-1_3733-3833_3814.wav,VTTS_b-1_3733-3833_3814.wav,1190,1173,17
11741,b-4_2000-5164_4744.wav,VTTS_b-4_2000-5164_4744.wav,2451,2659,-208
11742,b-4_401-500_416.wav,VTTS_b-4_401-500_416.wav,7590,7047,543
11743,b-4_1014-1100_1044.wav,VTTS_b-4_1014-1100_1044.wav,5320,5956,-636
11744,b-3_2350-2433_2367.wav,VTTS_b-3_2350-2433_2367.wav,4730,4586,144
11745,b-3_6116-6215_6204.wav,VTTS_b-3_6116-6215_6204.wav,3400,3808,-408
11746,b-4_2000-5164_5156.wav,VTTS_b-4_2000-5164_5156.wav,2044,1950,94
11747,b-3_3538-3627_3538.wav,VTTS_b-3_3538-3627_3538.wav,7800,7581,219
11748,b-4_151-300_284.wav,VTTS_b-4_151-300_284.wav,5690,5317,373
11749,b-4_2000-5164_3284.wav,VTTS_b-4_2000-5164_3284.wav,4296,4772,-476
11750,b-3_2524-2854_2850.wav,VTTS_b-3_2524-2854_2850.wav,9400,8464,936
11751,b-3_4207-4314_4224.wav,VTTS_b-3_4207-4314_4224.wav,3290,3216,74
11752,b-2_1019-1120_1068.wav,VTTS_b-2_1019-1120_1068.wav,1750,1707,43
11753,b-2_815-916_879.wav,VTTS_b-2_815-916_879.wav,3470,3483,-13
11754,b-3_5957-6015_5979.wav,VTTS_b-3_5957-6015_5979.wav,6310,5956,354
11755,b-3_1079-1320_1316.wav,VTTS_b-3_1079-1320_1316.wav,6610,5968,642
11756,b-4_2000-5164_4427.wav,VTTS_b-4_2000-5164_4427.wav,3933,3820,113
11757,b-2_1325-1426_1337.wav,VTTS_b-2_1325-1426_1337.wav,1270,1219,51
11758,b-1_3430-3530_3492.wav,VTTS_b-1_3430-3530_3492.wav,1720,1625,95
11759,b-1_1818-1918_1867.wav,VTTS_b-1_1818-1918_1867.wav,2570,2775,-205
11760,b-4_1101-1220_1102.wav,VTTS_b-4_1101-1220_1102.wav,2850,2415,435
11761,b-4_2000-5164_3564.wav,VTTS_b-4_2000-5164_3564.wav,1406,1126,280
11762,b-1_1313-1413_1315.wav,VTTS_b-1_1313-1413_1315.wav,3680,3646,34
11763,b-4_2000-5164_2004.wav,VTTS_b-4_2000-5164_2004.wav,4187,4714,-527
11764,b-1_2321-2421_2327.wav,VTTS_b-1_2321-2421_2327.wav,2330,2682,-352
11765,b-1_1-73_47.wav,VTTS_b-1_1-73_47.wav,1580,2055,-475
11766,b-3_501-930_581.wav,VTTS_b-3_501-930_581.wav,10520,9195,1325
11767,b-1_2018-2118_2047.wav,VTTS_b-1_2018-2118_2047.wav,3450,3576,-126
11768,b-3_1079-1320_1101.wav,VTTS_b-3_1079-1320_1101.wav,8440,8022,418
11769,b-4_2000-5164_2329.wav,VTTS_b-4_2000-5164_2329.wav,6300,7140,-840
11770,b-3_5009-5427_5034.wav,VTTS_b-3_5009-5427_5034.wav,3070,3506,-436
11771,b-1_3329-3429_3375.wav,VTTS_b-1_3329-3429_3375.wav,3610,3913,-303
11772,b-4_2000-5164_4863.wav,VTTS_b-4_2000-5164_4863.wav,6382,7523,-1141
11773,b-4_2000-5164_3935.wav,VTTS_b-4_2000-5164_3935.wav,7682,8185,-503
11774,b-4_2000-5164_4866.wav,VTTS_b-4_2000-5164_4866.wav,4232,3622,610
11775,b-3_1079-1320_1083.wav,VTTS_b-3_1079-1320_1083.wav,5510,5399,111
11776,b-3_2943-3024_3007.wav,VTTS_b-3_2943-3024_3007.wav,6140,6711,-571
11777,b-1_3127-3227_3130.wav,VTTS_b-1_3127-3227_3130.wav,2780,2810,-30
11778,b-4_2000-5164_4446.wav,VTTS_b-4_2000-5164_4446.wav,6976,4911,2065
11779,b-3_3364-3453_3419.wav,VTTS_b-3_3364-3453_3419.wav,4070,4191,-121
11780,b-2_2311-2412_2373.wav,VTTS_b-2_2311-2412_2373.wav,1210,1207,3
11781,b-3_501-930_730.wav,VTTS_b-3_501-930_730.wav,1000,987,13
11782,b-4_1707-1813_1785.wav,VTTS_b-4_1707-1813_1785.wav,7130,7744,-614
11783,b-4_2000-5164_4496.wav,VTTS_b-4_2000-5164_4496.wav,4120,5329,-1209
11784,b-3_2524-2854_2831.wav,VTTS_b-3_2524-2854_2831.wav,2790,2844,-54
11785,b-4_2000-5164_3623.wav,VTTS_b-4_2000-5164_3623.wav,3897,4540,-643
11786,b-3_5428-5533_5492.wav,VTTS_b-3_5428-5533_5492.wav,4490,4667,-177
11787,b-4_2000-5164_2822.wav,VTTS_b-4_2000-5164_2822.wav,3120,3262,-142
11788,b-4_2000-5164_4374.wav,VTTS_b-4_2000-5164_4374.wav,2161,2357,-196
11789,b-4_151-300_216.wav,VTTS_b-4_151-300_216.wav,2200,1962,238
11790,b-1_4214-4285_4280.wav,VTTS_b-1_4214-4285_4280.wav,5250,6188,-938
11791,b-3_2089-2176_2120.wav,VTTS_b-3_2089-2176_2120.wav,5360,4899,461
11792,b-4_2000-5164_4448.wav,VTTS_b-4_2000-5164_4448.wav,5529,4981,548
11793,b-3_5533-5638_5623.wav,VTTS_b-3_5533-5638_5623.wav,2160,1869,291
11794,b-3_3538-3627_3622.wav,VTTS_b-3_3538-3627_3622.wav,7980,7999,-19
11795,b-3_1666-1763_1707.wav,VTTS_b-3_1666-1763_1707.wav,3400,3866,-466
11796,b-4_1506-1600_1514.wav,VTTS_b-4_1506-1600_1514.wav,4540,3657,883
11797,b-4_1301-1400_1357.wav,VTTS_b-4_1301-1400_1357.wav,7960,8731,-771
11798,b-3_2177-2266_2222.wav,VTTS_b-3_2177-2266_2222.wav,6680,5828,852
11799,b-1_2826-2926_2836.wav,VTTS_b-1_2826-2926_2836.wav,3480,3216,264
11800,b-4_2000-5164_4228.wav,VTTS_b-4_2000-5164_4228.wav,1568,1881,-313
11801,b-2_1325-1426_1413.wav,VTTS_b-2_1325-1426_1413.wav,7830,11610,-3780
11802,b-4_2000-5164_3017.wav,VTTS_b-4_2000-5164_3017.wav,6082,6246,-164
11803,b-3_6801-6900_6837.wav,VTTS_b-3_6801-6900_6837.wav,5270,4667,603
11804,b-3_1321-1568_1509.wav,VTTS_b-3_1321-1568_1509.wav,6790,6409,381
11805,b-4_2000-5164_4361.wav,VTTS_b-4_2000-5164_4361.wav,1628,1509,119
11806,b-3_1764-1861_1851.wav,VTTS_b-3_1764-1861_1851.wav,6020,5712,308
11807,b-3_6401-6500_6498.wav,VTTS_b-3_6401-6500_6498.wav,2860,2554,306
11808,b-1_794-1009_829.wav,VTTS_b-1_794-1009_829.wav,1890,1567,323
11809,b-1_3329-3429_3365.wav,VTTS_b-1_3329-3429_3365.wav,1800,1683,117
11810,b-1_3430-3530_3525.wav,VTTS_b-1_3430-3530_3525.wav,2500,2705,-205
11811,b-3_6601-6700_6620.wav,VTTS_b-3_6601-6700_6620.wav,3410,3297,113
11812,b-3_5009-5427_5197.wav,VTTS_b-3_5009-5427_5197.wav,1890,1904,-14
11813,b-3_5853-5956_5934.wav,VTTS_b-3_5853-5956_5934.wav,4340,4098,242
11814,b-1_794-1009_902.wav,VTTS_b-1_794-1009_902.wav,4810,4667,143
11815,b-1_4286-4321_4294.wav,VTTS_b-1_4286-4321_4294.wav,1740,1997,-257
11816,b-1_579-649_644.wav,VTTS_b-1_579-649_644.wav,2760,2728,32
11817,b-4_501-1014_720.wav,VTTS_b-4_501-1014_720.wav,2280,2775,-495
11818,b-2_1699-1800_1740.wav,VTTS_b-2_1699-1800_1740.wav,1000,952,48
11819,b-3_2943-3024_2986.wav,VTTS_b-3_2943-3024_2986.wav,3560,3622,-62
11820,b-3_1079-1320_1131.wav,VTTS_b-3_1079-1320_1131.wav,2630,2531,99
11821,b-1_2321-2421_2353.wav,VTTS_b-1_2321-2421_2353.wav,3230,2949,281
11822,b-4_1506-1600_1518.wav,VTTS_b-4_1506-1600_1518.wav,4820,3855,965
11823,b-3_2524-2854_2744.wav,VTTS_b-3_2524-2854_2744.wav,6980,6165,815
11824,b-1_3632-3732_3708.wav,VTTS_b-1_3632-3732_3708.wav,2380,2206,174
11825,b-3_3364-3453_3424.wav,VTTS_b-3_3364-3453_3424.wav,6160,5317,843
11826,b-2_2209-2310_2211.wav,VTTS_b-2_2209-2310_2211.wav,5030,5341,-311
11827,b-2_1699-1800_1718.wav,VTTS_b-2_1699-1800_1718.wav,3330,3088,242
11828,b-3_4607-5008_4704.wav,VTTS_b-3_4607-5008_4704.wav,4990,4214,776
11829,b-3_5639-5744_5699.wav,VTTS_b-3_5639-5744_5699.wav,5010,4458,552
11830,b-4_1101-1220_1155.wav,VTTS_b-4_1101-1220_1155.wav,4280,6432,-2152
11831,b-4_2000-5164_3476.wav,VTTS_b-4_2000-5164_3476.wav,4037,4098,-61
11832,b-3_196-293_288.wav,VTTS_b-3_196-293_288.wav,4600,3019,1581
11833,b-3_2524-2854_2769.wav,VTTS_b-3_2524-2854_2769.wav,3510,3460,50
11834,b-3_1079-1320_1132.wav,VTTS_b-3_1079-1320_1132.wav,6340,6502,-162
11835,b-2_815-916_816.wav,VTTS_b-2_815-916_816.wav,6910,6153,757
11836,b-1_3430-3530_3452.wav,VTTS_b-1_3430-3530_3452.wav,1590,1498,92
11837,b-1_2018-2118_2068.wav,VTTS_b-1_2018-2118_2068.wav,1560,2519,-959
11838,b-3_2434-2523_2474.wav,VTTS_b-3_2434-2523_2474.wav,8260,7221,1039
11839,b-3_3279-3363_3291.wav,VTTS_b-3_3279-3363_3291.wav,7000,6467,533
11840,b-4_2000-5164_3182.wav,VTTS_b-4_2000-5164_3182.wav,7523,9067,-1544
11841,b-3_2434-2523_2486.wav,VTTS_b-3_2434-2523_2486.wav,6270,8208,-1938
11842,b-3_3025-3111_3096.wav,VTTS_b-3_3025-3111_3096.wav,7280,6908,372
11843,b-1_4430-4465_4440.wav,VTTS_b-1_4430-4465_4440.wav,1670,1904,-234
11844,b-3_3025-3111_3041.wav,VTTS_b-3_3025-3111_3041.wav,7650,7512,138
11845,b-4_1301-1400_1314.wav,VTTS_b-4_1301-1400_1314.wav,3980,3727,253
11846,b-4_1506-1600_1587.wav,VTTS_b-4_1506-1600_1587.wav,3180,3274,-94
11847,b-2_101-202_102.wav,VTTS_b-2_101-202_102.wav,1580,1521,59
11848,b-4_2000-5164_5044.wav,VTTS_b-4_2000-5164_5044.wav,5727,7047,-1320
11849,b-3_1960-2000_1983.wav,VTTS_b-3_1960-2000_1983.wav,8390,7419,971
11850,b-1_1313-1413_1392.wav,VTTS_b-1_1313-1413_1392.wav,5450,4876,574
11851,b-3_3715-3802_3760.wav,VTTS_b-3_3715-3802_3760.wav,5080,4621,459
11852,b-1_794-1009_838.wav,VTTS_b-1_794-1009_838.wav,1800,1718,82
11853,b-3_5745-5852_5809.wav,VTTS_b-3_5745-5852_5809.wav,6930,7094,-164
11854,b-1_3834-3934_3889.wav,VTTS_b-1_3834-3934_3889.wav,3920,5619,-1699
11855,b-4_2000-5164_4289.wav,VTTS_b-4_2000-5164_4289.wav,3001,2705,296
11856,b-3_2524-2854_2852.wav,VTTS_b-3_2524-2854_2852.wav,3370,3181,189
11857,b-2_1223-1324_1305.wav,VTTS_b-2_1223-1324_1305.wav,2220,2287,-67
11858,b-1_3329-3429_3344.wav,VTTS_b-1_3329-3429_3344.wav,3720,4354,-634
11859,b-4_2000-5164_2879.wav,VTTS_b-4_2000-5164_2879.wav,12640,11610,1030
11860,b-3_5853-5956_5875.wav,VTTS_b-3_5853-5956_5875.wav,6430,7488,-1058
11861,b-1_1818-1918_1912.wav,VTTS_b-1_1818-1918_1912.wav,2570,2403,167
11862,b-1_74-174_107.wav,VTTS_b-1_74-174_107.wav,4700,5352,-652
11863,b-1_1515-1615_1570.wav,VTTS_b-1_1515-1615_1570.wav,5490,4481,1009
11864,b-2_2413-2500_2423.wav,VTTS_b-2_2413-2500_2423.wav,3040,2844,196
11865,b-4_2000-5164_3417.wav,VTTS_b-4_2000-5164_3417.wav,7684,8185,-501
11866,b-3_3364-3453_3370.wav,VTTS_b-3_3364-3453_3370.wav,4030,3982,48
11867,b-1_4070-4105_4095.wav,VTTS_b-1_4070-4105_4095.wav,3130,3971,-841
11868,b-3_501-930_563.wav,VTTS_b-3_501-930_563.wav,4160,3936,224
11869,b-2_917-1018_985.wav,VTTS_b-2_917-1018_985.wav,4490,4574,-84
11870,b-4_2000-5164_2799.wav,VTTS_b-4_2000-5164_2799.wav,2785,2705,80
11871,b-1_1414-1514_1444.wav,VTTS_b-1_1414-1514_1444.wav,2110,2055,55
11872,b-1_478-578_525.wav,VTTS_b-1_478-578_525.wav,2480,2949,-469
11873,b-4_2000-5164_4840.wav,VTTS_b-4_2000-5164_4840.wav,1692,1289,403
11874,b-3_2524-2854_2598.wav,VTTS_b-3_2524-2854_2598.wav,4450,4145,305
11875,b-1_3834-3934_3912.wav,VTTS_b-1_3834-3934_3912.wav,1170,1126,44
11876,b-4_2000-5164_4085.wav,VTTS_b-4_2000-5164_4085.wav,6082,7024,-942
11877,b-3_5009-5427_5084.wav,VTTS_b-3_5009-5427_5084.wav,8610,10112,-1502
11878,b-3_98-195_113.wav,VTTS_b-3_98-195_113.wav,2720,2717,3
11879,b-4_2000-5164_4087.wav,VTTS_b-4_2000-5164_4087.wav,3298,3355,-57
11880,b-3_5853-5956_5890.wav,VTTS_b-3_5853-5956_5890.wav,3360,2426,934
11881,b-3_4607-5008_4912.wav,VTTS_b-3_4607-5008_4912.wav,6960,6803,157
11882,b-4_2000-5164_4200.wav,VTTS_b-4_2000-5164_4200.wav,2954,2519,435
11883,b-3_2943-3024_2974.wav,VTTS_b-3_2943-3024_2974.wav,2490,2554,-64
11884,b-4_1814-1900_1857.wav,VTTS_b-4_1814-1900_1857.wav,8740,8220,520
11885,b-3_3112-3197_3159.wav,VTTS_b-3_3112-3197_3159.wav,5920,6536,-616
11886,b-3_2524-2854_2533.wav,VTTS_b-3_2524-2854_2533.wav,5610,4853,757
11887,b-1_377-477_434.wav,VTTS_b-1_377-477_434.wav,1560,2206,-646
11888,b-1_4106-4141_4115.wav,VTTS_b-1_4106-4141_4115.wav,2020,2032,-12
11889,b-3_2434-2523_2482.wav,VTTS_b-3_2434-2523_2482.wav,6900,5968,932
11890,b-3_2267-2349_2286.wav,VTTS_b-3_2267-2349_2286.wav,8540,8022,518
11891,b-3_3364-3453_3379.wav,VTTS_b-3_3364-3453_3379.wav,2080,2183,-103
11892,b-4_1601-1706_1621.wav,VTTS_b-4_1601-1706_1621.wav,9440,9358,82
11893,b-3_6401-6500_6469.wav,VTTS_b-3_6401-6500_6469.wav,8740,8034,706
11894,b-1_1818-1918_1886.wav,VTTS_b-1_1818-1918_1886.wav,1230,1138,92
11895,b-2_509-610_566.wav,VTTS_b-2_509-610_566.wav,1630,2612,-982
11896,b-1_3531-3631_3604.wav,VTTS_b-1_3531-3631_3604.wav,1730,1916,-186
11897,b-3_2350-2433_2406.wav,VTTS_b-3_2350-2433_2406.wav,4810,4888,-78
11898,b-3_4104-4206_4122.wav,VTTS_b-3_4104-4206_4122.wav,6760,6896,-136
11899,b-4_1101-1220_1162.wav,VTTS_b-4_1101-1220_1162.wav,1870,1892,-22
11900,b-2_1699-1800_1707.wav,VTTS_b-2_1699-1800_1707.wav,2050,1904,146
11901,b-4_2000-5164_2760.wav,VTTS_b-4_2000-5164_2760.wav,4420,4354,66
11902,b-2_917-1018_967.wav,VTTS_b-2_917-1018_967.wav,6000,6943,-943
11903,b-2_1427-1562_1487.wav,VTTS_b-2_1427-1562_1487.wav,8720,11610,-2890
11904,b-1_3834-3934_3841.wav,VTTS_b-1_3834-3934_3841.wav,2960,3344,-384
11905,b-4_1101-1220_1114.wav,VTTS_b-4_1101-1220_1114.wav,1850,1683,167
11906,b-4_2000-5164_2891.wav,VTTS_b-4_2000-5164_2891.wav,6090,6153,-63
11907,b-3_3538-3627_3589.wav,VTTS_b-3_3538-3627_3589.wav,6880,7198,-318
11908,b-3_5639-5744_5687.wav,VTTS_b-3_5639-5744_5687.wav,4610,4481,129
11909,b-3_3198-3278_3251.wav,VTTS_b-3_3198-3278_3251.wav,6920,6920,0
11910,b-3_2000-2088_2016.wav,VTTS_b-3_2000-2088_2016.wav,8280,9056,-776
11911,b-1_4070-4105_4076.wav,VTTS_b-1_4070-4105_4076.wav,1930,2426,-496
11912,b-4_2000-5164_4239.wav,VTTS_b-4_2000-5164_4239.wav,5956,6339,-383
11913,b-4_2000-5164_2730.wav,VTTS_b-4_2000-5164_2730.wav,4895,5654,-759
11914,b-1_2119-2219_2139.wav,VTTS_b-1_2119-2219_2139.wav,1540,1509,31
11915,b-3_5853-5956_5871.wav,VTTS_b-3_5853-5956_5871.wav,3320,3320,0
11916,b-3_3279-3363_3344.wav,VTTS_b-3_3279-3363_3344.wav,4260,3808,452
11917,b-1_1616-1716_1649.wav,VTTS_b-1_1616-1716_1649.wav,1120,1115,5
11918,b-3_196-293_242.wav,VTTS_b-3_196-293_242.wav,1850,1765,85
11919,b-3_1764-1861_1783.wav,VTTS_b-3_1764-1861_1783.wav,5640,6177,-537
11920,b-3_4607-5008_4923.wav,VTTS_b-3_4607-5008_4923.wav,5530,5886,-356
11921,b-3_1321-1568_1494.wav,VTTS_b-3_1321-1568_1494.wav,3660,3495,165
11922,b-2_1121-1222_1139.wav,VTTS_b-2_1121-1222_1139.wav,2500,3611,-1111
11923,b-4_1814-1900_1840.wav,VTTS_b-4_1814-1900_1840.wav,4190,3413,777
11924,b-4_1901-2000_1954.wav,VTTS_b-4_1901-2000_1954.wav,3890,3994,-104
11925,b-1_3228-3328_3246.wav,VTTS_b-1_3228-3328_3246.wav,3670,4261,-591
11926,b-1_3935-4033_3987.wav,VTTS_b-1_3935-4033_3987.wav,2050,1962,88
11927,b-4_2000-5164_2188.wav,VTTS_b-4_2000-5164_2188.wav,5810,6049,-239
11928,b-1_3733-3833_3773.wav,VTTS_b-1_3733-3833_3773.wav,3010,2868,142
11929,b-3_501-930_809.wav,VTTS_b-3_501-930_809.wav,3370,3007,363
11930,b-2_1903-2038_1947.wav,VTTS_b-2_1903-2038_1947.wav,4600,4598,2
11931,b-1_3127-3227_3138.wav,VTTS_b-1_3127-3227_3138.wav,1190,1068,122
11932,b-3_6217-6274_6251.wav,VTTS_b-3_6217-6274_6251.wav,4220,4284,-64
11933,b-2_917-1018_973.wav,VTTS_b-2_917-1018_973.wav,2000,2148,-148
11934,b-4_2000-5164_2837.wav,VTTS_b-4_2000-5164_2837.wav,6020,5805,215
11935,b-2_203-304_225.wav,VTTS_b-2_203-304_225.wav,2990,2891,99
11936,b-4_2000-5164_2897.wav,VTTS_b-4_2000-5164_2897.wav,5000,4598,402
11937,b-4_2000-5164_3444.wav,VTTS_b-4_2000-5164_3444.wav,4670,5108,-438
11938,b-4_501-1014_538.wav,VTTS_b-4_501-1014_538.wav,10360,9172,1188
11939,b-4_501-1014_872.wav,VTTS_b-4_501-1014_872.wav,3600,3425,175
11940,b-1_2826-2926_2878.wav,VTTS_b-1_2826-2926_2878.wav,1370,1358,12
11941,b-3_5009-5427_5412.wav,VTTS_b-3_5009-5427_5412.wav,4280,5886,-1606
11942,b-4_2000-5164_3654.wav,VTTS_b-4_2000-5164_3654.wav,4803,5375,-572
11943,b-3_3803-3888_3888.wav,VTTS_b-3_3803-3888_3888.wav,3520,3379,141
11944,b-3_5428-5533_5448.wav,VTTS_b-3_5428-5533_5448.wav,12240,11610,630
11945,b-3_2434-2523_2507.wav,VTTS_b-3_2434-2523_2507.wav,3290,4029,-739
11946,b-3_2000-2088_2055.wav,VTTS_b-3_2000-2088_2055.wav,4210,4516,-306
11947,b-1_175-275_204.wav,VTTS_b-1_175-275_204.wav,1760,1428,332
11948,b-4_1506-1600_1545.wav,VTTS_b-4_1506-1600_1545.wav,3530,3994,-464
11949,b-4_2000-5164_3567.wav,VTTS_b-4_2000-5164_3567.wav,5414,4807,607
11950,b-4_2000-5164_3397.wav,VTTS_b-4_2000-5164_3397.wav,956,940,16
11951,b-4_2000-5164_3330.wav,VTTS_b-4_2000-5164_3330.wav,2884,2670,214
11952,b-4_2000-5164_3172.wav,VTTS_b-4_2000-5164_3172.wav,3332,3181,151
11953,b-2_509-610_529.wav,VTTS_b-2_509-610_529.wav,2030,1892,138
11954,b-1_794-1009_819.wav,VTTS_b-1_794-1009_819.wav,3180,3402,-222
11955,b-2_1597-1698_1675.wav,VTTS_b-2_1597-1698_1675.wav,1520,1440,80
11956,b-1_3228-3328_3263.wav,VTTS_b-1_3228-3328_3263.wav,2800,2299,501
11957,b-4_1601-1706_1674.wav,VTTS_b-4_1601-1706_1674.wav,4120,3738,382
11958,b-4_2000-5164_2431.wav,VTTS_b-4_2000-5164_2431.wav,5080,5770,-690
11959,b-4_501-1014_926.wav,VTTS_b-4_501-1014_926.wav,8010,11610,-3600
11960,b-4_2000-5164_2345.wav,VTTS_b-4_2000-5164_2345.wav,13330,11610,1720
11961,b-4_501-1014_727.wav,VTTS_b-4_501-1014_727.wav,5350,5341,9
11962,b-1_3329-3429_3366.wav,VTTS_b-1_3329-3429_3366.wav,2270,2241,29
11963,b-3_501-930_882.wav,VTTS_b-3_501-930_882.wav,7070,6687,383
11964,b-3_5853-5956_5866.wav,VTTS_b-3_5853-5956_5866.wav,3720,3053,667
11965,b-2_1019-1120_1045.wav,VTTS_b-2_1019-1120_1045.wav,1560,1997,-437
11966,b-3_3889-4000_3913.wav,VTTS_b-3_3889-4000_3913.wav,4030,4447,-417
11967,b-3_1666-1763_1677.wav,VTTS_b-3_1666-1763_1677.wav,6590,6444,146
11968,b-1_3127-3227_3195.wav,VTTS_b-1_3127-3227_3195.wav,2490,3332,-842
11969,b-4_2000-5164_4679.wav,VTTS_b-4_2000-5164_4679.wav,2754,2856,-102
11970,b-4_2000-5164_3802.wav,VTTS_b-4_2000-5164_3802.wav,7142,6618,524
11971,b-3_1568-1665_1583.wav,VTTS_b-3_1568-1665_1583.wav,2700,2635,65
11972,b-2_305-406_305.wav,VTTS_b-2_305-406_305.wav,1320,1091,229
11973,b-3_4607-5008_4997.wav,VTTS_b-3_4607-5008_4997.wav,5480,5840,-360
11974,b-3_4498-4605_4576.wav,VTTS_b-3_4498-4605_4576.wav,4620,5422,-802
11975,b-4_2000-5164_4692.wav,VTTS_b-4_2000-5164_4692.wav,7171,7094,77
11976,b-4_2000-5164_4165.wav,VTTS_b-4_2000-5164_4165.wav,4825,5236,-411
11977,b-3_2524-2854_2538.wav,VTTS_b-3_2524-2854_2538.wav,3890,3506,384
11978,b-4_2000-5164_4876.wav,VTTS_b-4_2000-5164_4876.wav,3635,3587,48
11979,b-1_3228-3328_3236.wav,VTTS_b-1_3228-3328_3236.wav,5410,5492,-82
11980,b-4_2000-5164_3635.wav,VTTS_b-4_2000-5164_3635.wav,3996,3831,165
11981,b-3_2524-2854_2548.wav,VTTS_b-3_2524-2854_2548.wav,2690,2717,-27
11982,b-4_301-400_360.wav,VTTS_b-4_301-400_360.wav,2100,2345,-245
11983,b-4_2000-5164_2805.wav,VTTS_b-4_2000-5164_2805.wav,8500,9149,-649
11984,b-4_1707-1813_1727.wav,VTTS_b-4_1707-1813_1727.wav,6800,6258,542
11985,b-1_3834-3934_3865.wav,VTTS_b-1_3834-3934_3865.wav,3520,2926,594
11986,b-3_3025-3111_3093.wav,VTTS_b-3_3025-3111_3093.wav,4890,4598,292
11987,b-2_815-916_835.wav,VTTS_b-2_815-916_835.wav,1700,1776,-76
11988,b-3_6401-6500_6408.wav,VTTS_b-3_6401-6500_6408.wav,2350,2531,-181
11989,b-3_2267-2349_2283.wav,VTTS_b-3_2267-2349_2283.wav,4720,4365,355
11990,b-4_2000-5164_2483.wav,VTTS_b-4_2000-5164_2483.wav,4200,6269,-2069
11991,b-4_1901-2000_1906.wav,VTTS_b-4_1901-2000_1906.wav,9720,10739,-1019
11992,b-4_2000-5164_4660.wav,VTTS_b-4_2000-5164_4660.wav,6327,5631,696
11993,b-3_931-979_962.wav,VTTS_b-3_931-979_962.wav,5910,5875,35
11994,b-4_151-300_179.wav,VTTS_b-4_151-300_179.wav,4870,4702,168
11995,b-4_2000-5164_2515.wav,VTTS_b-4_2000-5164_2515.wav,5290,5689,-399
11996,b-4_2000-5164_3332.wav,VTTS_b-4_2000-5164_3332.wav,2274,2322,-48
11997,b-2_1801-1902_1838.wav,VTTS_b-2_1801-1902_1838.wav,1210,1184,26
11998,b-3_2855-2942_2868.wav,VTTS_b-3_2855-2942_2868.wav,6340,6502,-162
11999,b-1_1616-1716_1684.wav,VTTS_b-1_1616-1716_1684.wav,1940,1823,117
12000,b-3_3538-3627_3606.wav,VTTS_b-3_3538-3627_3606.wav,7320,7639,-319
12001,b-2_2209-2310_2301.wav,VTTS_b-2_2209-2310_2301.wav,2240,2183,57
12002,b-3_3112-3197_3168.wav,VTTS_b-3_3112-3197_3168.wav,7860,8266,-406
12003,b-2_2073-2106_2076.wav,VTTS_b-2_2073-2106_2076.wav,3220,2868,352
12004,b-3_5009-5427_5216.wav,VTTS_b-3_5009-5427_5216.wav,3470,2879,591
12005,b-3_3889-4000_3909.wav,VTTS_b-3_3889-4000_3909.wav,5190,5700,-510
12006,b-1_4358-4393_4361.wav,VTTS_b-1_4358-4393_4361.wav,2480,2856,-376
12007,b-1_3228-3328_3303.wav,VTTS_b-1_3228-3328_3303.wav,1360,1393,-33
12008,b-2_815-916_856.wav,VTTS_b-2_815-916_856.wav,2800,2868,-68
12009,b-4_501-1014_795.wav,VTTS_b-4_501-1014_795.wav,7960,7755,205
12010,b-3_6801-6900_6883.wav,VTTS_b-3_6801-6900_6883.wav,4660,4632,28
12011,b-4_2000-5164_2600.wav,VTTS_b-4_2000-5164_2600.wav,5065,4481,584
12012,b-3_3112-3197_3169.wav,VTTS_b-3_3112-3197_3169.wav,7050,9509,-2459
12013,b-3_5533-5638_5614.wav,VTTS_b-3_5533-5638_5614.wav,7860,8185,-325
12014,b-1_2119-2219_2207.wav,VTTS_b-1_2119-2219_2207.wav,2260,2113,147
12015,b-4_2000-5164_5086.wav,VTTS_b-4_2000-5164_5086.wav,4768,5259,-491
12016,b-2_1597-1698_1698.wav,VTTS_b-2_1597-1698_1698.wav,5860,5654,206
12017,b-4_501-1014_931.wav,VTTS_b-4_501-1014_931.wav,8010,7674,336
12018,b-1_175-275_249.wav,VTTS_b-1_175-275_249.wav,1660,1718,-58
12019,b-3_4607-5008_4890.wav,VTTS_b-3_4607-5008_4890.wav,4620,4667,-47
12020,b-3_1764-1861_1858.wav,VTTS_b-3_1764-1861_1858.wav,5010,3855,1155
12021,b-1_1919-2017_1987.wav,VTTS_b-1_1919-2017_1987.wav,3750,3309,441
12022,b-4_2000-5164_3612.wav,VTTS_b-4_2000-5164_3612.wav,4774,4400,374
12023,b-3_6301-6400_6307.wav,VTTS_b-3_6301-6400_6307.wav,4810,4481,329
12024,b-3_6900-7016_6980.wav,VTTS_b-3_6900-7016_6980.wav,4230,4714,-484
12025,b-3_3628-3714_3646.wav,VTTS_b-3_3628-3714_3646.wav,4530,4087,443
12026,b-3_4001-4103_4044.wav,VTTS_b-3_4001-4103_4044.wav,7370,9358,-1988
12027,b-3_2943-3024_2958.wav,VTTS_b-3_2943-3024_2958.wav,4730,5468,-738
12028,b-4_2000-5164_3727.wav,VTTS_b-4_2000-5164_3727.wav,11245,10739,506
12029,b-3_2267-2349_2277.wav,VTTS_b-3_2267-2349_2277.wav,10740,11610,-870
12030,b-2_611-712_619.wav,VTTS_b-2_611-712_619.wav,1620,1416,204
12031,b-1_3935-4033_3939.wav,VTTS_b-1_3935-4033_3939.wav,1890,1916,-26
12032,b-4_1221-1300_1244.wav,VTTS_b-4_1221-1300_1244.wav,4130,3994,136
12033,b-4_1707-1813_1783.wav,VTTS_b-4_1707-1813_1783.wav,7620,6118,1502
12034,b-3_294-391_363.wav,VTTS_b-3_294-391_363.wav,6500,6618,-118
12035,b-4_1101-1220_1153.wav,VTTS_b-4_1101-1220_1153.wav,2480,2380,100
12036,b-1_1717-1817_1758.wav,VTTS_b-1_1717-1817_1758.wav,1790,1683,107
12037,b-3_501-930_869.wav,VTTS_b-3_501-930_869.wav,5460,5735,-275
12038,b-2_101-202_146.wav,VTTS_b-2_101-202_146.wav,1110,1010,100
12039,b-1_3632-3732_3657.wav,VTTS_b-1_3632-3732_3657.wav,1880,1834,46
12040,b-4_2000-5164_3317.wav,VTTS_b-4_2000-5164_3317.wav,2007,1974,33
12041,b-4_401-500_465.wav,VTTS_b-4_401-500_465.wav,2670,2554,116
12042,b-3_5853-5956_5860.wav,VTTS_b-3_5853-5956_5860.wav,4530,3947,583
12043,b-4_2000-5164_2981.wav,VTTS_b-4_2000-5164_2981.wav,3738,4307,-569
12044,b-3_6016-6115_6053.wav,VTTS_b-3_6016-6115_6053.wav,3380,3088,292
12045,b-3_6601-6700_6668.wav,VTTS_b-3_6601-6700_6668.wav,4530,4644,-114
12046,b-1_1515-1615_1527.wav,VTTS_b-1_1515-1615_1527.wav,1070,1022,48
12047,b-2_1597-1698_1644.wav,VTTS_b-2_1597-1698_1644.wav,8630,11169,-2539
12048,b-4_2000-5164_3928.wav,VTTS_b-4_2000-5164_3928.wav,5679,6095,-416
12049,b-1_686-793_709.wav,VTTS_b-1_686-793_709.wav,2040,1985,55
12050,b-1_794-1009_821.wav,VTTS_b-1_794-1009_821.wav,1490,1440,50
12051,b-1_2422-2522_2447.wav,VTTS_b-1_2422-2522_2447.wav,1350,1254,96
12052,b-3_5957-6015_5993.wav,VTTS_b-3_5957-6015_5993.wav,5500,5190,310
12053,b-4_53-150_127.wav,VTTS_b-4_53-150_127.wav,7730,7860,-130
12054,b-3_5009-5427_5391.wav,VTTS_b-3_5009-5427_5391.wav,5590,5236,354
12055,b-3_196-293_239.wav,VTTS_b-3_196-293_239.wav,6450,6420,30
12056,b-3_3628-3714_3691.wav,VTTS_b-3_3628-3714_3691.wav,6310,6118,192
12057,b-1_478-578_549.wav,VTTS_b-1_478-578_549.wav,2040,2125,-85
12058,b-4_2000-5164_4697.wav,VTTS_b-4_2000-5164_4697.wav,3074,2810,264
12059,b-1_74-174_162.wav,VTTS_b-1_74-174_162.wav,2560,3460,-900
12060,b-4_2000-5164_3712.wav,VTTS_b-4_2000-5164_3712.wav,1690,1579,111
12061,b-4_2000-5164_2282.wav,VTTS_b-4_2000-5164_2282.wav,6260,6130,130
12062,b-3_3715-3802_3768.wav,VTTS_b-3_3715-3802_3768.wav,7900,8475,-575
12063,b-1_2018-2118_2041.wav,VTTS_b-1_2018-2118_2041.wav,5510,4957,553
12064,b-4_2000-5164_2832.wav,VTTS_b-4_2000-5164_2832.wav,3340,3320,20
12065,b-3_3628-3714_3681.wav,VTTS_b-3_3628-3714_3681.wav,11680,11610,70
12066,b-3_1079-1320_1237.wav,VTTS_b-3_1079-1320_1237.wav,7920,7024,896
12067,b-3_392-500_473.wav,VTTS_b-3_392-500_473.wav,5320,5120,200
12068,b-3_5009-5427_5149.wav,VTTS_b-3_5009-5427_5149.wav,2020,1950,70
12069,b-2_203-304_220.wav,VTTS_b-2_203-304_220.wav,3280,3541,-261
12070,b-1_2826-2926_2925.wav,VTTS_b-1_2826-2926_2925.wav,2930,3100,-170
12071,b-1_3632-3732_3693.wav,VTTS_b-1_3632-3732_3693.wav,1860,1753,107
12072,b-4_2000-5164_3602.wav,VTTS_b-4_2000-5164_3602.wav,2963,2496,467
12073,b-4_501-1014_826.wav,VTTS_b-4_501-1014_826.wav,7270,8719,-1449
12074,b-4_1506-1600_1529.wav,VTTS_b-4_1506-1600_1529.wav,1280,1103,177
12075,b-3_6601-6700_6617.wav,VTTS_b-3_6601-6700_6617.wav,5720,5074,646
12076,b-4_2000-5164_4755.wav,VTTS_b-4_2000-5164_4755.wav,3287,3460,-173
12077,b-1_2523-2623_2613.wav,VTTS_b-1_2523-2623_2613.wav,2820,2531,289
12078,b-3_4607-5008_4709.wav,VTTS_b-3_4607-5008_4709.wav,4100,4563,-463
12079,b-3_6501-6600_6513.wav,VTTS_b-3_6501-6600_6513.wav,8080,8104,-24
12080,b-3_6116-6215_6200.wav,VTTS_b-3_6116-6215_6200.wav,3410,4365,-955
12081,b-3_501-930_609.wav,VTTS_b-3_501-930_609.wav,7480,8824,-1344
12082,b-3_501-930_651.wav,VTTS_b-3_501-930_651.wav,6080,6374,-294
12083,b-3_5009-5427_5258.wav,VTTS_b-3_5009-5427_5258.wav,4320,3704,616
12084,b-3_5745-5852_5769.wav,VTTS_b-3_5745-5852_5769.wav,5340,4574,766
12085,b-1_2826-2926_2905.wav,VTTS_b-1_2826-2926_2905.wav,3390,3820,-430
12086,b-1_175-275_223.wav,VTTS_b-1_175-275_223.wav,1180,1091,89
12087,b-2_1223-1324_1287.wav,VTTS_b-2_1223-1324_1287.wav,3330,4365,-1035
12088,b-4_2000-5164_2278.wav,VTTS_b-4_2000-5164_2278.wav,3740,5782,-2042
12089,b-3_1568-1665_1588.wav,VTTS_b-3_1568-1665_1588.wav,6360,5422,938
12090,b-2_1903-2038_1944.wav,VTTS_b-2_1903-2038_1944.wav,1300,1057,243
12091,b-3_1862-1959_1870.wav,VTTS_b-3_1862-1959_1870.wav,4040,3437,603
12092,b-4_2000-5164_2380.wav,VTTS_b-4_2000-5164_2380.wav,4075,4400,-325
12093,b-1_4142-4177_4166.wav,VTTS_b-1_4142-4177_4166.wav,1440,1382,58
12094,b-2_2413-2500_2493.wav,VTTS_b-2_2413-2500_2493.wav,2100,1521,579
12095,b-2_1903-2038_1935.wav,VTTS_b-2_1903-2038_1935.wav,3360,2752,608
12096,b-4_2000-5164_4536.wav,VTTS_b-4_2000-5164_4536.wav,3483,3251,232
12097,b-1_4214-4285_4221.wav,VTTS_b-1_4214-4285_4221.wav,2700,2694,6
12098,b-3_5009-5427_5387.wav,VTTS_b-3_5009-5427_5387.wav,4030,4145,-115
12099,b-2_1801-1902_1876.wav,VTTS_b-2_1801-1902_1876.wav,5260,4714,546
12100,b-4_2000-5164_2368.wav,VTTS_b-4_2000-5164_2368.wav,5305,5526,-221
12101,b-1_3531-3631_3550.wav,VTTS_b-1_3531-3631_3550.wav,3100,3379,-279
12102,b-3_5009-5427_5429.wav,VTTS_b-3_5009-5427_5429.wav,3520,3425,95
12103,b-3_98-195_194.wav,VTTS_b-3_98-195_194.wav,5880,5550,330
12104,b-3_4207-4314_4250.wav,VTTS_b-3_4207-4314_4250.wav,5630,5201,429
12105,b-3_5009-5427_5413.wav,VTTS_b-3_5009-5427_5413.wav,7650,7221,429
12106,b-1_3935-4033_4000.wav,VTTS_b-1_3935-4033_4000.wav,1550,1556,-6
12107,b-4_501-1014_614.wav,VTTS_b-4_501-1014_614.wav,4170,3982,188
12108,b-3_3889-4000_3906.wav,VTTS_b-3_3889-4000_3906.wav,6920,6769,151
12109,b-1_276-376_372.wav,VTTS_b-1_276-376_372.wav,1510,952,558
12110,b-1_2321-2421_2360.wav,VTTS_b-1_2321-2421_2360.wav,1710,1765,-55
12111,b-2_1121-1222_1150.wav,VTTS_b-2_1121-1222_1150.wav,6390,8022,-1632
12112,b-4_2000-5164_3870.wav,VTTS_b-4_2000-5164_3870.wav,2060,2206,-146
12113,b-4_2000-5164_4715.wav,VTTS_b-4_2000-5164_4715.wav,2821,2833,-12
12114,b-3_5745-5852_5745.wav,VTTS_b-3_5745-5852_5745.wav,4650,4981,-331
12115,b-4_2000-5164_3760.wav,VTTS_b-4_2000-5164_3760.wav,5340,8243,-2903
12116,b-3_4207-4314_4289.wav,VTTS_b-3_4207-4314_4289.wav,3050,2856,194
12117,b-3_2267-2349_2276.wav,VTTS_b-3_2267-2349_2276.wav,3640,3750,-110
12118,b-4_2000-5164_4753.wav,VTTS_b-4_2000-5164_4753.wav,3209,3831,-622
12119,b-2_1-100_77.wav,VTTS_b-2_1-100_77.wav,1210,1382,-172
12120,b-3_1321-1568_1382.wav,VTTS_b-3_1321-1568_1382.wav,3480,3518,-38
12121,b-4_2000-5164_4826.wav,VTTS_b-4_2000-5164_4826.wav,5637,5608,29
12122,b-3_5009-5427_5170.wav,VTTS_b-3_5009-5427_5170.wav,5940,7303,-1363
12123,b-3_3454-3537_3495.wav,VTTS_b-3_3454-3537_3495.wav,6050,6002,48
12124,b-1_4430-4465_4437.wav,VTTS_b-1_4430-4465_4437.wav,3660,4110,-450
12125,b-1_4178-4213_4199.wav,VTTS_b-1_4178-4213_4199.wav,3970,4261,-291
12126,b-3_5745-5852_5784.wav,VTTS_b-3_5745-5852_5784.wav,4470,4214,256
12127,b-3_4607-5008_4697.wav,VTTS_b-3_4607-5008_4697.wav,8570,9892,-1322
12128,b-4_2000-5164_3268.wav,VTTS_b-4_2000-5164_3268.wav,2132,2020,112
12129,b-1_579-649_602.wav,VTTS_b-1_579-649_602.wav,4120,4052,68
12130,b-4_2000-5164_4233.wav,VTTS_b-4_2000-5164_4233.wav,9071,8916,155
12131,b-3_6701-6800_6705.wav,VTTS_b-3_6701-6800_6705.wav,9440,9822,-382
12132,b-2_203-304_263.wav,VTTS_b-2_203-304_263.wav,3360,3146,214
12133,b-2_2209-2310_2256.wav,VTTS_b-2_2209-2310_2256.wav,1180,1149,31
12134,b-1_1010-1110_1113.wav,VTTS_b-1_1010-1110_1113.wav,1810,1707,103
12135,b-2_1325-1426_1349.wav,VTTS_b-2_1325-1426_1349.wav,1520,1358,162
12136,b-2_305-406_378.wav,VTTS_b-2_305-406_378.wav,2550,2786,-236
12137,b-2_1223-1324_1252.wav,VTTS_b-2_1223-1324_1252.wav,4550,4365,185
12138,b-3_5009-5427_5365.wav,VTTS_b-3_5009-5427_5365.wav,5940,5492,448
12139,b-4_2000-5164_4139.wav,VTTS_b-4_2000-5164_4139.wav,5605,6316,-711
12140,b-3_5853-5956_5862.wav,VTTS_b-3_5853-5956_5862.wav,4670,4168,502
12141,b-1_2624-2724_2644.wav,VTTS_b-1_2624-2724_2644.wav,4110,4992,-882
12142,b-1_4034-4069_4038.wav,VTTS_b-1_4034-4069_4038.wav,1770,1683,87
12143,b-4_2000-5164_4887.wav,VTTS_b-4_2000-5164_4887.wav,1994,2148,-154
12144,b-3_501-930_841.wav,VTTS_b-3_501-930_841.wav,5130,5677,-547
12145,b-2_1427-1562_1474.wav,VTTS_b-2_1427-1562_1474.wav,3010,2566,444
12146,b-3_1764-1861_1786.wav,VTTS_b-3_1764-1861_1786.wav,3490,3773,-283
12147,b-1_2927-3025_3001.wav,VTTS_b-1_2927-3025_3001.wav,1510,1683,-173
12148,b-4_1401-1505_1405.wav,VTTS_b-4_1401-1505_1405.wav,7960,7535,425
12149,b-2_1597-1698_1663.wav,VTTS_b-2_1597-1698_1663.wav,5210,4865,345
12150,b-4_2000-5164_3861.wav,VTTS_b-4_2000-5164_3861.wav,1630,1521,109
12151,b-1_478-578_514.wav,VTTS_b-1_478-578_514.wav,2500,2287,213
12152,b-1_3834-3934_3917.wav,VTTS_b-1_3834-3934_3917.wav,2030,2171,-141
12153,b-2_509-610_578.wav,VTTS_b-2_509-610_578.wav,6170,5782,388
12154,b-3_98-195_116.wav,VTTS_b-3_98-195_116.wav,3350,3448,-98
12155,b-1_4322-4357_4356.wav,VTTS_b-1_4322-4357_4356.wav,5130,5805,-675
12156,b-3_6601-6700_6602.wav,VTTS_b-3_6601-6700_6602.wav,5390,9996,-4606
12157,b-4_2000-5164_3603.wav,VTTS_b-4_2000-5164_3603.wav,4022,4040,-18
12158,b-4_301-400_385.wav,VTTS_b-4_301-400_385.wav,3800,3448,352
12159,b-1_2220-2320_2280.wav,VTTS_b-1_2220-2320_2280.wav,1770,1695,75
12160,b-1_3935-4033_4023.wav,VTTS_b-1_3935-4033_4023.wav,5980,5933,47
12161,b-4_2000-5164_2655.wav,VTTS_b-4_2000-5164_2655.wav,2560,2786,-226
12162,b-3_501-930_697.wav,VTTS_b-3_501-930_697.wav,4190,4203,-13
12163,b-1_1111-1211_1153.wav,VTTS_b-1_1111-1211_1153.wav,3040,2833,207
12164,b-4_2000-5164_3363.wav,VTTS_b-4_2000-5164_3363.wav,4176,4087,89
12165,b-1_1919-2017_1973.wav,VTTS_b-1_1919-2017_1973.wav,3480,4795,-1315
12166,b-3_501-930_890.wav,VTTS_b-3_501-930_890.wav,4420,4087,333
12167,b-2_509-610_521.wav,VTTS_b-2_509-610_521.wav,2290,1289,1001
12168,b-4_2000-5164_4070.wav,VTTS_b-4_2000-5164_4070.wav,2918,2891,27
12169,b-4_1901-2000_1920.wav,VTTS_b-4_1901-2000_1920.wav,3520,3170,350
12170,b-4_151-300_281.wav,VTTS_b-4_151-300_281.wav,7210,7256,-46
12171,b-3_1321-1568_1334.wav,VTTS_b-3_1321-1568_1334.wav,3570,3982,-412
12172,b-1_1717-1817_1720.wav,VTTS_b-1_1717-1817_1720.wav,880,917,-37
12173,b-4_2000-5164_4792.wav,VTTS_b-4_2000-5164_4792.wav,3871,4040,-169
12174,b-4_1401-1505_1443.wav,VTTS_b-4_1401-1505_1443.wav,4310,4447,-137
12175,b-3_4607-5008_4996.wav,VTTS_b-3_4607-5008_4996.wav,2920,3111,-191
12176,b-3_2943-3024_3012.wav,VTTS_b-3_2943-3024_3012.wav,2700,2972,-272
12177,b-3_4425-4497_4447.wav,VTTS_b-3_4425-4497_4447.wav,4670,4447,223
12178,b-3_3364-3453_3398.wav,VTTS_b-3_3364-3453_3398.wav,2570,3030,-460
12179,b-3_5533-5638_5613.wav,VTTS_b-3_5533-5638_5613.wav,6740,6560,180
12180,b-3_2000-2088_2088.wav,VTTS_b-3_2000-2088_2088.wav,4420,3773,647
12181,b-1_2927-3025_2944.wav,VTTS_b-1_2927-3025_2944.wav,1560,1498,62
12182,b-2_1-100_58.wav,VTTS_b-2_1-100_58.wav,1450,1556,-106
12183,b-3_5853-5956_5936.wav,VTTS_b-3_5853-5956_5936.wav,5240,5143,97
12184,b-2_1019-1120_1063.wav,VTTS_b-2_1019-1120_1063.wav,2010,2310,-300
12185,b-3_1079-1320_1268.wav,VTTS_b-3_1079-1320_1268.wav,4700,6177,-1477
12186,b-4_2000-5164_3629.wav,VTTS_b-4_2000-5164_3629.wav,4771,5457,-686
12187,b-4_1601-1706_1686.wav,VTTS_b-4_1601-1706_1686.wav,5070,4737,333
12188,b-1_2119-2219_2156.wav,VTTS_b-1_2119-2219_2156.wav,1620,1498,122
12189,b-4_2000-5164_3900.wav,VTTS_b-4_2000-5164_3900.wav,3751,3529,222
12190,b-2_1223-1324_1297.wav,VTTS_b-2_1223-1324_1297.wav,2780,3216,-436
12191,b-1_3127-3227_3190.wav,VTTS_b-1_3127-3227_3190.wav,1790,1521,269
12192,b-3_3364-3453_3415.wav,VTTS_b-3_3364-3453_3415.wav,3330,3228,102
12193,b-4_2000-5164_4997.wav,VTTS_b-4_2000-5164_4997.wav,5499,4923,576
12194,b-3_6601-6700_6677.wav,VTTS_b-3_6601-6700_6677.wav,5310,4865,445
12195,b-1_2826-2926_2857.wav,VTTS_b-1_2826-2926_2857.wav,3900,4737,-837
12196,b-4_2000-5164_2471.wav,VTTS_b-4_2000-5164_2471.wav,6625,6989,-364
12197,b-3_2267-2349_2294.wav,VTTS_b-3_2267-2349_2294.wav,4330,4702,-372
12198,b-3_1568-1665_1571.wav,VTTS_b-3_1568-1665_1571.wav,5240,5863,-623
12199,b-1_686-793_777.wav,VTTS_b-1_686-793_777.wav,1850,2090,-240
12200,b-4_1707-1813_1747.wav,VTTS_b-4_1707-1813_1747.wav,6220,6293,-73
12201,b-1_1-73_72.wav,VTTS_b-1_1-73_72.wav,2110,2682,-572
12202,b-3_6801-6900_6895.wav,VTTS_b-3_6801-6900_6895.wav,7220,7442,-222
12203,b-1_3430-3530_3438.wav,VTTS_b-1_3430-3530_3438.wav,1720,1730,-10
12204,b-3_6401-6500_6403.wav,VTTS_b-3_6401-6500_6403.wav,2530,2403,127
12205,b-4_2000-5164_3922.wav,VTTS_b-4_2000-5164_3922.wav,1170,1149,21
12206,b-2_1019-1120_1100.wav,VTTS_b-2_1019-1120_1100.wav,5540,4992,548
12207,b-2_713-814_769.wav,VTTS_b-2_713-814_769.wav,1140,1591,-451
12208,b-3_1568-1665_1640.wav,VTTS_b-3_1568-1665_1640.wav,3940,3994,-54
12209,b-1_377-477_405.wav,VTTS_b-1_377-477_405.wav,1740,1927,-187
12210,b-4_2000-5164_4422.wav,VTTS_b-4_2000-5164_4422.wav,2237,2322,-85
12211,b-1_1919-2017_1953.wav,VTTS_b-1_1919-2017_1953.wav,3410,3889,-479
12212,b-3_4104-4206_4105.wav,VTTS_b-3_4104-4206_4105.wav,11250,10344,906
12213,b-3_6501-6600_6597.wav,VTTS_b-3_6501-6600_6597.wav,2750,2868,-118
12214,b-4_2000-5164_3514.wav,VTTS_b-4_2000-5164_3514.wav,3786,4841,-1055
12215,b-3_5009-5427_5102.wav,VTTS_b-3_5009-5427_5102.wav,4420,4122,298
12216,b-4_151-300_272.wav,VTTS_b-4_151-300_272.wav,3030,4609,-1579
12217,b-3_2524-2854_2625.wav,VTTS_b-3_2524-2854_2625.wav,8810,8707,103
12218,b-1_1616-1716_1689.wav,VTTS_b-1_1616-1716_1689.wav,3760,5642,-1882
12219,b-4_501-1014_862.wav,VTTS_b-4_501-1014_862.wav,6400,6026,374
12220,b-3_501-930_643.wav,VTTS_b-3_501-930_643.wav,6110,5596,514
12221,b-3_6016-6115_6083.wav,VTTS_b-3_6016-6115_6083.wav,7710,8719,-1009
12222,b-3_98-195_103.wav,VTTS_b-3_98-195_103.wav,4840,5399,-559
12223,b-3_1764-1861_1780.wav,VTTS_b-3_1764-1861_1780.wav,4710,4667,43
12224,b-3_3025-3111_3049.wav,VTTS_b-3_3025-3111_3049.wav,4190,4110,80
12225,b-1_3632-3732_3707.wav,VTTS_b-1_3632-3732_3707.wav,750,766,-16
12226,b-1_686-793_772.wav,VTTS_b-1_686-793_772.wav,3240,3541,-301
12227,b-3_6301-6400_6359.wav,VTTS_b-3_6301-6400_6359.wav,6790,6827,-37
12228,b-1_2018-2118_2070.wav,VTTS_b-1_2018-2118_2070.wav,2710,3286,-576
12229,b-1_3531-3631_3543.wav,VTTS_b-1_3531-3631_3543.wav,1890,3587,-1697
12230,b-4_151-300_201.wav,VTTS_b-4_151-300_201.wav,4800,5306,-506
12231,b-1_1111-1211_1204.wav,VTTS_b-1_1111-1211_1204.wav,1860,1776,84
12232,b-4_2000-5164_4860.wav,VTTS_b-4_2000-5164_4860.wav,3704,4772,-1068
12233,b-4_151-300_213.wav,VTTS_b-4_151-300_213.wav,3300,3460,-160
12234,b-3_1568-1665_1647.wav,VTTS_b-3_1568-1665_1647.wav,1950,1718,232
12235,b-3_1-97_33.wav,VTTS_b-3_1-97_33.wav,3370,4005,-635
12236,b-3_2524-2854_2599.wav,VTTS_b-3_2524-2854_2599.wav,2580,2531,49
12237,b-1_3127-3227_3227.wav,VTTS_b-1_3127-3227_3227.wav,2520,2496,24
12238,b-1_2119-2219_2133.wav,VTTS_b-1_2119-2219_2133.wav,3200,3100,100
12239,b-2_1903-2038_1957.wav,VTTS_b-2_1903-2038_1957.wav,2290,3553,-1263
12240,b-3_5853-5956_5891.wav,VTTS_b-3_5853-5956_5891.wav,3880,3495,385
12241,b-2_1325-1426_1428.wav,VTTS_b-2_1325-1426_1428.wav,2360,1950,410
12242,b-3_1862-1959_1877.wav,VTTS_b-3_1862-1959_1877.wav,7480,8220,-740
12243,b-3_2524-2854_2621.wav,VTTS_b-3_2524-2854_2621.wav,9910,8847,1063
12244,b-4_53-150_147.wav,VTTS_b-4_53-150_147.wav,10050,7918,2132
12245,b-1_1616-1716_1651.wav,VTTS_b-1_1616-1716_1651.wav,820,975,-155
12246,b-4_2000-5164_2831.wav,VTTS_b-4_2000-5164_2831.wav,2280,2357,-77
12247,b-4_2000-5164_4248.wav,VTTS_b-4_2000-5164_4248.wav,3029,3379,-350
12248,b-1_4178-4213_4203.wav,VTTS_b-1_4178-4213_4203.wav,4140,4737,-597
12249,b-3_3628-3714_3640.wav,VTTS_b-3_3628-3714_3640.wav,5430,5271,159
12250,b-1_4142-4177_4169.wav,VTTS_b-1_4142-4177_4169.wav,1570,1788,-218
12251,b-3_5853-5956_5905.wav,VTTS_b-3_5853-5956_5905.wav,6300,5805,495
12252,b-1_175-275_188.wav,VTTS_b-1_175-275_188.wav,1760,1556,204
12253,b-3_2524-2854_2802.wav,VTTS_b-3_2524-2854_2802.wav,6750,6676,74
12254,b-1_2725-2825_2817.wav,VTTS_b-1_2725-2825_2817.wav,4710,4899,-189
12255,b-2_917-1018_984.wav,VTTS_b-2_917-1018_984.wav,980,964,16
12256,b-1_377-477_446.wav,VTTS_b-1_377-477_446.wav,2670,2438,232
12257,b-3_5009-5427_5411.wav,VTTS_b-3_5009-5427_5411.wav,9510,10170,-660
12258,b-3_1079-1320_1225.wav,VTTS_b-3_1079-1320_1225.wav,5750,6223,-473
12259,b-1_3127-3227_3140.wav,VTTS_b-1_3127-3227_3140.wav,3000,3077,-77
12260,b-3_4207-4314_4302.wav,VTTS_b-3_4207-4314_4302.wav,2460,2891,-431
12261,b-1_2422-2522_2439.wav,VTTS_b-1_2422-2522_2439.wav,2150,1614,536
12262,b-1_276-376_349.wav,VTTS_b-1_276-376_349.wav,2050,2647,-597
12263,b-4_1401-1505_1503.wav,VTTS_b-4_1401-1505_1503.wav,2760,2508,252
12264,b-4_301-400_312.wav,VTTS_b-4_301-400_312.wav,8990,8882,108
12265,b-1_2826-2926_2837.wav,VTTS_b-1_2826-2926_2837.wav,2730,2821,-91
12266,b-1_686-793_723.wav,VTTS_b-1_686-793_723.wav,1400,1440,-40
12267,b-3_98-195_195.wav,VTTS_b-3_98-195_195.wav,4150,4516,-366
12268,b-3_6701-6800_6710.wav,VTTS_b-3_6701-6800_6710.wav,5570,4934,636
12269,b-3_6401-6500_6466.wav,VTTS_b-3_6401-6500_6466.wav,2580,2624,-44
12270,b-4_501-1014_893.wav,VTTS_b-4_501-1014_893.wav,1790,1869,-79
12271,b-3_3715-3802_3764.wav,VTTS_b-3_3715-3802_3764.wav,5160,6293,-1133
12272,b-4_1901-2000_1955.wav,VTTS_b-4_1901-2000_1955.wav,2860,2531,329
12273,b-2_407-508_440.wav,VTTS_b-2_407-508_440.wav,3180,3483,-303
12274,b-4_2000-5164_5128.wav,VTTS_b-4_2000-5164_5128.wav,5520,5933,-413
12275,b-3_5428-5533_5460.wav,VTTS_b-3_5428-5533_5460.wav,3120,4110,-990
12276,b-3_4315-4424_4355.wav,VTTS_b-3_4315-4424_4355.wav,4780,4969,-189
12277,b-3_4315-4424_4405.wav,VTTS_b-3_4315-4424_4405.wav,2980,3123,-143
12278,b-4_2000-5164_3103.wav,VTTS_b-4_2000-5164_3103.wav,3726,3704,22
12279,b-3_5957-6015_6013.wav,VTTS_b-3_5957-6015_6013.wav,6800,8034,-1234
12280,b-1_3733-3833_3809.wav,VTTS_b-1_3733-3833_3809.wav,1700,1765,-65
12281,b-2_917-1018_931.wav,VTTS_b-2_917-1018_931.wav,3300,3657,-357
12282,b-1_1919-2017_1966.wav,VTTS_b-1_1919-2017_1966.wav,5140,5399,-259
12283,b-2_203-304_210.wav,VTTS_b-2_203-304_210.wav,1520,1347,173
12284,b-3_1764-1861_1803.wav,VTTS_b-3_1764-1861_1803.wav,5000,5027,-27
12285,b-3_3889-4000_3994.wav,VTTS_b-3_3889-4000_3994.wav,7440,7860,-420
12286,b-2_1699-1800_1797.wav,VTTS_b-2_1699-1800_1797.wav,8230,11610,-3380
12287,b-3_392-500_459.wav,VTTS_b-3_392-500_459.wav,5730,6153,-423
12288,b-1_2018-2118_2043.wav,VTTS_b-1_2018-2118_2043.wav,2950,3123,-173
12289,b-1_4142-4177_4164.wav,VTTS_b-1_4142-4177_4164.wav,1310,1254,56
12290,b-4_501-1014_666.wav,VTTS_b-4_501-1014_666.wav,3960,3727,233
12291,b-1_1919-2017_1981.wav,VTTS_b-1_1919-2017_1981.wav,2310,2229,81
12292,b-1_1717-1817_1757.wav,VTTS_b-1_1717-1817_1757.wav,1910,1660,250
12293,b-4_501-1014_570.wav,VTTS_b-4_501-1014_570.wav,5930,7500,-1570
12294,b-3_2267-2349_2269.wav,VTTS_b-3_2267-2349_2269.wav,6150,5364,786
12295,b-3_2089-2176_2150.wav,VTTS_b-3_2089-2176_2150.wav,2390,2334,56
12296,b-4_2000-5164_2353.wav,VTTS_b-4_2000-5164_2353.wav,1570,1463,107
12297,b-1_3531-3631_3553.wav,VTTS_b-1_3531-3631_3553.wav,5690,6002,-312
12298,b-2_2311-2412_2333.wav,VTTS_b-2_2311-2412_2333.wav,2330,2601,-271
12299,b-4_2000-5164_2564.wav,VTTS_b-4_2000-5164_2564.wav,2210,3402,-1192
12300,b-2_713-814_749.wav,VTTS_b-2_713-814_749.wav,4430,4714,-284
12301,b-1_74-174_118.wav,VTTS_b-1_74-174_118.wav,4620,5480,-860
12302,b-1_478-578_521.wav,VTTS_b-1_478-578_521.wav,3910,3297,613
12303,b-1_3228-3328_3300.wav,VTTS_b-1_3228-3328_3300.wav,1540,1753,-213
12304,b-4_2000-5164_5065.wav,VTTS_b-4_2000-5164_5065.wav,7071,6734,337
12305,b-4_2000-5164_4723.wav,VTTS_b-4_2000-5164_4723.wav,3265,3355,-90
12306,b-4_501-1014_851.wav,VTTS_b-4_501-1014_851.wav,7910,7535,375
12307,b-4_2000-5164_5070.wav,VTTS_b-4_2000-5164_5070.wav,2365,2218,147
12308,b-2_1019-1120_1077.wav,VTTS_b-2_1019-1120_1077.wav,2840,3541,-701
12309,b-2_1801-1902_1841.wav,VTTS_b-2_1801-1902_1841.wav,1400,1440,-40
12310,b-4_501-1014_861.wav,VTTS_b-4_501-1014_861.wav,7540,6362,1178
12311,b-2_1223-1324_1289.wav,VTTS_b-2_1223-1324_1289.wav,820,882,-62
12312,b-1_2624-2724_2689.wav,VTTS_b-1_2624-2724_2689.wav,3580,4249,-669
12313,b-4_501-1014_958.wav,VTTS_b-4_501-1014_958.wav,970,964,6
12314,b-4_2000-5164_3535.wav,VTTS_b-4_2000-5164_3535.wav,1453,1370,83
12315,b-3_6116-6215_6136.wav,VTTS_b-3_6116-6215_6136.wav,3980,5201,-1221
12316,b-3_501-930_592.wav,VTTS_b-3_501-930_592.wav,7660,7407,253
12317,b-2_1-100_40.wav,VTTS_b-2_1-100_40.wav,2500,2612,-112
12318,b-3_6801-6900_6899.wav,VTTS_b-3_6801-6900_6899.wav,3300,2868,432
12319,b-4_2000-5164_2668.wav,VTTS_b-4_2000-5164_2668.wav,3860,3506,354
12320,b-3_2943-3024_2961.wav,VTTS_b-3_2943-3024_2961.wav,4830,7558,-2728
12321,b-3_1862-1959_1863.wav,VTTS_b-3_1862-1959_1863.wav,2880,2717,163
12322,b-4_1601-1706_1606.wav,VTTS_b-4_1601-1706_1606.wav,4830,4563,267
12323,b-4_501-1014_799.wav,VTTS_b-4_501-1014_799.wav,7350,7047,303
12324,b-1_1414-1514_1437.wav,VTTS_b-1_1414-1514_1437.wav,1520,1370,150
12325,b-2_1223-1324_1258.wav,VTTS_b-2_1223-1324_1258.wav,2520,1463,1057
12326,b-3_2855-2942_2902.wav,VTTS_b-3_2855-2942_2902.wav,2570,2728,-158
12327,b-2_713-814_795.wav,VTTS_b-2_713-814_795.wav,2120,2334,-214
12328,b-4_2000-5164_3662.wav,VTTS_b-4_2000-5164_3662.wav,4028,4122,-94
12329,b-3_5853-5956_5856.wav,VTTS_b-3_5853-5956_5856.wav,3300,2879,421
12330,b-3_1568-1665_1622.wav,VTTS_b-3_1568-1665_1622.wav,8680,8928,-248
12331,b-4_2000-5164_3270.wav,VTTS_b-4_2000-5164_3270.wav,4186,3889,297
12332,b-3_501-930_822.wav,VTTS_b-3_501-930_822.wav,6530,6397,133
12333,b-4_501-1014_938.wav,VTTS_b-4_501-1014_938.wav,2750,2589,161
12334,b-4_501-1014_518.wav,VTTS_b-4_501-1014_518.wav,4120,4087,33
12335,b-2_1563-1596_1563.wav,VTTS_b-2_1563-1596_1563.wav,2550,2496,54
12336,b-3_4498-4605_4560.wav,VTTS_b-3_4498-4605_4560.wav,7950,6838,1112
12337,b-4_2000-5164_4465.wav,VTTS_b-4_2000-5164_4465.wav,2918,2868,50
12338,b-4_401-500_442.wav,VTTS_b-4_401-500_442.wav,3740,4052,-312
12339,b-3_5009-5427_5056.wav,VTTS_b-3_5009-5427_5056.wav,2830,3135,-305
12340,b-4_1101-1220_1204.wav,VTTS_b-4_1101-1220_1204.wav,8760,8336,424
12341,b-1_3329-3429_3338.wav,VTTS_b-1_3329-3429_3338.wav,3520,4737,-1217
12342,b-3_1764-1861_1829.wav,VTTS_b-3_1764-1861_1829.wav,6600,6153,447
12343,b-2_2209-2310_2265.wav,VTTS_b-2_2209-2310_2265.wav,1630,1637,-7
12344,b-3_3538-3627_3568.wav,VTTS_b-3_3538-3627_3568.wav,2950,2995,-45
12345,b-3_6501-6600_6568.wav,VTTS_b-3_6501-6600_6568.wav,6730,7430,-700
12346,b-1_3329-3429_3379.wav,VTTS_b-1_3329-3429_3379.wav,3010,2775,235
12347,b-1_2422-2522_2517.wav,VTTS_b-1_2422-2522_2517.wav,2750,3216,-466
12348,b-4_2000-5164_2751.wav,VTTS_b-4_2000-5164_2751.wav,5390,5259,131
12349,b-1_3430-3530_3497.wav,VTTS_b-1_3430-3530_3497.wav,3190,3959,-769
12350,b-1_3430-3530_3477.wav,VTTS_b-1_3430-3530_3477.wav,2580,2763,-183
12351,b-3_6301-6400_6308.wav,VTTS_b-3_6301-6400_6308.wav,1690,1625,65
12352,b-3_501-930_546.wav,VTTS_b-3_501-930_546.wav,2820,2984,-164
12353,b-3_4498-4605_4526.wav,VTTS_b-3_4498-4605_4526.wav,3360,3936,-576
12354,b-4_2000-5164_2076.wav,VTTS_b-4_2000-5164_2076.wav,2360,2473,-113
12355,b-4_401-500_414.wav,VTTS_b-4_401-500_414.wav,11070,11610,-540
12356,b-4_2000-5164_2206.wav,VTTS_b-4_2000-5164_2206.wav,2420,2612,-192
12357,b-4_1221-1300_1274.wav,VTTS_b-4_1221-1300_1274.wav,4930,4621,309
12358,b-3_4207-4314_4243.wav,VTTS_b-3_4207-4314_4243.wav,4710,5375,-665
12359,b-1_4358-4393_4385.wav,VTTS_b-1_4358-4393_4385.wav,1700,1660,40
12360,b-4_2000-5164_4356.wav,VTTS_b-4_2000-5164_4356.wav,7147,8290,-1143
12361,b-2_1903-2038_2003.wav,VTTS_b-2_1903-2038_2003.wav,4000,3646,354
12362,b-3_6116-6215_6165.wav,VTTS_b-3_6116-6215_6165.wav,3000,3065,-65
12363,b-2_917-1018_1011.wav,VTTS_b-2_917-1018_1011.wav,1480,1788,-308
12364,b-1_175-275_239.wav,VTTS_b-1_175-275_239.wav,4100,5747,-1647
12365,b-1_794-1009_958.wav,VTTS_b-1_794-1009_958.wav,3700,3866,-166
12366,b-3_1764-1861_1789.wav,VTTS_b-3_1764-1861_1789.wav,2790,2554,236
12367,b-3_3538-3627_3575.wav,VTTS_b-3_3538-3627_3575.wav,3770,3437,333
12368,b-3_1079-1320_1260.wav,VTTS_b-3_1079-1320_1260.wav,8460,7930,530
12369,b-4_501-1014_702.wav,VTTS_b-4_501-1014_702.wav,3390,3100,290
12370,b-3_3715-3802_3763.wav,VTTS_b-3_3715-3802_3763.wav,6680,6293,387
12371,b-3_1321-1568_1450.wav,VTTS_b-3_1321-1568_1450.wav,3610,3680,-70
12372,b-4_2000-5164_2583.wav,VTTS_b-4_2000-5164_2583.wav,3900,3762,138
12373,b-4_501-1014_522.wav,VTTS_b-4_501-1014_522.wav,3670,3355,315
12374,b-4_2000-5164_4237.wav,VTTS_b-4_2000-5164_4237.wav,9909,10658,-749
12375,b-3_5853-5956_5910.wav,VTTS_b-3_5853-5956_5910.wav,3660,3669,-9
12376,b-1_1616-1716_1639.wav,VTTS_b-1_1616-1716_1639.wav,4510,4272,238
12377,b-1_1818-1918_1829.wav,VTTS_b-1_1818-1918_1829.wav,4400,3785,615
12378,b-4_2000-5164_2171.wav,VTTS_b-4_2000-5164_2171.wav,5485,6269,-784
12379,b-4_53-150_113.wav,VTTS_b-4_53-150_113.wav,8370,7837,533
12380,b-4_2000-5164_3093.wav,VTTS_b-4_2000-5164_3093.wav,9809,10565,-756
12381,b-3_3538-3627_3571.wav,VTTS_b-3_3538-3627_3571.wav,3470,3309,161
12382,b-4_501-1014_786.wav,VTTS_b-4_501-1014_786.wav,4730,4632,98
12383,b-1_3733-3833_3779.wav,VTTS_b-1_3733-3833_3779.wav,1730,2264,-534
12384,b-3_501-930_583.wav,VTTS_b-3_501-930_583.wav,5850,5224,626
12385,b-4_301-400_333.wav,VTTS_b-4_301-400_333.wav,2210,2148,62
12386,b-4_2000-5164_3078.wav,VTTS_b-4_2000-5164_3078.wav,5303,5306,-3
12387,b-4_501-1014_686.wav,VTTS_b-4_501-1014_686.wav,10290,9439,851
12388,b-1_2018-2118_2064.wav,VTTS_b-1_2018-2118_2064.wav,3690,3460,230
12389,b-4_1901-2000_1943.wav,VTTS_b-4_1901-2000_1943.wav,8870,7767,1103
12390,b-3_3112-3197_3116.wav,VTTS_b-3_3112-3197_3116.wav,7480,6885,595
12391,b-3_2177-2266_2185.wav,VTTS_b-3_2177-2266_2185.wav,6310,6502,-192
12392,b-3_1666-1763_1732.wav,VTTS_b-3_1666-1763_1732.wav,11740,11610,130
12393,b-1_1717-1817_1743.wav,VTTS_b-1_1717-1817_1743.wav,1110,987,123
12394,b-2_815-916_830.wav,VTTS_b-2_815-916_830.wav,2550,2473,77
12395,b-3_3025-3111_3106.wav,VTTS_b-3_3025-3111_3106.wav,4440,3704,736
12396,b-3_1764-1861_1766.wav,VTTS_b-3_1764-1861_1766.wav,4920,4992,-72
12397,b-3_5745-5852_5779.wav,VTTS_b-3_5745-5852_5779.wav,3120,2984,136
12398,b-3_1321-1568_1330.wav,VTTS_b-3_1321-1568_1330.wav,1930,1788,142
12399,b-3_6401-6500_6482.wav,VTTS_b-3_6401-6500_6482.wav,3010,3262,-252
12400,b-3_2524-2854_2560.wav,VTTS_b-3_2524-2854_2560.wav,11110,10043,1067
12401,b-3_5533-5638_5628.wav,VTTS_b-3_5533-5638_5628.wav,3810,3332,478
12402,b-3_5639-5744_5710.wav,VTTS_b-3_5639-5744_5710.wav,2390,3088,-698
12403,b-4_2000-5164_4813.wav,VTTS_b-4_2000-5164_4813.wav,8238,7523,715
12404,b-4_2000-5164_4487.wav,VTTS_b-4_2000-5164_4487.wav,4877,4400,477
12405,b-1_1010-1110_1042.wav,VTTS_b-1_1010-1110_1042.wav,3030,3088,-58
12406,b-1_686-793_795.wav,VTTS_b-1_686-793_795.wav,1570,1498,72
12407,b-2_917-1018_958.wav,VTTS_b-2_917-1018_958.wav,4280,9125,-4845
12408,b-2_1903-2038_1919.wav,VTTS_b-2_1903-2038_1919.wav,2360,1776,584
12409,b-4_2000-5164_2234.wav,VTTS_b-4_2000-5164_2234.wav,6475,6676,-201
12410,b-2_1699-1800_1761.wav,VTTS_b-2_1699-1800_1761.wav,3220,3042,178
12411,b-1_1515-1615_1532.wav,VTTS_b-1_1515-1615_1532.wav,3270,2949,321
12412,b-3_3025-3111_3043.wav,VTTS_b-3_3025-3111_3043.wav,7980,7488,492
12413,b-2_1903-2038_2002.wav,VTTS_b-2_1903-2038_2002.wav,1150,1091,59
12414,b-4_2000-5164_4622.wav,VTTS_b-4_2000-5164_4622.wav,2281,2043,238
12415,b-1_478-578_479.wav,VTTS_b-1_478-578_479.wav,4200,4807,-607
12416,b-1_4142-4177_4149.wav,VTTS_b-1_4142-4177_4149.wav,890,1672,-782
12417,b-4_401-500_447.wav,VTTS_b-4_401-500_447.wav,3780,3820,-40
12418,b-3_196-293_225.wav,VTTS_b-3_196-293_225.wav,4910,4133,777
12419,b-2_1597-1698_1632.wav,VTTS_b-2_1597-1698_1632.wav,7690,10124,-2434
12420,b-3_6501-6600_6576.wav,VTTS_b-3_6501-6600_6576.wav,5150,4853,297
12421,b-3_1079-1320_1266.wav,VTTS_b-3_1079-1320_1266.wav,3480,3158,322
12422,b-2_2311-2412_2404.wav,VTTS_b-2_2311-2412_2404.wav,1880,2090,-210
12423,b-1_3228-3328_3233.wav,VTTS_b-1_3228-3328_3233.wav,1620,1834,-214
12424,b-3_5853-5956_5889.wav,VTTS_b-3_5853-5956_5889.wav,2280,2032,248
12425,b-4_2000-5164_4037.wav,VTTS_b-4_2000-5164_4037.wav,2489,2264,225
12426,b-1_1414-1514_1458.wav,VTTS_b-1_1414-1514_1458.wav,3590,3506,84
12427,b-3_3364-3453_3371.wav,VTTS_b-3_3364-3453_3371.wav,6470,6246,224
12428,b-1_2927-3025_2967.wav,VTTS_b-1_2927-3025_2967.wav,1280,1184,96
12429,b-1_1818-1918_1827.wav,VTTS_b-1_1818-1918_1827.wav,4030,3971,59
12430,b-3_3025-3111_3112.wav,VTTS_b-3_3025-3111_3112.wav,8260,6989,1271
12431,b-1_2927-3025_2981.wav,VTTS_b-1_2927-3025_2981.wav,1430,1440,-10
12432,b-1_2523-2623_2539.wav,VTTS_b-1_2523-2623_2539.wav,2700,2694,6
12433,b-1_377-477_377.wav,VTTS_b-1_377-477_377.wav,1030,1277,-247
12434,b-3_1568-1665_1584.wav,VTTS_b-3_1568-1665_1584.wav,2030,2287,-257
12435,b-1_3430-3530_3450.wav,VTTS_b-1_3430-3530_3450.wav,2820,2752,68
12436,b-4_2000-5164_5080.wav,VTTS_b-4_2000-5164_5080.wav,5285,5201,84
12437,b-3_931-979_943.wav,VTTS_b-3_931-979_943.wav,4240,4075,165
12438,b-2_2413-2500_2453.wav,VTTS_b-2_2413-2500_2453.wav,5210,4714,496
12439,b-3_6016-6115_6067.wav,VTTS_b-3_6016-6115_6067.wav,2060,2647,-587
12440,b-4_1601-1706_1655.wav,VTTS_b-4_1601-1706_1655.wav,8210,8092,118
12441,b-2_1325-1426_1339.wav,VTTS_b-2_1325-1426_1339.wav,2910,2577,333
12442,b-3_5533-5638_5578.wav,VTTS_b-3_5533-5638_5578.wav,4820,5259,-439
12443,b-4_2000-5164_3070.wav,VTTS_b-4_2000-5164_3070.wav,3213,2844,369
12444,b-1_1212-1312_1290.wav,VTTS_b-1_1212-1312_1290.wav,3940,4702,-762
12445,b-4_2000-5164_3848.wav,VTTS_b-4_2000-5164_3848.wav,2983,3019,-36
12446,b-4_2000-5164_2473.wav,VTTS_b-4_2000-5164_2473.wav,3035,3042,-7
12447,b-2_611-712_656.wav,VTTS_b-2_611-712_656.wav,2000,2519,-519
12448,b-1_2119-2219_2208.wav,VTTS_b-1_2119-2219_2208.wav,1840,1881,-41
12449,b-4_2000-5164_2557.wav,VTTS_b-4_2000-5164_2557.wav,8130,7488,642
12450,b-3_1079-1320_1201.wav,VTTS_b-3_1079-1320_1201.wav,2340,2450,-110
12451,b-4_501-1014_934.wav,VTTS_b-4_501-1014_934.wav,5980,6676,-696
12452,b-4_1814-1900_1864.wav,VTTS_b-4_1814-1900_1864.wav,10960,11529,-569
12453,b-3_501-930_659.wav,VTTS_b-3_501-930_659.wav,5590,6873,-1283
12454,b-3_2177-2266_2196.wav,VTTS_b-3_2177-2266_2196.wav,3450,2902,548
12455,b-2_305-406_380.wav,VTTS_b-2_305-406_380.wav,6030,5840,190
12456,b-4_501-1014_712.wav,VTTS_b-4_501-1014_712.wav,2470,2159,311
12457,b-3_2855-2942_2869.wav,VTTS_b-3_2855-2942_2869.wav,4820,5085,-265
12458,b-4_2000-5164_2005.wav,VTTS_b-4_2000-5164_2005.wav,4016,4586,-570
12459,b-1_1414-1514_1498.wav,VTTS_b-1_1414-1514_1498.wav,1820,1718,102
12460,b-4_2000-5164_3441.wav,VTTS_b-4_2000-5164_3441.wav,6134,7732,-1598
12461,b-2_305-406_368.wav,VTTS_b-2_305-406_368.wav,3970,4876,-906
12462,b-1_3127-3227_3175.wav,VTTS_b-1_3127-3227_3175.wav,2150,2218,-68
12463,b-4_53-150_114.wav,VTTS_b-4_53-150_114.wav,8070,7303,767
12464,b-3_501-930_812.wav,VTTS_b-3_501-930_812.wav,4390,3634,756
12465,b-3_4104-4206_4199.wav,VTTS_b-3_4104-4206_4199.wav,6160,5689,471
12466,b-3_3454-3537_3502.wav,VTTS_b-3_3454-3537_3502.wav,6400,8348,-1948
12467,b-3_5639-5744_5646.wav,VTTS_b-3_5639-5744_5646.wav,7810,7570,240
12468,b-1_175-275_246.wav,VTTS_b-1_175-275_246.wav,1740,1567,173
12469,b-1_686-793_750.wav,VTTS_b-1_686-793_750.wav,1460,1347,113
12470,b-3_2267-2349_2292.wav,VTTS_b-3_2267-2349_2292.wav,1140,940,200
12471,b-4_2000-5164_2497.wav,VTTS_b-4_2000-5164_2497.wav,4420,4702,-282
12472,b-3_1-97_86.wav,VTTS_b-3_1-97_86.wav,7050,6815,235
12473,b-1_3127-3227_3169.wav,VTTS_b-1_3127-3227_3169.wav,3060,3820,-760
12474,b-4_2000-5164_4636.wav,VTTS_b-4_2000-5164_4636.wav,4202,4795,-593
12475,b-2_1-100_14.wav,VTTS_b-2_1-100_14.wav,4560,4354,206
12476,b-3_4607-5008_4797.wav,VTTS_b-3_4607-5008_4797.wav,4870,4737,133
12477,b-2_1019-1120_1044.wav,VTTS_b-2_1019-1120_1044.wav,1070,1103,-33
12478,b-3_392-500_470.wav,VTTS_b-3_392-500_470.wav,3730,4052,-322
12479,b-3_5428-5533_5500.wav,VTTS_b-3_5428-5533_5500.wav,4780,4447,333
12480,b-4_2000-5164_3581.wav,VTTS_b-4_2000-5164_3581.wav,1563,1289,274
12481,b-4_2000-5164_3062.wav,VTTS_b-4_2000-5164_3062.wav,8902,8406,496
12482,b-4_2000-5164_4853.wav,VTTS_b-4_2000-5164_4853.wav,3530,4214,-684
12483,b-4_1-52_44.wav,VTTS_b-4_1-52_44.wav,13370,11610,1760
12484,b-1_2422-2522_2466.wav,VTTS_b-1_2422-2522_2466.wav,1410,1486,-76
12485,b-1_4322-4357_4336.wav,VTTS_b-1_4322-4357_4336.wav,3860,3994,-134
12486,b-2_1699-1800_1785.wav,VTTS_b-2_1699-1800_1785.wav,3760,3634,126
12487,b-3_3279-3363_3335.wav,VTTS_b-3_3279-3363_3335.wav,4320,3448,872
12488,b-3_3803-3888_3826.wav,VTTS_b-3_3803-3888_3826.wav,8060,8208,-148
12489,b-1_4322-4357_4352.wav,VTTS_b-1_4322-4357_4352.wav,1890,6420,-4530
12490,b-3_196-293_289.wav,VTTS_b-3_196-293_289.wav,8250,6188,2062
12491,b-4_1301-1400_1380.wav,VTTS_b-4_1301-1400_1380.wav,6340,5828,512
12492,b-1_1818-1918_1840.wav,VTTS_b-1_1818-1918_1840.wav,3500,3657,-157
12493,b-4_501-1014_977.wav,VTTS_b-4_501-1014_977.wav,6520,6281,239
12494,b-4_2000-5164_3155.wav,VTTS_b-4_2000-5164_3155.wav,7166,6896,270
12495,b-4_2000-5164_4284.wav,VTTS_b-4_2000-5164_4284.wav,4273,4702,-429
12496,b-4_2000-5164_4334.wav,VTTS_b-4_2000-5164_4334.wav,3444,3344,100
12497,b-3_2267-2349_2326.wav,VTTS_b-3_2267-2349_2326.wav,2930,2961,-31
12498,b-3_5009-5427_5352.wav,VTTS_b-3_5009-5427_5352.wav,4500,6397,-1897
12499,b-4_2000-5164_4958.wav,VTTS_b-4_2000-5164_4958.wav,4564,4644,-80
12500,b-3_3279-3363_3292.wav,VTTS_b-3_3279-3363_3292.wav,8320,8301,19
12501,b-1_1818-1918_1903.wav,VTTS_b-1_1818-1918_1903.wav,4200,4249,-49
12502,b-1_276-376_357.wav,VTTS_b-1_276-376_357.wav,1260,1161,99
12503,b-1_2321-2421_2364.wav,VTTS_b-1_2321-2421_2364.wav,1270,1277,-7
12504,b-2_101-202_170.wav,VTTS_b-2_101-202_170.wav,1920,1962,-42
12505,b-3_2434-2523_2462.wav,VTTS_b-3_2434-2523_2462.wav,2670,2183,487
12506,b-4_2000-5164_2374.wav,VTTS_b-4_2000-5164_2374.wav,6520,6478,42
12507,b-4_2000-5164_4782.wav,VTTS_b-4_2000-5164_4782.wav,6313,6629,-316
12508,b-2_1699-1800_1782.wav,VTTS_b-2_1699-1800_1782.wav,2720,2961,-241
12509,b-3_2855-2942_2932.wav,VTTS_b-3_2855-2942_2932.wav,7310,8046,-736
12510,b-3_501-930_789.wav,VTTS_b-3_501-930_789.wav,2870,2891,-21
12511,b-4_151-300_264.wav,VTTS_b-4_151-300_264.wav,6230,7221,-991
12512,b-4_301-400_309.wav,VTTS_b-4_301-400_309.wav,5510,4818,692
12513,b-4_2000-5164_3992.wav,VTTS_b-4_2000-5164_3992.wav,2990,2728,262
12514,b-4_2000-5164_3781.wav,VTTS_b-4_2000-5164_3781.wav,3370,3077,293
12515,b-4_2000-5164_2624.wav,VTTS_b-4_2000-5164_2624.wav,4160,4365,-205
12516,b-2_101-202_142.wav,VTTS_b-2_101-202_142.wav,1050,1022,28
12517,b-3_2855-2942_2908.wav,VTTS_b-3_2855-2942_2908.wav,3680,4145,-465
12518,b-3_2524-2854_2762.wav,VTTS_b-3_2524-2854_2762.wav,3040,3251,-211
12519,b-4_2000-5164_4691.wav,VTTS_b-4_2000-5164_4691.wav,2673,2496,177
12520,b-3_4315-4424_4323.wav,VTTS_b-3_4315-4424_4323.wav,4060,3750,310
12521,b-3_5957-6015_6000.wav,VTTS_b-3_5957-6015_6000.wav,2310,2136,174
12522,b-2_2107-2193_2107.wav,VTTS_b-2_2107-2193_2107.wav,1510,1428,82
12523,b-1_175-275_229.wav,VTTS_b-1_175-275_229.wav,1260,1103,157
12524,b-4_2000-5164_3079.wav,VTTS_b-4_2000-5164_3079.wav,8973,10495,-1522
12525,b-3_2524-2854_2667.wav,VTTS_b-3_2524-2854_2667.wav,4240,4261,-21
12526,b-3_1666-1763_1761.wav,VTTS_b-3_1666-1763_1761.wav,9530,9485,45
12527,b-1_2725-2825_2770.wav,VTTS_b-1_2725-2825_2770.wav,1830,1846,-16
12528,b-3_5009-5427_5017.wav,VTTS_b-3_5009-5427_5017.wav,4080,3529,551
12529,b-4_2000-5164_2997.wav,VTTS_b-4_2000-5164_2997.wav,4781,11610,-6829
12530,b-2_1325-1426_1357.wav,VTTS_b-2_1325-1426_1357.wav,1880,1927,-47
12531,b-4_2000-5164_2204.wav,VTTS_b-4_2000-5164_2204.wav,2945,3878,-933
12532,b-1_3329-3429_3407.wav,VTTS_b-1_3329-3429_3407.wav,1900,1904,-4
12533,b-1_2725-2825_2822.wav,VTTS_b-1_2725-2825_2822.wav,3930,3471,459
12534,b-3_6116-6215_6196.wav,VTTS_b-3_6116-6215_6196.wav,4140,4017,123
12535,b-3_3454-3537_3489.wav,VTTS_b-3_3454-3537_3489.wav,5730,5747,-17
12536,b-3_4001-4103_4056.wav,VTTS_b-3_4001-4103_4056.wav,2570,3181,-611
12537,b-4_2000-5164_4890.wav,VTTS_b-4_2000-5164_4890.wav,1080,940,140
12538,b-2_1801-1902_1811.wav,VTTS_b-2_1801-1902_1811.wav,1770,1707,63
12539,b-4_2000-5164_4001.wav,VTTS_b-4_2000-5164_4001.wav,5332,4934,398
12540,b-2_2194-2208_2199.wav,VTTS_b-2_2194-2208_2199.wav,3950,3518,432
12541,b-3_6016-6115_6030.wav,VTTS_b-3_6016-6115_6030.wav,13540,11610,1930
12542,b-3_5009-5427_5408.wav,VTTS_b-3_5009-5427_5408.wav,4750,4946,-196
12543,b-4_151-300_236.wav,VTTS_b-4_151-300_236.wav,3390,3100,290
12544,b-2_1223-1324_1280.wav,VTTS_b-2_1223-1324_1280.wav,8650,11610,-2960
12545,b-3_294-391_335.wav,VTTS_b-3_294-391_335.wav,1870,1858,12
12546,b-4_1901-2000_1964.wav,VTTS_b-4_1901-2000_1964.wav,8390,11610,-3220
12547,b-1_579-649_612.wav,VTTS_b-1_579-649_612.wav,940,975,-35
12548,b-3_3454-3537_3500.wav,VTTS_b-3_3454-3537_3500.wav,3520,4957,-1437
12549,b-4_2000-5164_4769.wav,VTTS_b-4_2000-5164_4769.wav,4816,4992,-176
12550,b-4_2000-5164_2991.wav,VTTS_b-4_2000-5164_2991.wav,9004,7187,1817
12551,b-3_5533-5638_5535.wav,VTTS_b-3_5533-5638_5535.wav,3750,3878,-128
12552,b-3_3025-3111_3044.wav,VTTS_b-3_3025-3111_3044.wav,6000,5271,729
12553,b-1_2725-2825_2765.wav,VTTS_b-1_2725-2825_2765.wav,3910,3727,183
12554,b-4_53-150_109.wav,VTTS_b-4_53-150_109.wav,7700,8464,-764
12555,b-3_6016-6115_6021.wav,VTTS_b-3_6016-6115_6021.wav,2980,2635,345
12556,b-4_1601-1706_1611.wav,VTTS_b-4_1601-1706_1611.wav,3940,4272,-332
12557,b-1_1717-1817_1753.wav,VTTS_b-1_1717-1817_1753.wav,4560,4690,-130
12558,b-3_1-97_26.wav,VTTS_b-3_1-97_26.wav,3200,3982,-782
12559,b-3_6301-6400_6311.wav,VTTS_b-3_6301-6400_6311.wav,4130,5143,-1013
12560,b-3_6801-6900_6811.wav,VTTS_b-3_6801-6900_6811.wav,2130,2368,-238
12561,b-4_2000-5164_4040.wav,VTTS_b-4_2000-5164_4040.wav,8781,10913,-2132
12562,b-4_151-300_186.wav,VTTS_b-4_151-300_186.wav,4060,4238,-178
12563,b-2_1019-1120_1087.wav,VTTS_b-2_1019-1120_1087.wav,2850,2171,679
12564,b-4_53-150_77.wav,VTTS_b-4_53-150_77.wav,8880,8963,-83
12565,b-3_4207-4314_4278.wav,VTTS_b-3_4207-4314_4278.wav,4670,5004,-334
12566,b-2_1903-2038_2020.wav,VTTS_b-2_1903-2038_2020.wav,3210,2659,551
12567,b-3_2267-2349_2340.wav,VTTS_b-3_2267-2349_2340.wav,7720,7396,324
12568,b-4_2000-5164_2037.wav,VTTS_b-4_2000-5164_2037.wav,2225,2612,-387
12569,b-3_980-1077_1020.wav,VTTS_b-3_980-1077_1020.wav,3490,3425,65
12570,b-4_2000-5164_2472.wav,VTTS_b-4_2000-5164_2472.wav,5590,5283,307
12571,b-2_815-916_915.wav,VTTS_b-2_815-916_915.wav,5570,8499,-2929
12572,b-3_5009-5427_5280.wav,VTTS_b-3_5009-5427_5280.wav,4710,4876,-166
12573,b-1_2927-3025_2930.wav,VTTS_b-1_2927-3025_2930.wav,3510,3355,155
12574,b-3_6701-6800_6712.wav,VTTS_b-3_6701-6800_6712.wav,2160,2171,-11
12575,b-3_501-930_676.wav,VTTS_b-3_501-930_676.wav,2830,3553,-723
12576,b-1_2119-2219_2191.wav,VTTS_b-1_2119-2219_2191.wav,1780,1811,-31
12577,b-2_1903-2038_2014.wav,VTTS_b-2_1903-2038_2014.wav,1460,1254,206
12578,b-4_2000-5164_3261.wav,VTTS_b-4_2000-5164_3261.wav,1726,1602,124
12579,b-2_407-508_471.wav,VTTS_b-2_407-508_471.wav,5990,5097,893
12580,b-3_3803-3888_3806.wav,VTTS_b-3_3803-3888_3806.wav,7970,6792,1178
12581,b-3_3889-4000_3900.wav,VTTS_b-3_3889-4000_3900.wav,8440,8208,232
12582,b-1_3531-3631_3535.wav,VTTS_b-1_3531-3631_3535.wav,1120,1057,63
12583,b-1_1111-1211_1174.wav,VTTS_b-1_1111-1211_1174.wav,2270,2125,145
12584,b-1_3127-3227_3139.wav,VTTS_b-1_3127-3227_3139.wav,3110,2856,254
12585,b-3_931-979_969.wav,VTTS_b-3_931-979_969.wav,5810,6211,-401
12586,b-4_2000-5164_3437.wav,VTTS_b-4_2000-5164_3437.wav,4737,5108,-371
12587,b-4_1601-1706_1626.wav,VTTS_b-4_1601-1706_1626.wav,3930,3553,377
12588,b-3_2855-2942_2931.wav,VTTS_b-3_2855-2942_2931.wav,3540,4458,-918
12589,b-3_3198-3278_3225.wav,VTTS_b-3_3198-3278_3225.wav,3890,5921,-2031
12590,b-3_98-195_134.wav,VTTS_b-3_98-195_134.wav,6930,6513,417
12591,b-3_6301-6400_6317.wav,VTTS_b-3_6301-6400_6317.wav,7070,6757,313
12592,b-4_2000-5164_5092.wav,VTTS_b-4_2000-5164_5092.wav,2450,2183,267
12593,b-3_2434-2523_2480.wav,VTTS_b-3_2434-2523_2480.wav,2500,2694,-194
12594,b-2_1223-1324_1265.wav,VTTS_b-2_1223-1324_1265.wav,2720,2810,-90
12595,b-1_3228-3328_3240.wav,VTTS_b-1_3228-3328_3240.wav,1300,1358,-58
12596,b-2_1903-2038_1949.wav,VTTS_b-2_1903-2038_1949.wav,3210,2856,354
12597,b-3_3279-3363_3332.wav,VTTS_b-3_3279-3363_3332.wav,2920,3019,-99
12598,b-4_1707-1813_1712.wav,VTTS_b-4_1707-1813_1712.wav,5870,5050,820
12599,b-3_3198-3278_3235.wav,VTTS_b-3_3198-3278_3235.wav,4140,3959,181
12600,b-3_6116-6215_6163.wav,VTTS_b-3_6116-6215_6163.wav,3980,3518,462
12601,b-2_305-406_347.wav,VTTS_b-2_305-406_347.wav,2400,2647,-247
12602,b-3_5957-6015_5965.wav,VTTS_b-3_5957-6015_5965.wav,3240,3228,12
12603,b-4_2000-5164_2774.wav,VTTS_b-4_2000-5164_2774.wav,6800,7082,-282
12604,b-3_4315-4424_4380.wav,VTTS_b-3_4315-4424_4380.wav,6860,6676,184
12605,b-3_2524-2854_2830.wav,VTTS_b-3_2524-2854_2830.wav,7000,7047,-47
12606,b-4_2000-5164_2288.wav,VTTS_b-4_2000-5164_2288.wav,8740,9660,-920
12607,b-2_917-1018_936.wav,VTTS_b-2_917-1018_936.wav,1280,1219,61
12608,b-1_3228-3328_3237.wav,VTTS_b-1_3228-3328_3237.wav,1440,1498,-58
12609,b-3_1-97_13.wav,VTTS_b-3_1-97_13.wav,8730,8615,115
12610,b-4_1707-1813_1763.wav,VTTS_b-4_1707-1813_1763.wav,6330,6049,281
12611,b-1_74-174_97.wav,VTTS_b-1_74-174_97.wav,2450,2403,47
12612,b-1_74-174_158.wav,VTTS_b-1_74-174_158.wav,3060,3042,18
12613,b-1_3733-3833_3822.wav,VTTS_b-1_3733-3833_3822.wav,2220,2252,-32
12614,b-4_2000-5164_3731.wav,VTTS_b-4_2000-5164_3731.wav,3740,3495,245
12615,b-3_2000-2088_2011.wav,VTTS_b-3_2000-2088_2011.wav,8410,7941,469
12616,b-2_203-304_212.wav,VTTS_b-2_203-304_212.wav,1350,1370,-20
12617,b-4_2000-5164_4671.wav,VTTS_b-4_2000-5164_4671.wav,5741,5561,180
12618,b-3_3803-3888_3859.wav,VTTS_b-3_3803-3888_3859.wav,2970,4760,-1790
12619,b-1_4106-4141_4127.wav,VTTS_b-1_4106-4141_4127.wav,3720,3518,202
12620,b-3_6601-6700_6664.wav,VTTS_b-3_6601-6700_6664.wav,2770,2972,-202
12621,b-1_3026-3126_3119.wav,VTTS_b-1_3026-3126_3119.wav,3890,3820,70
12622,b-2_203-304_251.wav,VTTS_b-2_203-304_251.wav,4410,4156,254
12623,b-3_1321-1568_1432.wav,VTTS_b-3_1321-1568_1432.wav,1220,1045,175
12624,b-1_686-793_701.wav,VTTS_b-1_686-793_701.wav,3650,3947,-297
12625,b-3_6501-6600_6507.wav,VTTS_b-3_6501-6600_6507.wav,4620,4342,278
12626,b-3_1079-1320_1148.wav,VTTS_b-3_1079-1320_1148.wav,8730,8371,359
12627,b-3_5009-5427_5296.wav,VTTS_b-3_5009-5427_5296.wav,2570,2589,-19
12628,b-1_1010-1110_1013.wav,VTTS_b-1_1010-1110_1013.wav,2700,3065,-365
12629,b-1_3329-3429_3408.wav,VTTS_b-1_3329-3429_3408.wav,2720,3297,-577
12630,b-4_501-1014_848.wav,VTTS_b-4_501-1014_848.wav,5710,6455,-745
12631,b-1_1515-1615_1594.wav,VTTS_b-1_1515-1615_1594.wav,1500,1393,107
12632,b-4_2000-5164_3974.wav,VTTS_b-4_2000-5164_3974.wav,4559,4911,-352
12633,b-3_1960-2000_1971.wav,VTTS_b-3_1960-2000_1971.wav,5540,5584,-44
12634,b-4_501-1014_771.wav,VTTS_b-4_501-1014_771.wav,1920,1834,86
12635,b-2_101-202_193.wav,VTTS_b-2_101-202_193.wav,1900,1788,112
12636,b-3_2855-2942_2926.wav,VTTS_b-3_2855-2942_2926.wav,3150,3065,85
12637,b-1_1717-1817_1752.wav,VTTS_b-1_1717-1817_1752.wav,1060,1057,3
12638,b-4_2000-5164_2853.wav,VTTS_b-4_2000-5164_2853.wav,7950,8766,-816
12639,b-3_1079-1320_1100.wav,VTTS_b-3_1079-1320_1100.wav,6080,5039,1041
12640,b-4_401-500_469.wav,VTTS_b-4_401-500_469.wav,6270,6142,128
12641,b-3_3454-3537_3522.wav,VTTS_b-3_3454-3537_3522.wav,6530,5468,1062
12642,b-1_2220-2320_2290.wav,VTTS_b-1_2220-2320_2290.wav,1190,1277,-87
12643,b-4_501-1014_927.wav,VTTS_b-4_501-1014_927.wav,1610,1416,194
12644,b-1_3127-3227_3135.wav,VTTS_b-1_3127-3227_3135.wav,4000,4052,-52
12645,b-4_2000-5164_2661.wav,VTTS_b-4_2000-5164_2661.wav,3200,3611,-411
12646,b-1_1313-1413_1362.wav,VTTS_b-1_1313-1413_1362.wav,2040,2136,-96
12647,b-1_3733-3833_3750.wav,VTTS_b-1_3733-3833_3750.wav,4090,4203,-113
12648,b-1_686-793_692.wav,VTTS_b-1_686-793_692.wav,2670,2635,35
12649,b-3_2943-3024_2970.wav,VTTS_b-3_2943-3024_2970.wav,8500,9056,-556
12650,b-2_611-712_646.wav,VTTS_b-2_611-712_646.wav,1210,1103,107
12651,b-4_1301-1400_1335.wav,VTTS_b-4_1301-1400_1335.wav,7650,7558,92
12652,b-3_2524-2854_2711.wav,VTTS_b-3_2524-2854_2711.wav,4190,3982,208
12653,b-3_4498-4605_4602.wav,VTTS_b-3_4498-4605_4602.wav,2420,2276,144
12654,b-2_1699-1800_1729.wav,VTTS_b-2_1699-1800_1729.wav,1610,1231,379
12655,b-3_501-930_900.wav,VTTS_b-3_501-930_900.wav,3130,3007,123
12656,b-1_1414-1514_1424.wav,VTTS_b-1_1414-1514_1424.wav,2730,2635,95
12657,b-3_2524-2854_2826.wav,VTTS_b-3_2524-2854_2826.wav,3660,3158,502
12658,b-4_401-500_454.wav,VTTS_b-4_401-500_454.wav,4770,4505,265
12659,b-4_1901-2000_1990.wav,VTTS_b-4_1901-2000_1990.wav,3380,3309,71
12660,b-1_2624-2724_2635.wav,VTTS_b-1_2624-2724_2635.wav,1640,1567,73
12661,b-2_203-304_287.wav,VTTS_b-2_203-304_287.wav,1840,1498,342
12662,b-1_377-477_417.wav,VTTS_b-1_377-477_417.wav,1520,1683,-163
12663,b-3_501-930_880.wav,VTTS_b-3_501-930_880.wav,4640,4296,344
12664,b-3_6301-6400_6306.wav,VTTS_b-3_6301-6400_6306.wav,2390,2357,33
12665,b-3_3454-3537_3460.wav,VTTS_b-3_3454-3537_3460.wav,10130,11610,-1480
12666,b-2_1427-1562_1456.wav,VTTS_b-2_1427-1562_1456.wav,3470,3309,161
12667,b-4_1506-1600_1520.wav,VTTS_b-4_1506-1600_1520.wav,6060,5445,615
12668,b-1_276-376_355.wav,VTTS_b-1_276-376_355.wav,1340,1370,-30
12669,b-2_509-610_515.wav,VTTS_b-2_509-610_515.wav,3920,4574,-654
12670,b-2_1903-2038_2018.wav,VTTS_b-2_1903-2038_2018.wav,1890,1765,125
12671,b-3_980-1077_1028.wav,VTTS_b-3_980-1077_1028.wav,5190,6014,-824
12672,b-3_4607-5008_4905.wav,VTTS_b-3_4607-5008_4905.wav,1040,975,65
12673,b-4_2000-5164_2998.wav,VTTS_b-4_2000-5164_2998.wav,3704,3947,-243
12674,b-2_2413-2500_2422.wav,VTTS_b-2_2413-2500_2422.wav,2480,2380,100
12675,b-3_4001-4103_4030.wav,VTTS_b-3_4001-4103_4030.wav,3720,4110,-390
12676,b-3_1862-1959_1900.wav,VTTS_b-3_1862-1959_1900.wav,2710,2786,-76
12677,b-2_1019-1120_1043.wav,VTTS_b-2_1019-1120_1043.wav,2460,2334,126
12678,b-4_1401-1505_1492.wav,VTTS_b-4_1401-1505_1492.wav,9440,7454,1986
12679,b-3_4207-4314_4261.wav,VTTS_b-3_4207-4314_4261.wav,5750,5248,502
12680,b-3_1079-1320_1277.wav,VTTS_b-3_1079-1320_1277.wav,10930,11099,-169
12681,b-2_509-610_540.wav,VTTS_b-2_509-610_540.wav,2930,3135,-205
12682,b-3_1666-1763_1696.wav,VTTS_b-3_1666-1763_1696.wav,4090,4122,-32
12683,b-4_2000-5164_2250.wav,VTTS_b-4_2000-5164_2250.wav,4655,4899,-244
12684,b-1_2826-2926_2923.wav,VTTS_b-1_2826-2926_2923.wav,2200,2752,-552
12685,b-3_5009-5427_5266.wav,VTTS_b-3_5009-5427_5266.wav,6660,4992,1668
12686,b-1_4466-4498_4469.wav,VTTS_b-1_4466-4498_4469.wav,2900,3796,-896
12687,b-3_3364-3453_3414.wav,VTTS_b-3_3364-3453_3414.wav,5490,5492,-2
12688,b-3_5853-5956_5935.wav,VTTS_b-3_5853-5956_5935.wav,2950,3529,-579
12689,b-3_2177-2266_2250.wav,VTTS_b-3_2177-2266_2250.wav,5390,5341,49
12690,b-1_2018-2118_2039.wav,VTTS_b-1_2018-2118_2039.wav,3290,3019,271
12691,b-4_401-500_436.wav,VTTS_b-4_401-500_436.wav,11950,11610,340
12692,b-4_401-500_401.wav,VTTS_b-4_401-500_401.wav,5880,5457,423
12693,b-1_4430-4465_4459.wav,VTTS_b-1_4430-4465_4459.wav,3040,3355,-315
12694,b-4_2000-5164_4474.wav,VTTS_b-4_2000-5164_4474.wav,10489,11610,-1121
12695,b-3_2524-2854_2629.wav,VTTS_b-3_2524-2854_2629.wav,3380,3471,-91
12696,b-1_1919-2017_2000.wav,VTTS_b-1_1919-2017_2000.wav,1370,1486,-116
12697,b-3_3198-3278_3211.wav,VTTS_b-3_3198-3278_3211.wav,7620,6873,747
12698,b-3_4498-4605_4596.wav,VTTS_b-3_4498-4605_4596.wav,10740,10461,279
12699,b-3_6701-6800_6765.wav,VTTS_b-3_6701-6800_6765.wav,10080,11610,-1530
12700,b-4_1-52_19.wav,VTTS_b-4_1-52_19.wav,5590,5550,40
12701,b-1_4142-4177_4151.wav,VTTS_b-1_4142-4177_4151.wav,5460,5817,-357
12702,b-1_2725-2825_2805.wav,VTTS_b-1_2725-2825_2805.wav,4040,4598,-558
12703,b-1_3329-3429_3337.wav,VTTS_b-1_3329-3429_3337.wav,4430,8290,-3860
12704,b-1_2624-2724_2674.wav,VTTS_b-1_2624-2724_2674.wav,2870,7407,-4537
12705,b-4_1-52_26.wav,VTTS_b-4_1-52_26.wav,4640,4586,54
12706,b-2_917-1018_993.wav,VTTS_b-2_917-1018_993.wav,2470,3181,-711
12707,b-3_501-930_856.wav,VTTS_b-3_501-930_856.wav,1980,1927,53
12708,b-3_2524-2854_2544.wav,VTTS_b-3_2524-2854_2544.wav,2200,2194,6
12709,b-2_1903-2038_1959.wav,VTTS_b-2_1903-2038_1959.wav,1840,2380,-540
12710,b-3_294-391_370.wav,VTTS_b-3_294-391_370.wav,3390,3204,186
12711,b-3_5957-6015_6007.wav,VTTS_b-3_5957-6015_6007.wav,7680,7697,-17
12712,b-4_2000-5164_3085.wav,VTTS_b-4_2000-5164_3085.wav,7486,6711,775
12713,b-1_1515-1615_1582.wav,VTTS_b-1_1515-1615_1582.wav,4330,6873,-2543
12714,b-3_3803-3888_3853.wav,VTTS_b-3_3803-3888_3853.wav,3380,2868,512
12715,b-4_2000-5164_3402.wav,VTTS_b-4_2000-5164_3402.wav,3521,3286,235
12716,b-1_1111-1211_1189.wav,VTTS_b-1_1111-1211_1189.wav,3680,3077,603
12717,b-1_377-477_411.wav,VTTS_b-1_377-477_411.wav,1930,2380,-450
12718,b-1_3733-3833_3742.wav,VTTS_b-1_3733-3833_3742.wav,1540,1277,263
12719,b-3_2267-2349_2308.wav,VTTS_b-3_2267-2349_2308.wav,3480,3065,415
12720,b-3_2524-2854_2841.wav,VTTS_b-3_2524-2854_2841.wav,6620,6409,211
12721,b-2_1019-1120_1111.wav,VTTS_b-2_1019-1120_1111.wav,4320,5259,-939
12722,b-3_6274-6300_6282.wav,VTTS_b-3_6274-6300_6282.wav,3610,3692,-82
12723,b-3_6900-7016_6957.wav,VTTS_b-3_6900-7016_6957.wav,8140,8069,71
12724,b-3_980-1077_1054.wav,VTTS_b-3_980-1077_1054.wav,4310,3506,804
12725,b-3_3112-3197_3134.wav,VTTS_b-3_3112-3197_3134.wav,3980,3541,439
12726,b-1_2018-2118_2102.wav,VTTS_b-1_2018-2118_2102.wav,3410,2775,635
12727,b-2_305-406_323.wav,VTTS_b-2_305-406_323.wav,5010,5677,-667
12728,b-1_2826-2926_2831.wav,VTTS_b-1_2826-2926_2831.wav,1300,1416,-116
12729,b-4_401-500_432.wav,VTTS_b-4_401-500_432.wav,5120,5143,-23
12730,b-4_1221-1300_1251.wav,VTTS_b-4_1221-1300_1251.wav,3890,3936,-46
12731,b-1_3834-3934_3860.wav,VTTS_b-1_3834-3934_3860.wav,2560,2357,203
12732,b-1_1414-1514_1499.wav,VTTS_b-1_1414-1514_1499.wav,1860,2206,-346
12733,b-3_501-930_705.wav,VTTS_b-3_501-930_705.wav,2580,2136,444
12734,b-2_713-814_747.wav,VTTS_b-2_713-814_747.wav,2010,1869,141
12735,b-3_3803-3888_3863.wav,VTTS_b-3_3803-3888_3863.wav,1590,1474,116
12736,b-2_1903-2038_2027.wav,VTTS_b-2_1903-2038_2027.wav,2430,2276,154
12737,b-1_3834-3934_3911.wav,VTTS_b-1_3834-3934_3911.wav,1720,1695,25
12738,b-1_1111-1211_1141.wav,VTTS_b-1_1111-1211_1141.wav,1840,1509,331
12739,b-4_501-1014_858.wav,VTTS_b-4_501-1014_858.wav,8430,8998,-568
12740,b-4_2000-5164_4672.wav,VTTS_b-4_2000-5164_4672.wav,6659,6571,88
12741,b-4_2000-5164_4554.wav,VTTS_b-4_2000-5164_4554.wav,5683,5573,110
12742,b-1_478-578_487.wav,VTTS_b-1_478-578_487.wav,2980,3320,-340
12743,b-1_2119-2219_2122.wav,VTTS_b-1_2119-2219_2122.wav,1770,1753,17
12744,b-3_4498-4605_4548.wav,VTTS_b-3_4498-4605_4548.wav,7830,10577,-2747
12745,b-3_2267-2349_2330.wav,VTTS_b-3_2267-2349_2330.wav,3520,3390,130
12746,b-3_501-930_821.wav,VTTS_b-3_501-930_821.wav,8060,7581,479
12747,b-3_4001-4103_4090.wav,VTTS_b-3_4001-4103_4090.wav,9620,9474,146
12748,b-4_1707-1813_1739.wav,VTTS_b-4_1707-1813_1739.wav,3230,2496,734
12749,b-3_4607-5008_4985.wav,VTTS_b-3_4607-5008_4985.wav,4150,3692,458
12750,b-3_2524-2854_2807.wav,VTTS_b-3_2524-2854_2807.wav,3310,3518,-208
12751,b-3_196-293_257.wav,VTTS_b-3_196-293_257.wav,2320,2694,-374
12752,b-4_1014-1100_1073.wav,VTTS_b-4_1014-1100_1073.wav,2090,1811,279
12753,b-1_686-793_700.wav,VTTS_b-1_686-793_700.wav,3100,3437,-337
12754,b-1_478-578_568.wav,VTTS_b-1_478-578_568.wav,1390,1324,66
12755,b-1_1414-1514_1514.wav,VTTS_b-1_1414-1514_1514.wav,1490,1463,27
12756,b-4_2000-5164_5148.wav,VTTS_b-4_2000-5164_5148.wav,4650,4447,203
12757,b-3_1321-1568_1419.wav,VTTS_b-3_1321-1568_1419.wav,760,778,-18
12758,b-1_3632-3732_3666.wav,VTTS_b-1_3632-3732_3666.wav,3420,3483,-63
12759,b-2_407-508_467.wav,VTTS_b-2_407-508_467.wav,1540,1950,-410
12760,b-2_1699-1800_1778.wav,VTTS_b-2_1699-1800_1778.wav,5960,6246,-286
12761,b-4_2000-5164_3785.wav,VTTS_b-4_2000-5164_3785.wav,3870,4168,-298
12762,b-3_6501-6600_6503.wav,VTTS_b-3_6501-6600_6503.wav,5010,4168,842
12763,b-4_501-1014_578.wav,VTTS_b-4_501-1014_578.wav,1690,1625,65
12764,b-2_203-304_243.wav,VTTS_b-2_203-304_243.wav,1530,1265,265
12765,b-3_3454-3537_3470.wav,VTTS_b-3_3454-3537_3470.wav,3240,3355,-115
12766,b-1_1919-2017_1993.wav,VTTS_b-1_1919-2017_1993.wav,2200,2229,-29
12767,b-1_1616-1716_1625.wav,VTTS_b-1_1616-1716_1625.wav,1310,1231,79
12768,b-3_2524-2854_2616.wav,VTTS_b-3_2524-2854_2616.wav,4630,4644,-14
12769,b-1_686-793_768.wav,VTTS_b-1_686-793_768.wav,1210,1231,-21
12770,b-3_3803-3888_3812.wav,VTTS_b-3_3803-3888_3812.wav,9040,8591,449
12771,b-2_2413-2500_2434.wav,VTTS_b-2_2413-2500_2434.wav,2080,2264,-184
12772,b-3_4607-5008_4885.wav,VTTS_b-3_4607-5008_4885.wav,6960,6490,470
12773,b-1_1717-1817_1786.wav,VTTS_b-1_1717-1817_1786.wav,2850,2821,29
12774,b-3_2177-2266_2209.wav,VTTS_b-3_2177-2266_2209.wav,5270,4725,545
12775,b-3_5009-5427_5358.wav,VTTS_b-3_5009-5427_5358.wav,3540,4052,-512
12776,b-3_4498-4605_4505.wav,VTTS_b-3_4498-4605_4505.wav,6450,5735,715
12777,b-1_1313-1413_1334.wav,VTTS_b-1_1313-1413_1334.wav,2550,2647,-97
12778,b-1_4430-4465_4430.wav,VTTS_b-1_4430-4465_4430.wav,2100,2043,57
12779,b-1_686-793_735.wav,VTTS_b-1_686-793_735.wav,1420,1416,4
12780,b-1_3733-3833_3791.wav,VTTS_b-1_3733-3833_3791.wav,2740,2879,-139
12781,b-3_3889-4000_3903.wav,VTTS_b-3_3889-4000_3903.wav,4520,5584,-1064
12782,b-1_3632-3732_3653.wav,VTTS_b-1_3632-3732_3653.wav,2880,3077,-197
12783,b-3_196-293_272.wav,VTTS_b-3_196-293_272.wav,3630,3773,-143
12784,b-3_4498-4605_4543.wav,VTTS_b-3_4498-4605_4543.wav,8420,8847,-427
12785,b-3_2350-2433_2378.wav,VTTS_b-3_2350-2433_2378.wav,4630,5550,-920
12786,b-3_294-391_376.wav,VTTS_b-3_294-391_376.wav,1470,1567,-97
12787,b-4_2000-5164_3872.wav,VTTS_b-4_2000-5164_3872.wav,3916,3855,61
12788,b-2_2311-2412_2340.wav,VTTS_b-2_2311-2412_2340.wav,4560,4435,125
12789,b-3_1321-1568_1413.wav,VTTS_b-3_1321-1568_1413.wav,1230,1033,197
12790,b-3_3364-3453_3396.wav,VTTS_b-3_3364-3453_3396.wav,1960,2055,-95
12791,b-4_1301-1400_1360.wav,VTTS_b-4_1301-1400_1360.wav,5140,4911,229
12792,b-3_1764-1861_1815.wav,VTTS_b-3_1764-1861_1815.wav,5540,5747,-207
12793,b-2_2413-2500_2437.wav,VTTS_b-2_2413-2500_2437.wav,2710,4377,-1667
12794,b-4_501-1014_983.wav,VTTS_b-4_501-1014_983.wav,6250,6107,143
12795,b-2_1903-2038_1993.wav,VTTS_b-2_1903-2038_1993.wav,2050,1591,459
12796,b-4_2000-5164_4240.wav,VTTS_b-4_2000-5164_4240.wav,1922,1765,157
12797,b-3_6501-6600_6556.wav,VTTS_b-3_6501-6600_6556.wav,4470,4493,-23
12798,b-2_2107-2193_2141.wav,VTTS_b-2_2107-2193_2141.wav,1050,1115,-65
12799,b-3_1666-1763_1739.wav,VTTS_b-3_1666-1763_1739.wav,4990,5584,-594
12800,b-4_401-500_438.wav,VTTS_b-4_401-500_438.wav,1770,1614,156
12801,b-1_1111-1211_1125.wav,VTTS_b-1_1111-1211_1125.wav,3880,4040,-160
12802,b-3_1321-1568_1442.wav,VTTS_b-3_1321-1568_1442.wav,5380,5526,-146
12803,b-1_1212-1312_1214.wav,VTTS_b-1_1212-1312_1214.wav,1690,2380,-690
12804,b-2_2311-2412_2412.wav,VTTS_b-2_2311-2412_2412.wav,1320,1335,-15
12805,b-3_1321-1568_1537.wav,VTTS_b-3_1321-1568_1537.wav,3280,3111,169
12806,b-3_6801-6900_6892.wav,VTTS_b-3_6801-6900_6892.wav,4890,11610,-6720
12807,b-3_3025-3111_3059.wav,VTTS_b-3_3025-3111_3059.wav,4270,3750,520
12808,b-4_501-1014_910.wav,VTTS_b-4_501-1014_910.wav,3620,3448,172
12809,b-1_1818-1918_1876.wav,VTTS_b-1_1818-1918_1876.wav,2540,2740,-200
12810,b-3_5428-5533_5433.wav,VTTS_b-3_5428-5533_5433.wav,3570,3100,470
12811,b-3_3889-4000_3938.wav,VTTS_b-3_3889-4000_3938.wav,7730,7361,369
12812,b-3_196-293_200.wav,VTTS_b-3_196-293_200.wav,3160,3843,-683
12813,b-3_3364-3453_3409.wav,VTTS_b-3_3364-3453_3409.wav,4820,4400,420
12814,b-2_203-304_293.wav,VTTS_b-2_203-304_293.wav,3290,3111,179
12815,b-3_2177-2266_2177.wav,VTTS_b-3_2177-2266_2177.wav,5930,6107,-177
12816,b-2_1699-1800_1769.wav,VTTS_b-2_1699-1800_1769.wav,1440,1695,-255
12817,b-1_1313-1413_1329.wav,VTTS_b-1_1313-1413_1329.wav,3790,4644,-854
12818,b-3_2855-2942_2924.wav,VTTS_b-3_2855-2942_2924.wav,6400,7105,-705
12819,b-4_2000-5164_3590.wav,VTTS_b-4_2000-5164_3590.wav,1821,1718,103
12820,b-4_1707-1813_1751.wav,VTTS_b-4_1707-1813_1751.wav,6510,6002,508
12821,b-4_1814-1900_1876.wav,VTTS_b-4_1814-1900_1876.wav,4220,3936,284
12822,b-1_1010-1110_1028.wav,VTTS_b-1_1010-1110_1028.wav,2740,3309,-569
12823,b-3_2000-2088_2075.wav,VTTS_b-3_2000-2088_2075.wav,4300,4005,295
12824,b-1_1818-1918_1835.wav,VTTS_b-1_1818-1918_1835.wav,1470,1370,100
12825,b-4_1101-1220_1197.wav,VTTS_b-4_1101-1220_1197.wav,590,546,44
12826,b-3_5853-5956_5888.wav,VTTS_b-3_5853-5956_5888.wav,3980,3936,44
12827,b-3_2350-2433_2370.wav,VTTS_b-3_2350-2433_2370.wav,7570,9009,-1439
12828,b-4_2000-5164_3008.wav,VTTS_b-4_2000-5164_3008.wav,5623,5875,-252
12829,b-3_6900-7016_6951.wav,VTTS_b-3_6900-7016_6951.wav,5380,4389,991
12830,b-3_294-391_324.wav,VTTS_b-3_294-391_324.wav,6590,6397,193
12831,b-3_3715-3802_3799.wav,VTTS_b-3_3715-3802_3799.wav,4640,4667,-27
12832,b-3_6701-6800_6788.wav,VTTS_b-3_6701-6800_6788.wav,14270,11610,2660
12833,b-1_2220-2320_2261.wav,VTTS_b-1_2220-2320_2261.wav,2300,2589,-289
12834,b-2_1597-1698_1620.wav,VTTS_b-2_1597-1698_1620.wav,2210,2357,-147
12835,b-3_5009-5427_5347.wav,VTTS_b-3_5009-5427_5347.wav,4640,4296,344
12836,b-1_2422-2522_2519.wav,VTTS_b-1_2422-2522_2519.wav,3640,3727,-87
12837,b-2_1-100_83.wav,VTTS_b-2_1-100_83.wav,2230,2635,-405
12838,b-3_1079-1320_1102.wav,VTTS_b-3_1079-1320_1102.wav,3640,3541,99
12839,b-3_4207-4314_4222.wav,VTTS_b-3_4207-4314_4222.wav,7040,8545,-1505
12840,b-1_2826-2926_2877.wav,VTTS_b-1_2826-2926_2877.wav,4510,4226,284
12841,b-2_1903-2038_1941.wav,VTTS_b-2_1903-2038_1941.wav,1960,2043,-83
12842,b-3_4498-4605_4569.wav,VTTS_b-3_4498-4605_4569.wav,3720,4110,-390
12843,b-3_3889-4000_3934.wav,VTTS_b-3_3889-4000_3934.wav,6890,6815,75
12844,b-4_151-300_243.wav,VTTS_b-4_151-300_243.wav,2400,2206,194
12845,b-1_3733-3833_3761.wav,VTTS_b-1_3733-3833_3761.wav,2750,3170,-420
12846,b-3_4607-5008_4780.wav,VTTS_b-3_4607-5008_4780.wav,5140,4934,206
12847,b-1_1919-2017_1946.wav,VTTS_b-1_1919-2017_1946.wav,1640,1660,-20
12848,b-3_501-930_640.wav,VTTS_b-3_501-930_640.wav,4070,3669,401
12849,b-4_2000-5164_3774.wav,VTTS_b-4_2000-5164_3774.wav,17140,11610,5530
12850,b-2_305-406_376.wav,VTTS_b-2_305-406_376.wav,2330,2786,-456
12851,b-2_203-304_231.wav,VTTS_b-2_203-304_231.wav,1430,1800,-370
12852,b-3_4607-5008_4992.wav,VTTS_b-3_4607-5008_4992.wav,5110,5097,13
12853,b-4_501-1014_829.wav,VTTS_b-4_501-1014_829.wav,3510,4389,-879
12854,b-4_1301-1400_1312.wav,VTTS_b-4_1301-1400_1312.wav,4920,4714,206
12855,b-2_1427-1562_1447.wav,VTTS_b-2_1427-1562_1447.wav,1070,929,141
12856,b-1_3531-3631_3534.wav,VTTS_b-1_3531-3631_3534.wav,1340,2717,-1377
12857,b-2_1903-2038_1911.wav,VTTS_b-2_1903-2038_1911.wav,6830,6107,723
12858,b-3_294-391_337.wav,VTTS_b-3_294-391_337.wav,4260,3889,371
12859,b-2_1121-1222_1154.wav,VTTS_b-2_1121-1222_1154.wav,1930,2589,-659
12860,b-1_2119-2219_2162.wav,VTTS_b-1_2119-2219_2162.wav,2040,1950,90
12861,b-3_6401-6500_6415.wav,VTTS_b-3_6401-6500_6415.wav,5660,4748,912
12862,b-4_2000-5164_3939.wav,VTTS_b-4_2000-5164_3939.wav,4191,3982,209
12863,b-2_2311-2412_2410.wav,VTTS_b-2_2311-2412_2410.wav,1530,1486,44
12864,b-3_6501-6600_6569.wav,VTTS_b-3_6501-6600_6569.wav,880,836,44
12865,b-2_917-1018_1000.wav,VTTS_b-2_917-1018_1000.wav,1450,1324,126
12866,b-1_794-1009_949.wav,VTTS_b-1_794-1009_949.wav,1470,1161,309
12867,b-1_4430-4465_4460.wav,VTTS_b-1_4430-4465_4460.wav,2890,3053,-163
12868,b-3_3364-3453_3448.wav,VTTS_b-3_3364-3453_3448.wav,3810,3518,292
12869,b-4_2000-5164_2952.wav,VTTS_b-4_2000-5164_2952.wav,6649,6293,356
12870,b-4_151-300_274.wav,VTTS_b-4_151-300_274.wav,1210,1103,107
12871,b-3_4607-5008_4786.wav,VTTS_b-3_4607-5008_4786.wav,2640,2868,-228
12872,b-3_4607-5008_4806.wav,VTTS_b-3_4607-5008_4806.wav,3930,4493,-563
12873,b-4_501-1014_697.wav,VTTS_b-4_501-1014_697.wav,1430,1242,188
12874,b-2_101-202_136.wav,VTTS_b-2_101-202_136.wav,1090,1033,57
12875,b-4_2000-5164_3637.wav,VTTS_b-4_2000-5164_3637.wav,6339,6594,-255
12876,b-4_2000-5164_3144.wav,VTTS_b-4_2000-5164_3144.wav,6573,5921,652
12877,b-2_2040-2072_2051.wav,VTTS_b-2_2040-2072_2051.wav,2400,2624,-224
12878,b-2_713-814_786.wav,VTTS_b-2_713-814_786.wav,6560,5573,987
12879,b-3_3803-3888_3852.wav,VTTS_b-3_3803-3888_3852.wav,1530,1509,21
12880,b-1_686-793_715.wav,VTTS_b-1_686-793_715.wav,1030,998,32
12881,b-4_2000-5164_5102.wav,VTTS_b-4_2000-5164_5102.wav,4209,4087,122
12882,b-1_1111-1211_1214.wav,VTTS_b-1_1111-1211_1214.wav,3840,4992,-1152
12883,b-3_5428-5533_5493.wav,VTTS_b-3_5428-5533_5493.wav,2150,2206,-56
12884,b-1_2624-2724_2669.wav,VTTS_b-1_2624-2724_2669.wav,1940,1811,129
12885,b-2_713-814_753.wav,VTTS_b-2_713-814_753.wav,2590,1591,999
12886,b-1_1414-1514_1460.wav,VTTS_b-1_1414-1514_1460.wav,830,998,-168
12887,b-4_2000-5164_2419.wav,VTTS_b-4_2000-5164_2419.wav,2115,2159,-44
12888,b-1_1717-1817_1794.wav,VTTS_b-1_1717-1817_1794.wav,1220,1219,1
12889,b-4_1101-1220_1170.wav,VTTS_b-4_1101-1220_1170.wav,4250,4063,187
12890,b-1_1313-1413_1313.wav,VTTS_b-1_1313-1413_1313.wav,4200,4029,171
12891,b-4_2000-5164_2919.wav,VTTS_b-4_2000-5164_2919.wav,5285,4934,351
12892,b-4_2000-5164_4896.wav,VTTS_b-4_2000-5164_4896.wav,1202,1242,-40
12893,b-4_2000-5164_4270.wav,VTTS_b-4_2000-5164_4270.wav,4499,4447,52
12894,b-1_3531-3631_3572.wav,VTTS_b-1_3531-3631_3572.wav,3770,3158,612
12895,b-4_2000-5164_3826.wav,VTTS_b-4_2000-5164_3826.wav,3606,3889,-283
12896,b-4_2000-5164_4482.wav,VTTS_b-4_2000-5164_4482.wav,2641,2473,168
12897,b-3_5533-5638_5540.wav,VTTS_b-3_5533-5638_5540.wav,9330,9358,-28
12898,b-3_1321-1568_1500.wav,VTTS_b-3_1321-1568_1500.wav,6980,6281,699
12899,b-3_2524-2854_2587.wav,VTTS_b-3_2524-2854_2587.wav,3570,3402,168
12900,b-2_203-304_232.wav,VTTS_b-2_203-304_232.wav,4900,3959,941
12901,b-4_2000-5164_4178.wav,VTTS_b-4_2000-5164_4178.wav,3444,3379,65
12902,b-4_1901-2000_1968.wav,VTTS_b-4_1901-2000_1968.wav,7820,7233,587
12903,b-3_2524-2854_2669.wav,VTTS_b-3_2524-2854_2669.wav,5310,3936,1374
12904,b-1_2523-2623_2538.wav,VTTS_b-1_2523-2623_2538.wav,1260,1451,-191
12905,b-4_2000-5164_2229.wav,VTTS_b-4_2000-5164_2229.wav,4770,5074,-304
12906,b-4_501-1014_503.wav,VTTS_b-4_501-1014_503.wav,2630,2519,111
12907,b-3_5533-5638_5608.wav,VTTS_b-3_5533-5638_5608.wav,7390,8220,-830
12908,b-3_6016-6115_6086.wav,VTTS_b-3_6016-6115_6086.wav,3940,3448,492
12909,b-3_4607-5008_4858.wav,VTTS_b-3_4607-5008_4858.wav,2050,1916,134
12910,b-3_392-500_419.wav,VTTS_b-3_392-500_419.wav,7690,8231,-541
12911,b-1_377-477_385.wav,VTTS_b-1_377-477_385.wav,2000,1823,177
12912,b-3_4607-5008_4906.wav,VTTS_b-3_4607-5008_4906.wav,8620,7570,1050
12913,b-3_5009-5427_5246.wav,VTTS_b-3_5009-5427_5246.wav,2870,2937,-67
12914,b-4_2000-5164_4811.wav,VTTS_b-4_2000-5164_4811.wav,1880,1776,104
12915,b-3_6301-6400_6360.wav,VTTS_b-3_6301-6400_6360.wav,7070,7384,-314
12916,b-2_203-304_289.wav,VTTS_b-2_203-304_289.wav,2920,5735,-2815
12917,b-3_4207-4314_4308.wav,VTTS_b-3_4207-4314_4308.wav,5200,4992,208
12918,b-2_1801-1902_1881.wav,VTTS_b-2_1801-1902_1881.wav,3820,2519,1301
12919,b-2_1699-1800_1753.wav,VTTS_b-2_1699-1800_1753.wav,2920,2717,203
12920,b-4_2000-5164_2798.wav,VTTS_b-4_2000-5164_2798.wav,3735,4040,-305
12921,b-1_175-275_234.wav,VTTS_b-1_175-275_234.wav,2560,3228,-668
12922,b-3_501-930_600.wav,VTTS_b-3_501-930_600.wav,5570,4876,694
12923,b-1_2321-2421_2420.wav,VTTS_b-1_2321-2421_2420.wav,1540,1544,-4
12924,b-3_2524-2854_2612.wav,VTTS_b-3_2524-2854_2612.wav,3350,3448,-98
12925,b-1_1010-1110_1111.wav,VTTS_b-1_1010-1110_1111.wav,2910,2868,42
12926,b-1_1717-1817_1735.wav,VTTS_b-1_1717-1817_1735.wav,1050,1196,-146
12927,b-4_2000-5164_2392.wav,VTTS_b-4_2000-5164_2392.wav,3060,3239,-179
12928,b-3_501-930_614.wav,VTTS_b-3_501-930_614.wav,3250,3019,231
12929,b-2_713-814_748.wav,VTTS_b-2_713-814_748.wav,5310,5840,-530
12930,b-2_2311-2412_2341.wav,VTTS_b-2_2311-2412_2341.wav,1250,1010,240
12931,b-2_1121-1222_1168.wav,VTTS_b-2_1121-1222_1168.wav,2340,2647,-307
12932,b-2_1223-1324_1318.wav,VTTS_b-2_1223-1324_1318.wav,1260,1207,53
12933,b-1_1616-1716_1674.wav,VTTS_b-1_1616-1716_1674.wav,1850,1695,155
12934,b-3_2267-2349_2338.wav,VTTS_b-3_2267-2349_2338.wav,6840,7814,-974
12935,b-4_2000-5164_3239.wav,VTTS_b-4_2000-5164_3239.wav,1754,1637,117
12936,b-1_4322-4357_4324.wav,VTTS_b-1_4322-4357_4324.wav,2850,3320,-470
12937,b-1_2927-3025_2927.wav,VTTS_b-1_2927-3025_2927.wav,1750,1718,32
12938,b-3_6900-7016_6904.wav,VTTS_b-3_6900-7016_6904.wav,5500,5387,113
12939,b-4_1601-1706_1628.wav,VTTS_b-4_1601-1706_1628.wav,4460,4214,246
12940,b-3_2943-3024_2948.wav,VTTS_b-3_2943-3024_2948.wav,2620,2961,-341
12941,b-4_2000-5164_4658.wav,VTTS_b-4_2000-5164_4658.wav,7695,8812,-1117
12942,b-4_53-150_90.wav,VTTS_b-4_53-150_90.wav,6690,6200,490
12943,b-3_6401-6500_6461.wav,VTTS_b-3_6401-6500_6461.wav,4310,4122,188
12944,b-3_1862-1959_1926.wav,VTTS_b-3_1862-1959_1926.wav,5610,5120,490
12945,b-4_1401-1505_1487.wav,VTTS_b-4_1401-1505_1487.wav,7670,6920,750
12946,b-1_794-1009_826.wav,VTTS_b-1_794-1009_826.wav,3510,3947,-437
12947,b-3_4498-4605_4529.wav,VTTS_b-3_4498-4605_4529.wav,3450,3448,2
12948,b-3_501-930_742.wav,VTTS_b-3_501-930_742.wav,3890,3924,-34
12949,b-3_501-930_516.wav,VTTS_b-3_501-930_516.wav,4080,3866,214
12950,b-1_3127-3227_3129.wav,VTTS_b-1_3127-3227_3129.wav,3040,3181,-141
12951,b-3_3538-3627_3561.wav,VTTS_b-3_3538-3627_3561.wav,2390,2589,-199
12952,b-3_6401-6500_6406.wav,VTTS_b-3_6401-6500_6406.wav,5340,5027,313
12953,b-2_1699-1800_1793.wav,VTTS_b-2_1699-1800_1793.wav,1440,1416,24
12954,b-3_6217-6274_6220.wav,VTTS_b-3_6217-6274_6220.wav,3000,2995,5
12955,b-4_1101-1220_1140.wav,VTTS_b-4_1101-1220_1140.wav,5230,5770,-540
12956,b-3_5428-5533_5429.wav,VTTS_b-3_5428-5533_5429.wav,2830,3251,-421
12957,b-4_2000-5164_4647.wav,VTTS_b-4_2000-5164_4647.wav,2406,2276,130
12958,b-4_501-1014_929.wav,VTTS_b-4_501-1014_929.wav,6690,5178,1512
12959,b-1_2018-2118_2063.wav,VTTS_b-1_2018-2118_2063.wav,1300,1265,35
12960,b-2_815-916_841.wav,VTTS_b-2_815-916_841.wav,6240,5619,621
12961,b-3_4207-4314_4313.wav,VTTS_b-3_4207-4314_4313.wav,7230,5735,1495
12962,b-3_3025-3111_3046.wav,VTTS_b-3_3025-3111_3046.wav,3930,3924,6
12963,b-2_1019-1120_1094.wav,VTTS_b-2_1019-1120_1094.wav,2070,1718,352
12964,b-3_3454-3537_3525.wav,VTTS_b-3_3454-3537_3525.wav,1600,1486,114
12965,b-3_931-979_974.wav,VTTS_b-3_931-979_974.wav,7780,8615,-835
12966,b-4_2000-5164_4868.wav,VTTS_b-4_2000-5164_4868.wav,4985,5016,-31
12967,b-1_3733-3833_3774.wav,VTTS_b-1_3733-3833_3774.wav,1760,1927,-167
12968,b-3_98-195_121.wav,VTTS_b-3_98-195_121.wav,3730,3634,96
12969,b-4_1814-1900_1861.wav,VTTS_b-4_1814-1900_1861.wav,8390,8905,-515
12970,b-1_3632-3732_3681.wav,VTTS_b-1_3632-3732_3681.wav,1620,1416,204
12971,b-4_2000-5164_2703.wav,VTTS_b-4_2000-5164_2703.wav,7600,6769,831
12972,b-3_1321-1568_1532.wav,VTTS_b-3_1321-1568_1532.wav,4470,3820,650
12973,b-4_401-500_487.wav,VTTS_b-4_401-500_487.wav,4950,4865,85
12974,b-3_2524-2854_2797.wav,VTTS_b-3_2524-2854_2797.wav,3480,3460,20
12975,b-3_6601-6700_6691.wav,VTTS_b-3_6601-6700_6691.wav,4290,4133,157
12976,b-4_2000-5164_3968.wav,VTTS_b-4_2000-5164_3968.wav,3457,3390,67
12977,b-3_5428-5533_5530.wav,VTTS_b-3_5428-5533_5530.wav,5210,5027,183
12978,b-1_1010-1110_1071.wav,VTTS_b-1_1010-1110_1071.wav,4340,3634,706
12979,b-1_1919-2017_1933.wav,VTTS_b-1_1919-2017_1933.wav,950,906,44
12980,b-2_2209-2310_2246.wav,VTTS_b-2_2209-2310_2246.wav,2860,2705,155
12981,b-3_2089-2176_2166.wav,VTTS_b-3_2089-2176_2166.wav,3040,3088,-48
12982,b-1_1414-1514_1475.wav,VTTS_b-1_1414-1514_1475.wav,4140,3913,227
12983,b-4_1101-1220_1139.wav,VTTS_b-4_1101-1220_1139.wav,7200,6606,594
12984,b-4_2000-5164_2480.wav,VTTS_b-4_2000-5164_2480.wav,5880,6734,-854
12985,b-2_1903-2038_1908.wav,VTTS_b-2_1903-2038_1908.wav,1380,1173,207
12986,b-4_2000-5164_2603.wav,VTTS_b-4_2000-5164_2603.wav,5645,8684,-3039
12987,b-4_2000-5164_2074.wav,VTTS_b-4_2000-5164_2074.wav,9320,8858,462
12988,b-4_1901-2000_1922.wav,VTTS_b-4_1901-2000_1922.wav,2610,2299,311
12989,b-3_3279-3363_3354.wav,VTTS_b-3_3279-3363_3354.wav,6260,6641,-381
12990,b-3_6801-6900_6816.wav,VTTS_b-3_6801-6900_6816.wav,5320,4656,664
12991,b-4_2000-5164_2732.wav,VTTS_b-4_2000-5164_2732.wav,4440,4586,-146
12992,b-3_294-391_381.wav,VTTS_b-3_294-391_381.wav,5310,5515,-205
12993,b-4_2000-5164_2277.wav,VTTS_b-4_2000-5164_2277.wav,5740,5863,-123
12994,b-2_1903-2038_1964.wav,VTTS_b-2_1903-2038_1964.wav,4080,3564,516
12995,b-4_501-1014_571.wav,VTTS_b-4_501-1014_571.wav,2730,2577,153
12996,b-3_2267-2349_2312.wav,VTTS_b-3_2267-2349_2312.wav,6170,6002,168
12997,b-1_1818-1918_1828.wav,VTTS_b-1_1818-1918_1828.wav,1030,1045,-15
12998,b-4_301-400_379.wav,VTTS_b-4_301-400_379.wav,2600,3007,-407
12999,b-3_5639-5744_5659.wav,VTTS_b-3_5639-5744_5659.wav,4060,4400,-340
13000,b-1_3834-3934_3905.wav,VTTS_b-1_3834-3934_3905.wav,2840,2392,448
13001,b-3_6016-6115_6087.wav,VTTS_b-3_6016-6115_6087.wav,4020,4272,-252
13002,b-3_1764-1861_1776.wav,VTTS_b-3_1764-1861_1776.wav,5160,4807,353
13003,b-4_2000-5164_4231.wav,VTTS_b-4_2000-5164_4231.wav,4400,4598,-198
13004,b-1_1919-2017_2009.wav,VTTS_b-1_1919-2017_2009.wav,3270,2368,902
13005,b-3_4001-4103_4032.wav,VTTS_b-3_4001-4103_4032.wav,5520,5921,-401
13006,b-3_1-97_31.wav,VTTS_b-3_1-97_31.wav,4450,4342,108
13007,b-3_5009-5427_5109.wav,VTTS_b-3_5009-5427_5109.wav,1840,1869,-29
13008,b-4_2000-5164_2884.wav,VTTS_b-4_2000-5164_2884.wav,2300,2937,-637
13009,b-1_3127-3227_3204.wav,VTTS_b-1_3127-3227_3204.wav,1630,1660,-30
13010,b-3_294-391_308.wav,VTTS_b-3_294-391_308.wav,4630,4226,404
13011,b-3_3715-3802_3793.wav,VTTS_b-3_3715-3802_3793.wav,6450,5666,784
13012,b-3_5853-5956_5948.wav,VTTS_b-3_5853-5956_5948.wav,2880,2949,-69
13013,b-3_2089-2176_2175.wav,VTTS_b-3_2089-2176_2175.wav,5860,5608,252
13014,b-4_2000-5164_3021.wav,VTTS_b-4_2000-5164_3021.wav,10304,10751,-447
13015,b-3_5009-5427_5213.wav,VTTS_b-3_5009-5427_5213.wav,5490,6258,-768
13016,b-3_1079-1320_1204.wav,VTTS_b-3_1079-1320_1204.wav,5710,5851,-141
13017,b-4_501-1014_823.wav,VTTS_b-4_501-1014_823.wav,2520,4098,-1578
13018,b-1_4214-4285_4281.wav,VTTS_b-1_4214-4285_4281.wav,4390,5283,-893
13019,b-4_1301-1400_1365.wav,VTTS_b-4_1301-1400_1365.wav,6320,5596,724
13020,b-4_2000-5164_4780.wav,VTTS_b-4_2000-5164_4780.wav,6829,7001,-172
13021,b-3_6401-6500_6476.wav,VTTS_b-3_6401-6500_6476.wav,5580,6327,-747
13022,b-3_4207-4314_4221.wav,VTTS_b-3_4207-4314_4221.wav,4560,4505,55
13023,b-3_1666-1763_1698.wav,VTTS_b-3_1666-1763_1698.wav,5790,5573,217
13024,b-1_2523-2623_2600.wav,VTTS_b-1_2523-2623_2600.wav,1760,1672,88
13025,b-4_2000-5164_4302.wav,VTTS_b-4_2000-5164_4302.wav,2112,2032,80
13026,b-3_980-1077_1068.wav,VTTS_b-3_980-1077_1068.wav,9100,8510,590
13027,b-4_1506-1600_1511.wav,VTTS_b-4_1506-1600_1511.wav,4520,3831,689
13028,b-1_2220-2320_2314.wav,VTTS_b-1_2220-2320_2314.wav,1550,1498,52
13029,b-3_2350-2433_2402.wav,VTTS_b-3_2350-2433_2402.wav,3450,3193,257
13030,b-3_6701-6800_6734.wav,VTTS_b-3_6701-6800_6734.wav,3310,3135,175
13031,b-2_1223-1324_1246.wav,VTTS_b-2_1223-1324_1246.wav,4790,4214,576
13032,b-3_6900-7016_6996.wav,VTTS_b-3_6900-7016_6996.wav,6710,6327,383
13033,b-4_2000-5164_4585.wav,VTTS_b-4_2000-5164_4585.wav,4495,4841,-346
13034,b-3_3198-3278_3250.wav,VTTS_b-3_3198-3278_3250.wav,6450,5515,935
13035,b-1_4322-4357_4329.wav,VTTS_b-1_4322-4357_4329.wav,2540,3704,-1164
13036,b-1_4214-4285_4261.wav,VTTS_b-1_4214-4285_4261.wav,3310,4470,-1160
13037,b-3_5639-5744_5668.wav,VTTS_b-3_5639-5744_5668.wav,6570,7094,-524
13038,b-3_6401-6500_6414.wav,VTTS_b-3_6401-6500_6414.wav,4580,4052,528
13039,b-4_2000-5164_4639.wav,VTTS_b-4_2000-5164_4639.wav,3100,3193,-93
13040,b-3_3889-4000_3936.wav,VTTS_b-3_3889-4000_3936.wav,5400,4946,454
13041,b-1_4070-4105_4084.wav,VTTS_b-1_4070-4105_4084.wav,2920,2995,-75
13042,b-3_5009-5427_5128.wav,VTTS_b-3_5009-5427_5128.wav,8470,9369,-899
13043,b-3_3889-4000_3952.wav,VTTS_b-3_3889-4000_3952.wav,5360,5248,112
13044,b-1_4142-4177_4144.wav,VTTS_b-1_4142-4177_4144.wav,1090,1057,33
13045,b-4_2000-5164_5133.wav,VTTS_b-4_2000-5164_5133.wav,4304,3889,415
13046,b-1_4106-4141_4139.wav,VTTS_b-1_4106-4141_4139.wav,1140,1080,60
13047,b-4_2000-5164_2830.wav,VTTS_b-4_2000-5164_2830.wav,3680,4145,-465
13048,b-3_4607-5008_4732.wav,VTTS_b-3_4607-5008_4732.wav,4280,4389,-109
13049,b-1_74-174_114.wav,VTTS_b-1_74-174_114.wav,1030,1080,-50
13050,b-3_5533-5638_5574.wav,VTTS_b-3_5533-5638_5574.wav,5060,5294,-234
13051,b-3_2000-2088_2079.wav,VTTS_b-3_2000-2088_2079.wav,5990,7094,-1104
13052,b-2_1801-1902_1815.wav,VTTS_b-2_1801-1902_1815.wav,4110,3448,662
13053,b-4_2000-5164_3165.wav,VTTS_b-4_2000-5164_3165.wav,5482,5666,-184
13054,b-1_3127-3227_3154.wav,VTTS_b-1_3127-3227_3154.wav,1270,1184,86
13055,b-3_5639-5744_5715.wav,VTTS_b-3_5639-5744_5715.wav,3360,3204,156
13056,b-1_3127-3227_3193.wav,VTTS_b-1_3127-3227_3193.wav,2870,2485,385
13057,b-3_3889-4000_3893.wav,VTTS_b-3_3889-4000_3893.wav,9960,11610,-1650
13058,b-4_2000-5164_4652.wav,VTTS_b-4_2000-5164_4652.wav,5479,6687,-1208
13059,b-1_2422-2522_2448.wav,VTTS_b-1_2422-2522_2448.wav,1040,940,100
13060,b-3_2350-2433_2426.wav,VTTS_b-3_2350-2433_2426.wav,4320,4528,-208
13061,b-2_917-1018_942.wav,VTTS_b-2_917-1018_942.wav,1920,3738,-1818
13062,b-3_6274-6300_6286.wav,VTTS_b-3_6274-6300_6286.wav,4620,4818,-198
13063,b-4_2000-5164_4983.wav,VTTS_b-4_2000-5164_4983.wav,3600,4040,-440
13064,b-3_294-391_368.wav,VTTS_b-3_294-391_368.wav,4410,11610,-7200
13065,b-3_3025-3111_3047.wav,VTTS_b-3_3025-3111_3047.wav,8690,7663,1027
13066,b-2_1903-2038_1973.wav,VTTS_b-2_1903-2038_1973.wav,1970,2020,-50
13067,b-3_4607-5008_4775.wav,VTTS_b-3_4607-5008_4775.wav,3800,3738,62
13068,b-3_501-930_530.wav,VTTS_b-3_501-930_530.wav,6280,6432,-152
13069,b-1_276-376_289.wav,VTTS_b-1_276-376_289.wav,1690,1974,-284
13070,b-4_1401-1505_1407.wav,VTTS_b-4_1401-1505_1407.wav,7280,7152,128
13071,b-4_2000-5164_2011.wav,VTTS_b-4_2000-5164_2011.wav,2093,2392,-299
13072,b-3_6217-6274_6232.wav,VTTS_b-3_6217-6274_6232.wav,3330,3483,-153
13073,b-1_3026-3126_3113.wav,VTTS_b-1_3026-3126_3113.wav,2330,1985,345
13074,b-3_2177-2266_2233.wav,VTTS_b-3_2177-2266_2233.wav,3620,3460,160
13075,b-3_4607-5008_4809.wav,VTTS_b-3_4607-5008_4809.wav,1540,1602,-62
13076,b-1_1414-1514_1495.wav,VTTS_b-1_1414-1514_1495.wav,5590,6420,-830
13077,b-3_3715-3802_3795.wav,VTTS_b-3_3715-3802_3795.wav,9190,8870,320
13078,b-1_794-1009_834.wav,VTTS_b-1_794-1009_834.wav,1120,2159,-1039
13079,b-1_3228-3328_3301.wav,VTTS_b-1_3228-3328_3301.wav,2700,2775,-75
13080,b-4_2000-5164_2430.wav,VTTS_b-4_2000-5164_2430.wav,10030,11610,-1580
13081,b-1_1212-1312_1230.wav,VTTS_b-1_1212-1312_1230.wav,6290,6327,-37
13082,b-3_2000-2088_2004.wav,VTTS_b-3_2000-2088_2004.wav,5170,4679,491
13083,b-3_5745-5852_5778.wav,VTTS_b-3_5745-5852_5778.wav,4110,7976,-3866
13084,b-3_6217-6274_6248.wav,VTTS_b-3_6217-6274_6248.wav,2360,2241,119
13085,b-4_151-300_298.wav,VTTS_b-4_151-300_298.wav,4740,4934,-194
13086,b-4_2000-5164_4090.wav,VTTS_b-4_2000-5164_4090.wav,4818,5132,-314
13087,b-4_1221-1300_1226.wav,VTTS_b-4_1221-1300_1226.wav,2860,3077,-217
13088,b-4_2000-5164_2328.wav,VTTS_b-4_2000-5164_2328.wav,3710,4458,-748
13089,b-2_407-508_453.wav,VTTS_b-2_407-508_453.wav,3460,4168,-708
13090,b-2_1121-1222_1183.wav,VTTS_b-2_1121-1222_1183.wav,2400,2194,206
13091,b-1_3127-3227_3145.wav,VTTS_b-1_3127-3227_3145.wav,4730,4493,237
13092,b-3_1079-1320_1238.wav,VTTS_b-3_1079-1320_1238.wav,3330,3355,-25
13093,b-3_2089-2176_2111.wav,VTTS_b-3_2089-2176_2111.wav,6060,5840,220
13094,b-1_175-275_189.wav,VTTS_b-1_175-275_189.wav,2430,2543,-113
13095,b-1_2321-2421_2414.wav,VTTS_b-1_2321-2421_2414.wav,2380,2392,-12
13096,b-4_2000-5164_2253.wav,VTTS_b-4_2000-5164_2253.wav,2610,2531,79
13097,b-3_5745-5852_5796.wav,VTTS_b-3_5745-5852_5796.wav,3670,3541,129
13098,b-3_4104-4206_4172.wav,VTTS_b-3_4104-4206_4172.wav,3400,3529,-129
13099,b-4_1401-1505_1495.wav,VTTS_b-4_1401-1505_1495.wav,2870,2612,258
13100,b-3_1321-1568_1470.wav,VTTS_b-3_1321-1568_1470.wav,4600,5468,-868
13101,b-2_2413-2500_2477.wav,VTTS_b-2_2413-2500_2477.wav,2220,2206,14
13102,b-3_1079-1320_1119.wav,VTTS_b-3_1079-1320_1119.wav,5530,5259,271
13103,b-3_501-930_578.wav,VTTS_b-3_501-930_578.wav,5710,5341,369
13104,b-4_2000-5164_2995.wav,VTTS_b-4_2000-5164_2995.wav,4299,4702,-403
13105,b-1_276-376_327.wav,VTTS_b-1_276-376_327.wav,1840,1707,133
13106,b-4_2000-5164_2049.wav,VTTS_b-4_2000-5164_2049.wav,6655,7361,-706
13107,b-1_3127-3227_3163.wav,VTTS_b-1_3127-3227_3163.wav,4810,4354,456
13108,b-4_2000-5164_3405.wav,VTTS_b-4_2000-5164_3405.wav,8448,10391,-1943
13109,b-3_4607-5008_4826.wav,VTTS_b-3_4607-5008_4826.wav,3090,3355,-265
13110,b-1_2321-2421_2369.wav,VTTS_b-1_2321-2421_2369.wav,1630,1649,-19
13111,b-2_713-814_744.wav,VTTS_b-2_713-814_744.wav,2630,2473,157
13112,b-3_2524-2854_2714.wav,VTTS_b-3_2524-2854_2714.wav,4790,4865,-75
13113,b-4_2000-5164_2408.wav,VTTS_b-4_2000-5164_2408.wav,3225,3379,-154
13114,b-1_4070-4105_4077.wav,VTTS_b-1_4070-4105_4077.wav,3190,3541,-351
13115,b-1_4466-4498_4479.wav,VTTS_b-1_4466-4498_4479.wav,3970,4075,-105
13116,b-3_2434-2523_2470.wav,VTTS_b-3_2434-2523_2470.wav,3510,3379,131
13117,b-3_1321-1568_1388.wav,VTTS_b-3_1321-1568_1388.wav,10460,11355,-895
13118,b-2_1019-1120_1047.wav,VTTS_b-2_1019-1120_1047.wav,1210,1207,3
13119,b-4_1221-1300_1277.wav,VTTS_b-4_1221-1300_1277.wav,2440,2450,-10
13120,b-4_501-1014_512.wav,VTTS_b-4_501-1014_512.wav,4700,4505,195
13121,b-4_2000-5164_2151.wav,VTTS_b-4_2000-5164_2151.wav,8370,8545,-175
13122,b-2_1223-1324_1307.wav,VTTS_b-2_1223-1324_1307.wav,2640,2183,457
13123,b-4_501-1014_523.wav,VTTS_b-4_501-1014_523.wav,1200,871,329
13124,b-3_6801-6900_6871.wav,VTTS_b-3_6801-6900_6871.wav,3720,3924,-204
13125,b-3_3628-3714_3657.wav,VTTS_b-3_3628-3714_3657.wav,5680,6374,-694
13126,b-3_1079-1320_1311.wav,VTTS_b-3_1079-1320_1311.wav,4280,4029,251
13127,b-3_3025-3111_3091.wav,VTTS_b-3_3025-3111_3091.wav,5240,5677,-437
13128,b-2_203-304_286.wav,VTTS_b-2_203-304_286.wav,4280,5387,-1107
13129,b-1_2927-3025_3005.wav,VTTS_b-1_2927-3025_3005.wav,2630,2612,18
13130,b-4_2000-5164_4462.wav,VTTS_b-4_2000-5164_4462.wav,4881,4551,330
13131,b-2_1597-1698_1692.wav,VTTS_b-2_1597-1698_1692.wav,2530,2659,-129
13132,b-1_74-174_117.wav,VTTS_b-1_74-174_117.wav,1990,2159,-169
13133,b-2_1903-2038_1979.wav,VTTS_b-2_1903-2038_1979.wav,2300,2299,1
13134,b-2_2311-2412_2382.wav,VTTS_b-2_2311-2412_2382.wav,2190,2264,-74
13135,b-3_6217-6274_6254.wav,VTTS_b-3_6217-6274_6254.wav,6090,6118,-28
13136,b-2_1325-1426_1340.wav,VTTS_b-2_1325-1426_1340.wav,8040,7221,819
13137,b-4_1401-1505_1423.wav,VTTS_b-4_1401-1505_1423.wav,3140,3413,-273
13138,b-4_1901-2000_1986.wav,VTTS_b-4_1901-2000_1986.wav,4260,4632,-372
13139,b-3_3628-3714_3684.wav,VTTS_b-3_3628-3714_3684.wav,3730,5039,-1309
13140,b-2_2073-2106_2106.wav,VTTS_b-2_2073-2106_2106.wav,2980,4156,-1176
13141,b-4_2000-5164_4108.wav,VTTS_b-4_2000-5164_4108.wav,4233,4249,-16
13142,b-2_1121-1222_1124.wav,VTTS_b-2_1121-1222_1124.wav,1020,1788,-768
13143,b-3_5009-5427_5350.wav,VTTS_b-3_5009-5427_5350.wav,5240,5016,224
13144,b-4_2000-5164_2068.wav,VTTS_b-4_2000-5164_2068.wav,8345,7814,531
13145,b-4_2000-5164_5000.wav,VTTS_b-4_2000-5164_5000.wav,9660,9242,418
13146,b-4_2000-5164_2790.wav,VTTS_b-4_2000-5164_2790.wav,3350,3390,-40
13147,b-3_6601-6700_6665.wav,VTTS_b-3_6601-6700_6665.wav,4140,3576,564
13148,b-3_5009-5427_5424.wav,VTTS_b-3_5009-5427_5424.wav,6400,5886,514
13149,b-3_4425-4497_4488.wav,VTTS_b-3_4425-4497_4488.wav,3040,2717,323
13150,b-1_3026-3126_3042.wav,VTTS_b-1_3026-3126_3042.wav,1930,1881,49
13151,b-2_1903-2038_2030.wav,VTTS_b-2_1903-2038_2030.wav,2560,2612,-52
13152,b-4_501-1014_945.wav,VTTS_b-4_501-1014_945.wav,4830,4493,337
13153,b-4_2000-5164_2763.wav,VTTS_b-4_2000-5164_2763.wav,4500,4319,181
13154,b-3_1568-1665_1662.wav,VTTS_b-3_1568-1665_1662.wav,4320,4807,-487
13155,b-3_3889-4000_3891.wav,VTTS_b-3_3889-4000_3891.wav,7910,9056,-1146
13156,b-2_1121-1222_1198.wav,VTTS_b-2_1121-1222_1198.wav,1530,1625,-95
13157,b-4_2000-5164_2843.wav,VTTS_b-4_2000-5164_2843.wav,5720,6536,-816
13158,b-2_1903-2038_1954.wav,VTTS_b-2_1903-2038_1954.wav,1730,2345,-615
13159,b-3_6900-7016_6976.wav,VTTS_b-3_6900-7016_6976.wav,8800,8162,638
13160,b-2_2073-2106_2098.wav,VTTS_b-2_2073-2106_2098.wav,1680,1567,113
13161,b-1_2321-2421_2354.wav,VTTS_b-1_2321-2421_2354.wav,1800,1614,186
13162,b-4_1707-1813_1734.wav,VTTS_b-4_1707-1813_1734.wav,1240,1312,-72
13163,b-2_1121-1222_1149.wav,VTTS_b-2_1121-1222_1149.wav,3790,3483,307
13164,b-4_1401-1505_1464.wav,VTTS_b-4_1401-1505_1464.wav,8230,7732,498
13165,b-3_501-930_793.wav,VTTS_b-3_501-930_793.wav,3430,2879,551
13166,b-4_2000-5164_2029.wav,VTTS_b-4_2000-5164_2029.wav,1580,1474,106
13167,b-1_1616-1716_1642.wav,VTTS_b-1_1616-1716_1642.wav,1630,1533,97
13168,b-3_1321-1568_1438.wav,VTTS_b-3_1321-1568_1438.wav,5510,5561,-51
13169,b-1_3935-4033_3963.wav,VTTS_b-1_3935-4033_3963.wav,2700,2833,-133
13170,b-4_2000-5164_2808.wav,VTTS_b-4_2000-5164_2808.wav,5560,5085,475
13171,b-4_2000-5164_4026.wav,VTTS_b-4_2000-5164_4026.wav,8345,9810,-1465
13172,b-3_501-930_669.wav,VTTS_b-3_501-930_669.wav,2280,2577,-297
13173,b-3_931-979_940.wav,VTTS_b-3_931-979_940.wav,2830,2659,171
13174,b-4_2000-5164_2508.wav,VTTS_b-4_2000-5164_2508.wav,5540,5457,83
13175,b-4_2000-5164_3520.wav,VTTS_b-4_2000-5164_3520.wav,3389,3866,-477
13176,b-3_294-391_294.wav,VTTS_b-3_294-391_294.wav,2340,2357,-17
13177,b-3_4498-4605_4516.wav,VTTS_b-3_4498-4605_4516.wav,3830,3855,-25
13178,b-2_509-610_606.wav,VTTS_b-2_509-610_606.wav,2530,2577,-47
13179,b-3_1960-2000_1968.wav,VTTS_b-3_1960-2000_1968.wav,3430,3518,-88
13180,b-1_2523-2623_2619.wav,VTTS_b-1_2523-2623_2619.wav,1770,1776,-6
13181,b-3_1666-1763_1743.wav,VTTS_b-3_1666-1763_1743.wav,5110,5027,83
13182,b-1_3531-3631_3554.wav,VTTS_b-1_3531-3631_3554.wav,1930,1823,107
13183,b-1_2725-2825_2786.wav,VTTS_b-1_2725-2825_2786.wav,2680,3228,-548
13184,b-1_3733-3833_3765.wav,VTTS_b-1_3733-3833_3765.wav,1710,1730,-20
13185,b-3_2524-2854_2729.wav,VTTS_b-3_2524-2854_2729.wav,9620,11610,-1990
13186,b-2_2209-2310_2280.wav,VTTS_b-2_2209-2310_2280.wav,1540,2856,-1316
13187,b-4_1014-1100_1072.wav,VTTS_b-4_1014-1100_1072.wav,7860,7152,708
13188,b-1_377-477_389.wav,VTTS_b-1_377-477_389.wav,2160,1811,349
13189,b-3_5533-5638_5585.wav,VTTS_b-3_5533-5638_5585.wav,4300,3506,794
13190,b-2_305-406_405.wav,VTTS_b-2_305-406_405.wav,3250,2833,417
13191,b-1_2220-2320_2311.wav,VTTS_b-1_2220-2320_2311.wav,2030,2009,21
13192,b-2_1597-1698_1679.wav,VTTS_b-2_1597-1698_1679.wav,1850,2194,-344
13193,b-4_2000-5164_3052.wav,VTTS_b-4_2000-5164_3052.wav,1804,1614,190
13194,b-3_1666-1763_1706.wav,VTTS_b-3_1666-1763_1706.wav,5200,4180,1020
13195,b-2_1801-1902_1853.wav,VTTS_b-2_1801-1902_1853.wav,1040,964,76
13196,b-3_196-293_246.wav,VTTS_b-3_196-293_246.wav,4300,3855,445
13197,b-2_1-100_1.wav,VTTS_b-2_1-100_1.wav,3900,3971,-71
13198,b-3_6401-6500_6458.wav,VTTS_b-3_6401-6500_6458.wav,7130,7279,-149
13199,b-4_2000-5164_3593.wav,VTTS_b-4_2000-5164_3593.wav,2563,2682,-119
13200,b-1_3632-3732_3712.wav,VTTS_b-1_3632-3732_3712.wav,2010,1800,210
13201,b-3_4498-4605_4542.wav,VTTS_b-3_4498-4605_4542.wav,2620,2972,-352
13202,b-4_53-150_79.wav,VTTS_b-4_53-150_79.wav,7220,6861,359
13203,b-3_5009-5427_5353.wav,VTTS_b-3_5009-5427_5353.wav,5960,6269,-309
13204,b-1_3733-3833_3820.wav,VTTS_b-1_3733-3833_3820.wav,1820,1614,206
13205,b-4_2000-5164_5040.wav,VTTS_b-4_2000-5164_5040.wav,4349,3959,390
13206,b-3_3628-3714_3702.wav,VTTS_b-3_3628-3714_3702.wav,5190,4830,360
13207,b-1_2523-2623_2565.wav,VTTS_b-1_2523-2623_2565.wav,4240,4226,14
13208,b-4_2000-5164_4322.wav,VTTS_b-4_2000-5164_4322.wav,7835,8197,-362
13209,b-3_6900-7016_6953.wav,VTTS_b-3_6900-7016_6953.wav,2890,2554,336
13210,b-4_1014-1100_1031.wav,VTTS_b-4_1014-1100_1031.wav,2500,2218,282
13211,b-1_1414-1514_1503.wav,VTTS_b-1_1414-1514_1503.wav,2540,2694,-154
13212,b-4_2000-5164_3755.wav,VTTS_b-4_2000-5164_3755.wav,3910,3738,172
13213,b-4_2000-5164_4938.wav,VTTS_b-4_2000-5164_4938.wav,3280,3170,110
13214,b-3_5745-5852_5846.wav,VTTS_b-3_5745-5852_5846.wav,5170,5155,15
13215,b-1_2422-2522_2493.wav,VTTS_b-1_2422-2522_2493.wav,2050,1788,262
13216,b-4_2000-5164_2855.wav,VTTS_b-4_2000-5164_2855.wav,7530,7535,-5
13217,b-3_5009-5427_5079.wav,VTTS_b-3_5009-5427_5079.wav,5950,5526,424
13218,b-4_501-1014_930.wav,VTTS_b-4_501-1014_930.wav,3780,3808,-28
13219,b-2_1801-1902_1879.wav,VTTS_b-2_1801-1902_1879.wav,1540,1591,-51
13220,b-2_1223-1324_1271.wav,VTTS_b-2_1223-1324_1271.wav,4150,3866,284
13221,b-1_3834-3934_3877.wav,VTTS_b-1_3834-3934_3877.wav,4880,5074,-194
13222,b-3_1568-1665_1655.wav,VTTS_b-3_1568-1665_1655.wav,7820,9567,-1747
13223,b-2_1121-1222_1175.wav,VTTS_b-2_1121-1222_1175.wav,750,731,19
13224,b-3_5745-5852_5827.wav,VTTS_b-3_5745-5852_5827.wav,3430,3158,272
13225,b-4_1506-1600_1592.wav,VTTS_b-4_1506-1600_1592.wav,5080,5132,-52
13226,b-3_501-930_596.wav,VTTS_b-3_501-930_596.wav,2860,2682,178
13227,b-4_2000-5164_2729.wav,VTTS_b-4_2000-5164_2729.wav,6220,6711,-491
13228,b-3_196-293_248.wav,VTTS_b-3_196-293_248.wav,4250,3913,337
13229,b-3_4607-5008_4847.wav,VTTS_b-3_4607-5008_4847.wav,7660,7535,125
13230,b-3_2434-2523_2435.wav,VTTS_b-3_2434-2523_2435.wav,6840,6629,211
13231,b-3_5009-5427_5215.wav,VTTS_b-3_5009-5427_5215.wav,4440,4389,51
13232,b-1_4286-4321_4292.wav,VTTS_b-1_4286-4321_4292.wav,3070,3878,-808
13233,b-2_2311-2412_2327.wav,VTTS_b-2_2311-2412_2327.wav,5180,4540,640
13234,b-4_1221-1300_1250.wav,VTTS_b-4_1221-1300_1250.wav,4430,4296,134
13235,b-1_4178-4213_4181.wav,VTTS_b-1_4178-4213_4181.wav,1720,1614,106
13236,b-3_392-500_406.wav,VTTS_b-3_392-500_406.wav,5100,4865,235
13237,b-1_2321-2421_2347.wav,VTTS_b-1_2321-2421_2347.wav,3920,3762,158
13238,b-2_1597-1698_1611.wav,VTTS_b-2_1597-1698_1611.wav,3270,2101,1169
13239,b-4_2000-5164_2693.wav,VTTS_b-4_2000-5164_2693.wav,3500,3541,-41
13240,b-1_794-1009_823.wav,VTTS_b-1_794-1009_823.wav,2570,2961,-391
13241,b-4_2000-5164_2137.wav,VTTS_b-4_2000-5164_2137.wav,6830,8359,-1529
13242,b-2_1325-1426_1358.wav,VTTS_b-2_1325-1426_1358.wav,2540,2264,276
13243,b-1_3329-3429_3336.wav,VTTS_b-1_3329-3429_3336.wav,3960,5085,-1125
13244,b-3_3112-3197_3185.wav,VTTS_b-3_3112-3197_3185.wav,5720,6072,-352
13245,b-4_1506-1600_1570.wav,VTTS_b-4_1506-1600_1570.wav,2240,2496,-256
13246,b-4_1301-1400_1358.wav,VTTS_b-4_1301-1400_1358.wav,6760,6966,-206
13247,b-1_1212-1312_1281.wav,VTTS_b-1_1212-1312_1281.wav,770,1881,-1111
13248,b-4_1901-2000_1919.wav,VTTS_b-4_1901-2000_1919.wav,3480,3170,310
13249,b-3_6116-6215_6156.wav,VTTS_b-3_6116-6215_6156.wav,7430,8487,-1057
13250,b-1_276-376_346.wav,VTTS_b-1_276-376_346.wav,1460,1625,-165
13251,b-4_2000-5164_4034.wav,VTTS_b-4_2000-5164_4034.wav,4900,4760,140
13252,b-3_3112-3197_3180.wav,VTTS_b-3_3112-3197_3180.wav,4510,4389,121
13253,b-4_2000-5164_2115.wav,VTTS_b-4_2000-5164_2115.wav,1920,1974,-54
13254,b-3_4607-5008_4782.wav,VTTS_b-3_4607-5008_4782.wav,2610,2554,56
13255,b-4_2000-5164_2231.wav,VTTS_b-4_2000-5164_2231.wav,4450,4841,-391
13256,b-1_3127-3227_3166.wav,VTTS_b-1_3127-3227_3166.wav,5170,4667,503
13257,b-2_713-814_724.wav,VTTS_b-2_713-814_724.wav,5440,5224,216
13258,b-4_2000-5164_2150.wav,VTTS_b-4_2000-5164_2150.wav,3455,3506,-51
13259,b-4_1707-1813_1743.wav,VTTS_b-4_1707-1813_1743.wav,6260,7674,-1414
13260,b-3_3803-3888_3829.wav,VTTS_b-3_3803-3888_3829.wav,3910,3820,90
13261,b-4_2000-5164_2550.wav,VTTS_b-4_2000-5164_2550.wav,10320,9079,1241
13262,b-4_301-400_380.wav,VTTS_b-4_301-400_380.wav,1920,1904,16
13263,b-4_53-150_94.wav,VTTS_b-4_53-150_94.wav,7010,9404,-2394
13264,b-2_2107-2193_2135.wav,VTTS_b-2_2107-2193_2135.wav,2260,2287,-27
13265,b-1_2624-2724_2701.wav,VTTS_b-1_2624-2724_2701.wav,1880,1997,-117
13266,b-1_2220-2320_2263.wav,VTTS_b-1_2220-2320_2263.wav,2210,2101,109
13267,b-1_1818-1918_1909.wav,VTTS_b-1_1818-1918_1909.wav,3520,3239,281
13268,b-4_2000-5164_3952.wav,VTTS_b-4_2000-5164_3952.wav,4857,4354,503
13269,b-3_1764-1861_1859.wav,VTTS_b-3_1764-1861_1859.wav,8000,7163,837
13270,b-2_1903-2038_2016.wav,VTTS_b-2_1903-2038_2016.wav,2680,2252,428
13271,b-1_794-1009_828.wav,VTTS_b-1_794-1009_828.wav,4470,4923,-453
13272,b-3_6601-6700_6689.wav,VTTS_b-3_6601-6700_6689.wav,6320,5979,341
13273,b-3_5533-5638_5592.wav,VTTS_b-3_5533-5638_5592.wav,3500,10995,-7495
13274,b-2_509-610_511.wav,VTTS_b-2_509-610_511.wav,2140,2218,-78
13275,b-3_6501-6600_6572.wav,VTTS_b-3_6501-6600_6572.wav,5450,5213,237
13276,b-3_2524-2854_2726.wav,VTTS_b-3_2524-2854_2726.wav,5710,6583,-873
13277,b-3_3803-3888_3841.wav,VTTS_b-3_3803-3888_3841.wav,6260,11610,-5350
13278,b-3_3025-3111_3062.wav,VTTS_b-3_3025-3111_3062.wav,3550,3506,44
13279,b-3_2350-2433_2433.wav,VTTS_b-3_2350-2433_2433.wav,4710,6815,-2105
13280,b-3_4498-4605_4537.wav,VTTS_b-3_4498-4605_4537.wav,5380,5283,97
13281,b-4_1301-1400_1316.wav,VTTS_b-4_1301-1400_1316.wav,2860,3053,-193
13282,b-4_151-300_226.wav,VTTS_b-4_151-300_226.wav,6340,8905,-2565
13283,b-2_101-202_181.wav,VTTS_b-2_101-202_181.wav,2270,1858,412
13284,b-4_2000-5164_3644.wav,VTTS_b-4_2000-5164_3644.wav,1671,1521,150
13285,b-3_501-930_796.wav,VTTS_b-3_501-930_796.wav,6130,5317,813
13286,b-1_2725-2825_2750.wav,VTTS_b-1_2725-2825_2750.wav,1570,2090,-520
13287,b-2_1427-1562_1515.wav,VTTS_b-2_1427-1562_1515.wav,2720,1776,944
13288,b-1_1818-1918_1860.wav,VTTS_b-1_1818-1918_1860.wav,2990,2728,262
13289,b-1_1717-1817_1799.wav,VTTS_b-1_1717-1817_1799.wav,1720,1637,83
13290,b-3_1568-1665_1569.wav,VTTS_b-3_1568-1665_1569.wav,4450,4087,363
13291,b-2_2209-2310_2263.wav,VTTS_b-2_2209-2310_2263.wav,1550,1730,-180
13292,b-1_2523-2623_2611.wav,VTTS_b-1_2523-2623_2611.wav,2600,2438,162
13293,b-1_1616-1716_1659.wav,VTTS_b-1_1616-1716_1659.wav,1520,1405,115
13294,b-2_407-508_491.wav,VTTS_b-2_407-508_491.wav,2540,1962,578
13295,b-4_2000-5164_4710.wav,VTTS_b-4_2000-5164_4710.wav,3750,4017,-267
13296,b-4_2000-5164_3919.wav,VTTS_b-4_2000-5164_3919.wav,7559,7872,-313
13297,b-2_1223-1324_1238.wav,VTTS_b-2_1223-1324_1238.wav,6820,7964,-1144
13298,b-4_2000-5164_3340.wav,VTTS_b-4_2000-5164_3340.wav,5978,11610,-5632
13299,b-4_1101-1220_1122.wav,VTTS_b-4_1101-1220_1122.wav,3440,3088,352
13300,b-1_3228-3328_3311.wav,VTTS_b-1_3228-3328_3311.wav,1080,1033,47
13301,b-3_501-930_739.wav,VTTS_b-3_501-930_739.wav,6550,5782,768
13302,b-3_5009-5427_5191.wav,VTTS_b-3_5009-5427_5191.wav,9330,9114,216
13303,b-3_2434-2523_2520.wav,VTTS_b-3_2434-2523_2520.wav,3020,3007,13
13304,b-3_5533-5638_5626.wav,VTTS_b-3_5533-5638_5626.wav,4350,4191,159
13305,b-3_3889-4000_3898.wav,VTTS_b-3_3889-4000_3898.wav,7800,8661,-861
13306,b-4_2000-5164_3453.wav,VTTS_b-4_2000-5164_3453.wav,3097,2728,369
13307,b-4_1014-1100_1022.wav,VTTS_b-4_1014-1100_1022.wav,7280,6699,581
13308,b-1_579-649_615.wav,VTTS_b-1_579-649_615.wav,3890,4481,-591
13309,b-2_101-202_125.wav,VTTS_b-2_101-202_125.wav,2490,2426,64
13310,b-2_2413-2500_2498.wav,VTTS_b-2_2413-2500_2498.wav,6560,5480,1080
13311,b-3_6217-6274_6218.wav,VTTS_b-3_6217-6274_6218.wav,3050,3100,-50
13312,b-4_2000-5164_4916.wav,VTTS_b-4_2000-5164_4916.wav,2997,2821,176
13313,b-3_4315-4424_4346.wav,VTTS_b-3_4315-4424_4346.wav,6220,8150,-1930
13314,b-3_1568-1665_1580.wav,VTTS_b-3_1568-1665_1580.wav,6400,6072,328
13315,b-4_501-1014_885.wav,VTTS_b-4_501-1014_885.wav,6960,6548,412
13316,b-3_1960-2000_1960.wav,VTTS_b-3_1960-2000_1960.wav,3760,3506,254
13317,b-3_501-930_806.wav,VTTS_b-3_501-930_806.wav,3930,4957,-1027
13318,b-4_2000-5164_2913.wav,VTTS_b-4_2000-5164_2913.wav,10789,9892,897
13319,b-4_501-1014_778.wav,VTTS_b-4_501-1014_778.wav,5310,4830,480
13320,b-1_3935-4033_3977.wav,VTTS_b-1_3935-4033_3977.wav,1370,1474,-104
13321,b-3_5639-5744_5679.wav,VTTS_b-3_5639-5744_5679.wav,6010,6084,-74
13322,b-4_2000-5164_4831.wav,VTTS_b-4_2000-5164_4831.wav,3422,3367,55
13323,b-2_1699-1800_1791.wav,VTTS_b-2_1699-1800_1791.wav,1120,1068,52
13324,b-3_4207-4314_4208.wav,VTTS_b-3_4207-4314_4208.wav,4010,3692,318
13325,b-1_3632-3732_3685.wav,VTTS_b-1_3632-3732_3685.wav,2610,2368,242
13326,b-3_6701-6800_6702.wav,VTTS_b-3_6701-6800_6702.wav,3320,2647,673
13327,b-3_6701-6800_6746.wav,VTTS_b-3_6701-6800_6746.wav,3900,4029,-129
13328,b-4_2000-5164_3836.wav,VTTS_b-4_2000-5164_3836.wav,2448,2299,149
13329,b-1_1616-1716_1697.wav,VTTS_b-1_1616-1716_1697.wav,1310,1370,-60
13330,b-3_501-930_589.wav,VTTS_b-3_501-930_589.wav,7370,8162,-792
13331,b-4_2000-5164_2112.wav,VTTS_b-4_2000-5164_2112.wav,5200,5584,-384
13332,b-3_4498-4605_4523.wav,VTTS_b-3_4498-4605_4523.wav,5900,5828,72
13333,b-3_6900-7016_6910.wav,VTTS_b-3_6900-7016_6910.wav,4880,5132,-252
13334,b-3_1-97_25.wav,VTTS_b-3_1-97_25.wav,3500,3576,-76
13335,b-3_6801-6900_6814.wav,VTTS_b-3_6801-6900_6814.wav,4730,4644,86
13336,b-3_3538-3627_3624.wav,VTTS_b-3_3538-3627_3624.wav,3080,2984,96
13337,b-1_1919-2017_1940.wav,VTTS_b-1_1919-2017_1940.wav,910,824,86
13338,b-3_501-930_654.wav,VTTS_b-3_501-930_654.wav,5480,6281,-801
13339,b-3_4607-5008_4892.wav,VTTS_b-3_4607-5008_4892.wav,2830,3146,-316
13340,b-1_1818-1918_1908.wav,VTTS_b-1_1818-1918_1908.wav,1580,1509,71
13341,b-3_4498-4605_4524.wav,VTTS_b-3_4498-4605_4524.wav,2450,2566,-116
13342,b-3_3889-4000_3978.wav,VTTS_b-3_3889-4000_3978.wav,4130,4180,-50
13343,b-1_3329-3429_3340.wav,VTTS_b-1_3329-3429_3340.wav,4220,11610,-7390
13344,b-1_4322-4357_4351.wav,VTTS_b-1_4322-4357_4351.wav,1180,1347,-167
13345,b-4_1707-1813_1729.wav,VTTS_b-4_1707-1813_1729.wav,6830,6827,3
13346,b-3_2943-3024_2989.wav,VTTS_b-3_2943-3024_2989.wav,6110,11610,-5500
13347,b-1_3228-3328_3282.wav,VTTS_b-1_3228-3328_3282.wav,910,940,-30
13348,b-1_1818-1918_1832.wav,VTTS_b-1_1818-1918_1832.wav,1710,1521,189
13349,b-3_196-293_253.wav,VTTS_b-3_196-293_253.wav,3710,3901,-191
13350,b-3_5009-5427_5222.wav,VTTS_b-3_5009-5427_5222.wav,5670,5654,16
13351,b-3_5009-5427_5095.wav,VTTS_b-3_5009-5427_5095.wav,3040,2937,103
13352,b-3_6801-6900_6858.wav,VTTS_b-3_6801-6900_6858.wav,7430,7512,-82
13353,b-2_101-202_147.wav,VTTS_b-2_101-202_147.wav,1680,1823,-143
13354,b-4_1401-1505_1442.wav,VTTS_b-4_1401-1505_1442.wav,4080,3808,272
13355,b-3_5009-5427_5287.wav,VTTS_b-3_5009-5427_5287.wav,1620,1625,-5
13356,b-3_4498-4605_4499.wav,VTTS_b-3_4498-4605_4499.wav,4230,3878,352
13357,b-3_3803-3888_3818.wav,VTTS_b-3_3803-3888_3818.wav,3090,3413,-323
13358,b-3_6801-6900_6821.wav,VTTS_b-3_6801-6900_6821.wav,6140,6838,-698
13359,b-1_1818-1918_1896.wav,VTTS_b-1_1818-1918_1896.wav,3850,4400,-550
13360,b-3_3454-3537_3524.wav,VTTS_b-3_3454-3537_3524.wav,4740,4574,166
13361,b-4_2000-5164_2331.wav,VTTS_b-4_2000-5164_2331.wav,3655,3622,33
13362,b-2_1325-1426_1375.wav,VTTS_b-2_1325-1426_1375.wav,11010,10461,549
13363,b-4_2000-5164_3978.wav,VTTS_b-4_2000-5164_3978.wav,7952,6536,1416
13364,b-4_2000-5164_3316.wav,VTTS_b-4_2000-5164_3316.wav,1180,859,321
13365,b-4_2000-5164_3496.wav,VTTS_b-4_2000-5164_3496.wav,717,650,67
13366,b-1_377-477_395.wav,VTTS_b-1_377-477_395.wav,1360,1289,71
13367,b-1_2018-2118_2078.wav,VTTS_b-1_2018-2118_2078.wav,2410,2392,18
13368,b-3_6701-6800_6787.wav,VTTS_b-3_6701-6800_6787.wav,5120,4690,430
13369,b-2_2209-2310_2216.wav,VTTS_b-2_2209-2310_2216.wav,1890,2078,-188
13370,b-2_1121-1222_1195.wav,VTTS_b-2_1121-1222_1195.wav,2590,1544,1046
13371,b-3_5009-5427_5166.wav,VTTS_b-3_5009-5427_5166.wav,3680,4481,-801
13372,b-3_4607-5008_4716.wav,VTTS_b-3_4607-5008_4716.wav,3120,3448,-328
13373,b-1_3026-3126_3062.wav,VTTS_b-1_3026-3126_3062.wav,1620,2078,-458
13374,b-4_2000-5164_4057.wav,VTTS_b-4_2000-5164_4057.wav,3494,3216,278
13375,b-3_1862-1959_1932.wav,VTTS_b-3_1862-1959_1932.wav,5710,5422,288
13376,b-1_1515-1615_1603.wav,VTTS_b-1_1515-1615_1603.wav,1440,1474,-34
13377,b-3_1321-1568_1496.wav,VTTS_b-3_1321-1568_1496.wav,940,859,81
13378,b-3_2177-2266_2266.wav,VTTS_b-3_2177-2266_2266.wav,7150,6374,776
13379,b-2_1903-2038_1971.wav,VTTS_b-2_1903-2038_1971.wav,3850,2995,855
13380,b-4_151-300_235.wav,VTTS_b-4_151-300_235.wav,1880,7326,-5446
13381,b-3_4207-4314_4211.wav,VTTS_b-3_4207-4314_4211.wav,5580,5410,170
13382,b-3_501-930_725.wav,VTTS_b-3_501-930_725.wav,5760,4818,942
13383,b-1_2826-2926_2830.wav,VTTS_b-1_2826-2926_2830.wav,3710,4156,-446
13384,b-2_1325-1426_1355.wav,VTTS_b-2_1325-1426_1355.wav,3170,2694,476
13385,b-3_3198-3278_3232.wav,VTTS_b-3_3198-3278_3232.wav,9020,11517,-2497
13386,b-2_1801-1902_1866.wav,VTTS_b-2_1801-1902_1866.wav,1590,1753,-163
13387,b-1_1818-1918_1841.wav,VTTS_b-1_1818-1918_1841.wav,4690,4981,-291
13388,b-3_1-97_73.wav,VTTS_b-3_1-97_73.wav,1960,1950,10
13389,b-4_2000-5164_3383.wav,VTTS_b-4_2000-5164_3383.wav,1522,1428,94
13390,b-1_3632-3732_3664.wav,VTTS_b-1_3632-3732_3664.wav,2030,2194,-164
13391,b-4_2000-5164_2896.wav,VTTS_b-4_2000-5164_2896.wav,680,1138,-458
13392,b-1_4286-4321_4321.wav,VTTS_b-1_4286-4321_4321.wav,2420,2125,295
13393,b-4_53-150_83.wav,VTTS_b-4_53-150_83.wav,7150,7790,-640
13394,b-3_392-500_403.wav,VTTS_b-3_392-500_403.wav,10540,9485,1055
13395,b-3_1321-1568_1477.wav,VTTS_b-3_1321-1568_1477.wav,12010,11180,830
13396,b-2_1903-2038_1963.wav,VTTS_b-2_1903-2038_1963.wav,2490,2461,29
13397,b-3_1321-1568_1426.wav,VTTS_b-3_1321-1568_1426.wav,3260,2810,450
13398,b-3_3454-3537_3455.wav,VTTS_b-3_3454-3537_3455.wav,3280,3309,-29
13399,b-4_151-300_166.wav,VTTS_b-4_151-300_166.wav,8160,6943,1217
13400,b-4_501-1014_833.wav,VTTS_b-4_501-1014_833.wav,5400,6478,-1078
13401,b-3_4498-4605_4555.wav,VTTS_b-3_4498-4605_4555.wav,7860,6002,1858
13402,b-4_501-1014_600.wav,VTTS_b-4_501-1014_600.wav,2200,2032,168
13403,b-4_2000-5164_4819.wav,VTTS_b-4_2000-5164_4819.wav,6209,6130,79
13404,b-3_6900-7016_6938.wav,VTTS_b-3_6900-7016_6938.wav,3760,3843,-83
13405,b-1_1414-1514_1461.wav,VTTS_b-1_1414-1514_1461.wav,1020,1057,-37
13406,b-3_2524-2854_2626.wav,VTTS_b-3_2524-2854_2626.wav,7900,6954,946
13407,b-3_1321-1568_1464.wav,VTTS_b-3_1321-1568_1464.wav,3690,3228,462
13408,b-1_4070-4105_4105.wav,VTTS_b-1_4070-4105_4105.wav,4800,4574,226
13409,b-1_1616-1716_1629.wav,VTTS_b-1_1616-1716_1629.wav,3200,3007,193
13410,b-4_401-500_422.wav,VTTS_b-4_401-500_422.wav,4090,4017,73
13411,b-4_2000-5164_2248.wav,VTTS_b-4_2000-5164_2248.wav,3000,2705,295
13412,b-3_5957-6015_5969.wav,VTTS_b-3_5957-6015_5969.wav,6190,5666,524
13413,b-1_1919-2017_2012.wav,VTTS_b-1_1919-2017_2012.wav,2130,2148,-18
13414,b-3_2943-3024_2971.wav,VTTS_b-3_2943-3024_2971.wav,2360,2450,-90
13415,b-4_2000-5164_2222.wav,VTTS_b-4_2000-5164_2222.wav,4580,4226,354
13416,b-4_2000-5164_2350.wav,VTTS_b-4_2000-5164_2350.wav,4960,6327,-1367
13417,b-3_4498-4605_4591.wav,VTTS_b-3_4498-4605_4591.wav,5980,5944,36
13418,b-1_1818-1918_1917.wav,VTTS_b-1_1818-1918_1917.wav,3170,4075,-905
13419,b-1_579-649_620.wav,VTTS_b-1_579-649_620.wav,2990,2473,517
13420,b-3_980-1077_1003.wav,VTTS_b-3_980-1077_1003.wav,4360,3611,749
13421,b-2_1597-1698_1655.wav,VTTS_b-2_1597-1698_1655.wav,2890,2659,231
13422,b-1_3026-3126_3115.wav,VTTS_b-1_3026-3126_3115.wav,2050,2415,-365
13423,b-1_3329-3429_3378.wav,VTTS_b-1_3329-3429_3378.wav,3240,2821,419
13424,b-3_6801-6900_6861.wav,VTTS_b-3_6801-6900_6861.wav,4680,4992,-312
13425,b-3_501-930_753.wav,VTTS_b-3_501-930_753.wav,7130,6827,303
13426,b-2_2311-2412_2359.wav,VTTS_b-2_2311-2412_2359.wav,1200,1242,-42
13427,b-1_794-1009_992.wav,VTTS_b-1_794-1009_992.wav,2330,2438,-108
13428,b-3_501-930_929.wav,VTTS_b-3_501-930_929.wav,2960,2647,313
13429,b-2_1427-1562_1493.wav,VTTS_b-2_1427-1562_1493.wav,3120,4923,-1803
13430,b-3_2000-2088_2027.wav,VTTS_b-3_2000-2088_2027.wav,3030,2984,46
13431,b-3_2267-2349_2299.wav,VTTS_b-3_2267-2349_2299.wav,5890,5921,-31
13432,b-1_2220-2320_2257.wav,VTTS_b-1_2220-2320_2257.wav,1090,1161,-71
13433,b-3_1666-1763_1718.wav,VTTS_b-3_1666-1763_1718.wav,5010,4725,285
13434,b-1_377-477_456.wav,VTTS_b-1_377-477_456.wav,3420,3750,-330
13435,b-3_4607-5008_4758.wav,VTTS_b-3_4607-5008_4758.wav,6840,8069,-1229
13436,b-3_6601-6700_6650.wav,VTTS_b-3_6601-6700_6650.wav,3660,6455,-2795
13437,b-3_6016-6115_6058.wav,VTTS_b-3_6016-6115_6058.wav,3340,3286,54
13438,b-3_1321-1568_1390.wav,VTTS_b-3_1321-1568_1390.wav,6280,5909,371
13439,b-4_2000-5164_2535.wav,VTTS_b-4_2000-5164_2535.wav,7650,8081,-431
13440,b-4_501-1014_661.wav,VTTS_b-4_501-1014_661.wav,3790,3727,63
13441,b-3_501-930_794.wav,VTTS_b-3_501-930_794.wav,7240,7523,-283
13442,b-1_1818-1918_1818.wav,VTTS_b-1_1818-1918_1818.wav,2220,2972,-752
13443,b-3_1321-1568_1437.wav,VTTS_b-3_1321-1568_1437.wav,5300,5596,-296
13444,b-1_2422-2522_2430.wav,VTTS_b-1_2422-2522_2430.wav,1220,1126,94
13445,b-1_478-578_509.wav,VTTS_b-1_478-578_509.wav,3120,3773,-653
13446,b-3_501-930_699.wav,VTTS_b-3_501-930_699.wav,4650,4087,563
13447,b-2_815-916_907.wav,VTTS_b-2_815-916_907.wav,3930,3471,459
13448,b-2_2209-2310_2224.wav,VTTS_b-2_2209-2310_2224.wav,5910,5933,-23
13449,b-3_5428-5533_5504.wav,VTTS_b-3_5428-5533_5504.wav,7520,7918,-398
13450,b-3_5009-5427_5368.wav,VTTS_b-3_5009-5427_5368.wav,6550,6153,397
13451,b-3_6501-6600_6521.wav,VTTS_b-3_6501-6600_6521.wav,5580,5271,309
13452,b-4_1401-1505_1414.wav,VTTS_b-4_1401-1505_1414.wav,1740,1509,231
13453,b-3_4104-4206_4111.wav,VTTS_b-3_4104-4206_4111.wav,11370,11610,-240
13454,b-4_151-300_262.wav,VTTS_b-4_151-300_262.wav,5840,7419,-1579
13455,b-1_2725-2825_2755.wav,VTTS_b-1_2725-2825_2755.wav,3300,2926,374
13456,b-4_2000-5164_2045.wav,VTTS_b-4_2000-5164_2045.wav,8795,10716,-1921
13457,b-3_4104-4206_4190.wav,VTTS_b-3_4104-4206_4190.wav,3860,4156,-296
13458,b-2_2209-2310_2270.wav,VTTS_b-2_2209-2310_2270.wav,4150,4342,-192
13459,b-1_1313-1413_1325.wav,VTTS_b-1_1313-1413_1325.wav,2300,2426,-126
13460,b-3_2524-2854_2697.wav,VTTS_b-3_2524-2854_2697.wav,2790,2717,73
13461,b-2_2107-2193_2162.wav,VTTS_b-2_2107-2193_2162.wav,1820,1428,392
13462,b-3_2350-2433_2351.wav,VTTS_b-3_2350-2433_2351.wav,6690,11610,-4920
13463,b-1_3430-3530_3481.wav,VTTS_b-1_3430-3530_3481.wav,3510,4238,-728
13464,b-2_203-304_208.wav,VTTS_b-2_203-304_208.wav,2400,2322,78
13465,b-4_151-300_214.wav,VTTS_b-4_151-300_214.wav,830,824,6
13466,b-3_5009-5427_5265.wav,VTTS_b-3_5009-5427_5265.wav,1120,1173,-53
13467,b-3_98-195_148.wav,VTTS_b-3_98-195_148.wav,4450,11018,-6568
13468,b-3_392-500_410.wav,VTTS_b-3_392-500_410.wav,4660,5492,-832
13469,b-3_6016-6115_6054.wav,VTTS_b-3_6016-6115_6054.wav,5200,6467,-1267
13470,b-3_1321-1568_1379.wav,VTTS_b-3_1321-1568_1379.wav,4580,3924,656
13471,b-1_1414-1514_1417.wav,VTTS_b-1_1414-1514_1417.wav,2610,2426,184
13472,b-2_2107-2193_2117.wav,VTTS_b-2_2107-2193_2117.wav,1520,1428,92
13473,b-4_2000-5164_4918.wav,VTTS_b-4_2000-5164_4918.wav,2244,2252,-8
13474,b-1_3329-3429_3372.wav,VTTS_b-1_3329-3429_3372.wav,900,1300,-400
13475,b-4_2000-5164_3128.wav,VTTS_b-4_2000-5164_3128.wav,3161,3483,-322
13476,b-2_1121-1222_1213.wav,VTTS_b-2_1121-1222_1213.wav,3780,4505,-725
13477,b-3_5639-5744_5703.wav,VTTS_b-3_5639-5744_5703.wav,4550,4505,45
13478,b-1_3026-3126_3053.wav,VTTS_b-1_3026-3126_3053.wav,4780,5074,-294
13479,b-3_6016-6115_6057.wav,VTTS_b-3_6016-6115_6057.wav,3820,3657,163
13480,b-4_501-1014_651.wav,VTTS_b-4_501-1014_651.wav,4150,4203,-53
13481,b-2_509-610_604.wav,VTTS_b-2_509-610_604.wav,2440,4122,-1682
13482,b-4_1221-1300_1288.wav,VTTS_b-4_1221-1300_1288.wav,5130,4923,207
13483,b-1_276-376_308.wav,VTTS_b-1_276-376_308.wav,2000,1765,235
13484,b-4_2000-5164_4891.wav,VTTS_b-4_2000-5164_4891.wav,5736,6258,-522
13485,b-1_794-1009_900.wav,VTTS_b-1_794-1009_900.wav,2460,1962,498
13486,b-4_2000-5164_4290.wav,VTTS_b-4_2000-5164_4290.wav,1341,1184,157
13487,b-3_3364-3453_3399.wav,VTTS_b-3_3364-3453_3399.wav,5460,4621,839
13488,b-3_3628-3714_3695.wav,VTTS_b-3_3628-3714_3695.wav,7660,7256,404
13489,b-1_650-685_669.wav,VTTS_b-1_650-685_669.wav,6220,5283,937
13490,b-3_4001-4103_4046.wav,VTTS_b-3_4001-4103_4046.wav,5100,4992,108
13491,b-3_501-930_898.wav,VTTS_b-3_501-930_898.wav,3390,3529,-139
13492,b-3_294-391_332.wav,VTTS_b-3_294-391_332.wav,6550,6118,432
13493,b-4_2000-5164_2056.wav,VTTS_b-4_2000-5164_2056.wav,6175,6049,126
13494,b-4_2000-5164_4845.wav,VTTS_b-4_2000-5164_4845.wav,2864,2891,-27
13495,b-1_1616-1716_1616.wav,VTTS_b-1_1616-1716_1616.wav,4100,3634,466
13496,b-4_2000-5164_2738.wav,VTTS_b-4_2000-5164_2738.wav,3895,3634,261
13497,b-3_3628-3714_3667.wav,VTTS_b-3_3628-3714_3667.wav,2980,3007,-27
13498,b-3_392-500_482.wav,VTTS_b-3_392-500_482.wav,5110,4528,582
13499,b-4_2000-5164_3770.wav,VTTS_b-4_2000-5164_3770.wav,6600,6084,516
13500,b-3_2855-2942_2887.wav,VTTS_b-3_2855-2942_2887.wav,2660,2810,-150
13501,b-1_3127-3227_3207.wav,VTTS_b-1_3127-3227_3207.wav,2460,2473,-13
13502,b-4_151-300_168.wav,VTTS_b-4_151-300_168.wav,6940,6954,-14
13503,b-4_2000-5164_3582.wav,VTTS_b-4_2000-5164_3582.wav,3125,3030,95
13504,b-2_2311-2412_2345.wav,VTTS_b-2_2311-2412_2345.wav,3150,3019,131
13505,b-4_2000-5164_4349.wav,VTTS_b-4_2000-5164_4349.wav,5768,6235,-467
13506,b-3_98-195_162.wav,VTTS_b-3_98-195_162.wav,4340,4865,-525
13507,b-3_5639-5744_5714.wav,VTTS_b-3_5639-5744_5714.wav,7970,7651,319
13508,b-3_2434-2523_2521.wav,VTTS_b-3_2434-2523_2521.wav,3260,3518,-258
13509,b-2_101-202_107.wav,VTTS_b-2_101-202_107.wav,5990,7779,-1789
13510,b-4_501-1014_536.wav,VTTS_b-4_501-1014_536.wav,6700,5654,1046
13511,b-4_1707-1813_1745.wav,VTTS_b-4_1707-1813_1745.wav,6540,5700,840
13512,b-4_1101-1220_1144.wav,VTTS_b-4_1101-1220_1144.wav,5500,5178,322
13513,b-1_1313-1413_1335.wav,VTTS_b-1_1313-1413_1335.wav,2630,2577,53
13514,b-3_3454-3537_3534.wav,VTTS_b-3_3454-3537_3534.wav,4630,4818,-188
13515,b-3_1960-2000_1978.wav,VTTS_b-3_1960-2000_1978.wav,1630,1486,144
13516,b-3_3889-4000_3974.wav,VTTS_b-3_3889-4000_3974.wav,5190,4725,465
13517,b-4_401-500_421.wav,VTTS_b-4_401-500_421.wav,2590,2252,338
13518,b-3_4207-4314_4258.wav,VTTS_b-3_4207-4314_4258.wav,7510,8499,-989
13519,b-3_2434-2523_2439.wav,VTTS_b-3_2434-2523_2439.wav,4510,5108,-598
13520,b-4_2000-5164_2554.wav,VTTS_b-4_2000-5164_2554.wav,6105,6502,-397
13521,b-4_2000-5164_4544.wav,VTTS_b-4_2000-5164_4544.wav,3935,3692,243
13522,b-1_4466-4498_4489.wav,VTTS_b-1_4466-4498_4489.wav,2820,3437,-617
13523,b-2_2311-2412_2403.wav,VTTS_b-2_2311-2412_2403.wav,4110,3889,221
13524,b-3_4607-5008_5004.wav,VTTS_b-3_4607-5008_5004.wav,1310,1591,-281
13525,b-3_6217-6274_6236.wav,VTTS_b-3_6217-6274_6236.wav,3960,4180,-220
13526,b-3_4001-4103_4071.wav,VTTS_b-3_4001-4103_4071.wav,3530,3971,-441
13527,b-2_815-916_886.wav,VTTS_b-2_815-916_886.wav,3040,2844,196
13528,b-1_2321-2421_2389.wav,VTTS_b-1_2321-2421_2389.wav,3860,3773,87
13529,b-3_5009-5427_5106.wav,VTTS_b-3_5009-5427_5106.wav,4490,4319,171
13530,b-4_2000-5164_4133.wav,VTTS_b-4_2000-5164_4133.wav,3838,3785,53
13531,b-2_2107-2193_2131.wav,VTTS_b-2_2107-2193_2131.wav,1160,1289,-129
13532,b-1_3228-3328_3295.wav,VTTS_b-1_3228-3328_3295.wav,1780,1730,50
13533,b-1_276-376_279.wav,VTTS_b-1_276-376_279.wav,1590,1695,-105
13534,b-2_917-1018_924.wav,VTTS_b-2_917-1018_924.wav,1680,1660,20
13535,b-3_980-1077_1049.wav,VTTS_b-3_980-1077_1049.wav,6060,5677,383
13536,b-3_3198-3278_3218.wav,VTTS_b-3_3198-3278_3218.wav,2600,2577,23
13537,b-3_501-930_863.wav,VTTS_b-3_501-930_863.wav,6420,7814,-1394
13538,b-2_1019-1120_1029.wav,VTTS_b-2_1019-1120_1029.wav,5500,9578,-4078
13539,b-3_5009-5427_5064.wav,VTTS_b-3_5009-5427_5064.wav,2840,3216,-376
13540,b-4_2000-5164_2239.wav,VTTS_b-4_2000-5164_2239.wav,3040,3297,-257
13541,b-2_2107-2193_2168.wav,VTTS_b-2_2107-2193_2168.wav,3590,2798,792
13542,b-1_4178-4213_4197.wav,VTTS_b-1_4178-4213_4197.wav,2180,2194,-14
13543,b-3_5957-6015_5991.wav,VTTS_b-3_5957-6015_5991.wav,5110,5178,-68
13544,b-4_2000-5164_3313.wav,VTTS_b-4_2000-5164_3313.wav,4213,5538,-1325
13545,b-3_5533-5638_5635.wav,VTTS_b-3_5533-5638_5635.wav,6210,6873,-663
13546,b-1_1717-1817_1756.wav,VTTS_b-1_1717-1817_1756.wav,2310,2345,-35
13547,b-3_4607-5008_4859.wav,VTTS_b-3_4607-5008_4859.wav,3510,3599,-89
13548,b-3_5853-5956_5874.wav,VTTS_b-3_5853-5956_5874.wav,5700,5283,417
13549,b-1_2523-2623_2562.wav,VTTS_b-1_2523-2623_2562.wav,2640,2694,-54
13550,b-4_2000-5164_3281.wav,VTTS_b-4_2000-5164_3281.wav,6121,6351,-230
13551,b-1_794-1009_995.wav,VTTS_b-1_794-1009_995.wav,1990,1892,98
13552,b-1_3935-4033_3973.wav,VTTS_b-1_3935-4033_3973.wav,4140,3785,355
13553,b-1_3733-3833_3755.wav,VTTS_b-1_3733-3833_3755.wav,2240,2519,-279
13554,b-2_305-406_313.wav,VTTS_b-2_305-406_313.wav,3430,3622,-192
13555,b-3_4498-4605_4527.wav,VTTS_b-3_4498-4605_4527.wav,4980,6780,-1800
13556,b-1_2018-2118_2054.wav,VTTS_b-1_2018-2118_2054.wav,3230,3576,-346
13557,b-3_6401-6500_6464.wav,VTTS_b-3_6401-6500_6464.wav,2170,2148,22
13558,b-4_1601-1706_1662.wav,VTTS_b-4_1601-1706_1662.wav,4020,3831,189
13559,b-4_1601-1706_1618.wav,VTTS_b-4_1601-1706_1618.wav,4010,4807,-797
13560,b-4_2000-5164_2513.wav,VTTS_b-4_2000-5164_2513.wav,1710,1695,15
13561,b-2_1427-1562_1475.wav,VTTS_b-2_1427-1562_1475.wav,4080,4725,-645
13562,b-4_301-400_395.wav,VTTS_b-4_301-400_395.wav,7930,7477,453
13563,b-4_2000-5164_5025.wav,VTTS_b-4_2000-5164_5025.wav,7873,7187,686
13564,b-2_2209-2310_2231.wav,VTTS_b-2_2209-2310_2231.wav,1600,1498,102
13565,b-4_2000-5164_4078.wav,VTTS_b-4_2000-5164_4078.wav,5530,5642,-112
13566,b-2_509-610_570.wav,VTTS_b-2_509-610_570.wav,4650,7895,-3245
13567,b-4_2000-5164_2007.wav,VTTS_b-4_2000-5164_2007.wav,8564,10112,-1548
13568,b-4_2000-5164_3312.wav,VTTS_b-4_2000-5164_3312.wav,1170,801,369
13569,b-1_1313-1413_1327.wav,VTTS_b-1_1313-1413_1327.wav,3340,3065,275
13570,b-4_2000-5164_3796.wav,VTTS_b-4_2000-5164_3796.wav,2020,2334,-314
13571,b-4_2000-5164_2320.wav,VTTS_b-4_2000-5164_2320.wav,1800,1904,-104
13572,b-4_2000-5164_5047.wav,VTTS_b-4_2000-5164_5047.wav,2718,2682,36
13573,b-3_6116-6215_6188.wav,VTTS_b-3_6116-6215_6188.wav,5660,5747,-87
13574,b-2_2107-2193_2137.wav,VTTS_b-2_2107-2193_2137.wav,3230,2577,653
13575,b-3_6701-6800_6786.wav,VTTS_b-3_6701-6800_6786.wav,4770,4540,230
13576,b-1_2220-2320_2264.wav,VTTS_b-1_2220-2320_2264.wav,1630,1950,-320
13577,b-4_2000-5164_4138.wav,VTTS_b-4_2000-5164_4138.wav,6003,6885,-882
13578,b-2_2073-2106_2093.wav,VTTS_b-2_2073-2106_2093.wav,6750,6711,39
13579,b-4_401-500_430.wav,VTTS_b-4_401-500_430.wav,5500,4772,728
13580,b-3_501-930_566.wav,VTTS_b-3_501-930_566.wav,6810,6838,-28
13581,b-1_1111-1211_1188.wav,VTTS_b-1_1111-1211_1188.wav,3810,3855,-45
13582,b-4_2000-5164_2850.wav,VTTS_b-4_2000-5164_2850.wav,7840,7477,363
13583,b-1_1010-1110_1012.wav,VTTS_b-1_1010-1110_1012.wav,2870,2740,130
13584,b-2_815-916_829.wav,VTTS_b-2_815-916_829.wav,1640,1800,-160
13585,b-4_2000-5164_5041.wav,VTTS_b-4_2000-5164_5041.wav,2421,2461,-40
13586,b-3_3198-3278_3198.wav,VTTS_b-3_3198-3278_3198.wav,3100,3123,-23
13587,b-1_3733-3833_3825.wav,VTTS_b-1_3733-3833_3825.wav,2290,2345,-55
13588,b-1_2826-2926_2846.wav,VTTS_b-1_2826-2926_2846.wav,1300,1265,35
13589,b-3_4207-4314_4225.wav,VTTS_b-3_4207-4314_4225.wav,6710,7628,-918
13590,b-1_3026-3126_3087.wav,VTTS_b-1_3026-3126_3087.wav,3370,4017,-647
13591,b-2_1699-1800_1713.wav,VTTS_b-2_1699-1800_1713.wav,5460,6014,-554
13592,b-3_3715-3802_3737.wav,VTTS_b-3_3715-3802_3737.wav,6320,5817,503
13593,b-4_2000-5164_3538.wav,VTTS_b-4_2000-5164_3538.wav,2933,2415,518
13594,b-2_1223-1324_1267.wav,VTTS_b-2_1223-1324_1267.wav,1640,1974,-334
13595,b-4_301-400_353.wav,VTTS_b-4_301-400_353.wav,7410,7059,351
13596,b-3_1764-1861_1782.wav,VTTS_b-3_1764-1861_1782.wav,5760,6037,-277
13597,b-2_917-1018_948.wav,VTTS_b-2_917-1018_948.wav,990,1637,-647
13598,b-1_2321-2421_2396.wav,VTTS_b-1_2321-2421_2396.wav,2550,2496,54
13599,b-3_1079-1320_1125.wav,VTTS_b-3_1079-1320_1125.wav,12940,11575,1365
13600,b-3_3112-3197_3164.wav,VTTS_b-3_3112-3197_3164.wav,3220,2972,248
13601,b-4_1221-1300_1278.wav,VTTS_b-4_1221-1300_1278.wav,3560,3297,263
13602,b-3_1079-1320_1095.wav,VTTS_b-3_1079-1320_1095.wav,6670,6258,412
13603,b-3_5639-5744_5666.wav,VTTS_b-3_5639-5744_5666.wav,4720,4725,-5
13604,b-1_2927-3025_2977.wav,VTTS_b-1_2927-3025_2977.wav,2080,2171,-91
13605,b-3_5853-5956_5941.wav,VTTS_b-3_5853-5956_5941.wav,3850,3866,-16
13606,b-1_2826-2926_2851.wav,VTTS_b-1_2826-2926_2851.wav,1980,2229,-249
13607,b-4_2000-5164_4906.wav,VTTS_b-4_2000-5164_4906.wav,3543,3332,211
13608,b-4_2000-5164_2501.wav,VTTS_b-4_2000-5164_2501.wav,2510,2763,-253
13609,b-3_2524-2854_2546.wav,VTTS_b-3_2524-2854_2546.wav,5800,6188,-388
13610,b-3_4001-4103_4096.wav,VTTS_b-3_4001-4103_4096.wav,8540,8638,-98
13611,b-1_3430-3530_3441.wav,VTTS_b-1_3430-3530_3441.wav,1380,1289,91
13612,b-2_2107-2193_2169.wav,VTTS_b-2_2107-2193_2169.wav,1370,1335,35
13613,b-3_501-930_876.wav,VTTS_b-3_501-930_876.wav,2020,1985,35
13614,b-2_1325-1426_1391.wav,VTTS_b-2_1325-1426_1391.wav,2960,2891,69
13615,b-3_98-195_98.wav,VTTS_b-3_98-195_98.wav,9290,11610,-2320
13616,b-1_2119-2219_2215.wav,VTTS_b-1_2119-2219_2215.wav,3740,11610,-7870
13617,b-1_1818-1918_1844.wav,VTTS_b-1_1818-1918_1844.wav,4300,4423,-123
13618,b-3_5428-5533_5505.wav,VTTS_b-3_5428-5533_5505.wav,4770,4505,265
13619,b-1_1919-2017_1927.wav,VTTS_b-1_1919-2017_1927.wav,2650,2856,-206
13620,b-4_1101-1220_1131.wav,VTTS_b-4_1101-1220_1131.wav,7160,8882,-1722
13621,b-4_53-150_97.wav,VTTS_b-4_53-150_97.wav,7710,8150,-440
13622,b-3_4607-5008_4739.wav,VTTS_b-3_4607-5008_4739.wav,4420,4284,136
13623,b-3_501-930_909.wav,VTTS_b-3_501-930_909.wav,4740,4180,560
13624,b-3_4607-5008_4967.wav,VTTS_b-3_4607-5008_4967.wav,6640,6954,-314
13625,b-3_1079-1320_1081.wav,VTTS_b-3_1079-1320_1081.wav,5070,4679,391
13626,b-1_377-477_438.wav,VTTS_b-1_377-477_438.wav,3270,4458,-1188
13627,b-3_6217-6274_6264.wav,VTTS_b-3_6217-6274_6264.wav,2900,2879,21
13628,b-3_501-930_629.wav,VTTS_b-3_501-930_629.wav,7250,7674,-424
13629,b-3_4315-4424_4352.wav,VTTS_b-3_4315-4424_4352.wav,7190,7581,-391
13630,b-4_501-1014_847.wav,VTTS_b-4_501-1014_847.wav,14430,11610,2820
13631,b-1_1212-1312_1301.wav,VTTS_b-1_1212-1312_1301.wav,1670,1498,172
13632,b-3_6016-6115_6032.wav,VTTS_b-3_6016-6115_6032.wav,9360,8046,1314
13633,b-4_2000-5164_2092.wav,VTTS_b-4_2000-5164_2092.wav,3010,2705,305
13634,b-3_3364-3453_3382.wav,VTTS_b-3_3364-3453_3382.wav,6460,6060,400
13635,b-1_4214-4285_4235.wav,VTTS_b-1_4214-4285_4235.wav,3680,5050,-1370
13636,b-4_2000-5164_2083.wav,VTTS_b-4_2000-5164_2083.wav,9560,10182,-622
13637,b-4_2000-5164_3478.wav,VTTS_b-4_2000-5164_3478.wav,8551,8371,180
13638,b-4_2000-5164_3854.wav,VTTS_b-4_2000-5164_3854.wav,4303,4365,-62
13639,b-4_501-1014_658.wav,VTTS_b-4_501-1014_658.wav,8900,9718,-818
13640,b-1_794-1009_865.wav,VTTS_b-1_794-1009_865.wav,2920,3820,-900
13641,b-2_509-610_608.wav,VTTS_b-2_509-610_608.wav,5290,5236,54
13642,b-4_2000-5164_2312.wav,VTTS_b-4_2000-5164_2312.wav,4355,4481,-126
13643,b-3_2524-2854_2845.wav,VTTS_b-3_2524-2854_2845.wav,5630,4748,882
13644,b-1_2523-2623_2591.wav,VTTS_b-1_2523-2623_2591.wav,3080,3100,-20
13645,b-3_5745-5852_5763.wav,VTTS_b-3_5745-5852_5763.wav,4550,10670,-6120
13646,b-4_401-500_404.wav,VTTS_b-4_401-500_404.wav,1310,1254,56
13647,b-3_501-930_533.wav,VTTS_b-3_501-930_533.wav,12970,11610,1360
13648,b-1_377-477_472.wav,VTTS_b-1_377-477_472.wav,1230,1010,220
13649,b-3_1079-1320_1294.wav,VTTS_b-3_1079-1320_1294.wav,3330,3495,-165
13650,b-4_2000-5164_2194.wav,VTTS_b-4_2000-5164_2194.wav,12040,11610,430
13651,b-3_1079-1320_1271.wav,VTTS_b-3_1079-1320_1271.wav,4770,4075,695
13652,b-3_6016-6115_6051.wav,VTTS_b-3_6016-6115_6051.wav,1890,1672,218
13653,b-2_509-610_565.wav,VTTS_b-2_509-610_565.wav,1460,1254,206
13654,b-1_1-73_25.wav,VTTS_b-1_1-73_25.wav,4270,4156,114
13655,b-3_1666-1763_1681.wav,VTTS_b-3_1666-1763_1681.wav,4250,4098,152
13656,b-1_1-73_39.wav,VTTS_b-1_1-73_39.wav,3090,3077,13
13657,b-3_3538-3627_3623.wav,VTTS_b-3_3538-3627_3623.wav,3780,4214,-434
13658,b-1_1515-1615_1546.wav,VTTS_b-1_1515-1615_1546.wav,5230,4447,783
13659,b-3_4607-5008_4787.wav,VTTS_b-3_4607-5008_4787.wav,4350,4377,-27
13660,b-3_4001-4103_4005.wav,VTTS_b-3_4001-4103_4005.wav,4600,4214,386
13661,b-3_2855-2942_2873.wav,VTTS_b-3_2855-2942_2873.wav,2780,3657,-877
13662,b-1_3733-3833_3787.wav,VTTS_b-1_3733-3833_3787.wav,2040,3239,-1199
13663,b-1_2927-3025_3007.wav,VTTS_b-1_2927-3025_3007.wav,4010,3773,237
13664,b-3_1862-1959_1956.wav,VTTS_b-3_1862-1959_1956.wav,5070,5259,-189
13665,b-2_101-202_134.wav,VTTS_b-2_101-202_134.wav,1350,1881,-531
13666,b-3_4498-4605_4500.wav,VTTS_b-3_4498-4605_4500.wav,4010,3320,690
13667,b-3_2524-2854_2610.wav,VTTS_b-3_2524-2854_2610.wav,5910,5364,546
13668,b-1_3935-4033_3967.wav,VTTS_b-1_3935-4033_3967.wav,4630,5550,-920
13669,b-1_2725-2825_2767.wav,VTTS_b-1_2725-2825_2767.wav,3960,5097,-1137
13670,b-3_4425-4497_4467.wav,VTTS_b-3_4425-4497_4467.wav,3050,4156,-1106
13671,b-4_151-300_172.wav,VTTS_b-4_151-300_172.wav,5800,5492,308
13672,b-3_6016-6115_6109.wav,VTTS_b-3_6016-6115_6109.wav,9640,10286,-646
13673,b-3_2434-2523_2510.wav,VTTS_b-3_2434-2523_2510.wav,4560,4969,-409
13674,b-4_2000-5164_4293.wav,VTTS_b-4_2000-5164_4293.wav,6724,8104,-1380
13675,b-1_1111-1211_1117.wav,VTTS_b-1_1111-1211_1117.wav,4700,6629,-1929
13676,b-3_3198-3278_3260.wav,VTTS_b-3_3198-3278_3260.wav,4740,4888,-148
13677,b-2_203-304_282.wav,VTTS_b-2_203-304_282.wav,2360,3019,-659
13678,b-1_3329-3429_3380.wav,VTTS_b-1_3329-3429_3380.wav,2420,2635,-215
13679,b-4_2000-5164_2292.wav,VTTS_b-4_2000-5164_2292.wav,7120,6641,479
13680,b-1_2018-2118_2086.wav,VTTS_b-1_2018-2118_2086.wav,1260,1300,-40
13681,b-1_794-1009_955.wav,VTTS_b-1_794-1009_955.wav,2170,1962,208
13682,b-4_501-1014_898.wav,VTTS_b-4_501-1014_898.wav,3540,3413,127
13683,b-4_151-300_241.wav,VTTS_b-4_151-300_241.wav,2160,2380,-220
13684,b-2_1427-1562_1555.wav,VTTS_b-2_1427-1562_1555.wav,2500,3727,-1227
13685,b-3_4001-4103_4017.wav,VTTS_b-3_4001-4103_4017.wav,2260,2345,-85
13686,b-1_3834-3934_3903.wav,VTTS_b-1_3834-3934_3903.wav,6310,5433,877
13687,b-3_4425-4497_4474.wav,VTTS_b-3_4425-4497_4474.wav,3040,3123,-83
13688,b-1_175-275_228.wav,VTTS_b-1_175-275_228.wav,1270,1219,51
13689,b-2_101-202_192.wav,VTTS_b-2_101-202_192.wav,2230,2334,-104
13690,b-4_1301-1400_1346.wav,VTTS_b-4_1301-1400_1346.wav,8610,8696,-86
13691,b-1_1313-1413_1373.wav,VTTS_b-1_1313-1413_1373.wav,2690,2914,-224
13692,b-2_2209-2310_2289.wav,VTTS_b-2_2209-2310_2289.wav,3300,2961,339
13693,b-4_1101-1220_1107.wav,VTTS_b-4_1101-1220_1107.wav,10600,9799,801
13694,b-3_5533-5638_5552.wav,VTTS_b-3_5533-5638_5552.wav,5390,5724,-334
13695,b-3_4607-5008_4810.wav,VTTS_b-3_4607-5008_4810.wav,2700,3413,-713
13696,b-3_6116-6215_6178.wav,VTTS_b-3_6116-6215_6178.wav,6640,5956,684
13697,b-4_2000-5164_4005.wav,VTTS_b-4_2000-5164_4005.wav,5490,5677,-187
13698,b-1_3026-3126_3036.wav,VTTS_b-1_3026-3126_3036.wav,2820,2519,301
13699,b-4_2000-5164_4526.wav,VTTS_b-4_2000-5164_4526.wav,3702,3715,-13
13700,b-4_2000-5164_3235.wav,VTTS_b-4_2000-5164_3235.wav,7289,7814,-525
13701,b-4_2000-5164_4928.wav,VTTS_b-4_2000-5164_4928.wav,5035,5352,-317
13702,b-1_3026-3126_3102.wav,VTTS_b-1_3026-3126_3102.wav,2150,2241,-91
13703,b-3_3889-4000_3942.wav,VTTS_b-3_3889-4000_3942.wav,5060,4563,497
13704,b-1_2321-2421_2418.wav,VTTS_b-1_2321-2421_2418.wav,2410,3251,-841
13705,b-3_2177-2266_2230.wav,VTTS_b-3_2177-2266_2230.wav,5580,4110,1470
13706,b-3_2434-2523_2509.wav,VTTS_b-3_2434-2523_2509.wav,8280,9648,-1368
13707,b-4_2000-5164_2818.wav,VTTS_b-4_2000-5164_2818.wav,4060,3808,252
13708,b-3_1764-1861_1822.wav,VTTS_b-3_1764-1861_1822.wav,7540,7523,17
13709,b-1_1818-1918_1915.wav,VTTS_b-1_1818-1918_1915.wav,2230,1869,361
13710,b-3_1321-1568_1407.wav,VTTS_b-3_1321-1568_1407.wav,8260,7454,806
13711,b-1_1717-1817_1818.wav,VTTS_b-1_1717-1817_1818.wav,2500,2635,-135
13712,b-3_6601-6700_6624.wav,VTTS_b-3_6601-6700_6624.wav,5510,6177,-667
13713,b-4_1221-1300_1234.wav,VTTS_b-4_1221-1300_1234.wav,6280,6664,-384
13714,b-1_3026-3126_3045.wav,VTTS_b-1_3026-3126_3045.wav,2710,2577,133
13715,b-4_501-1014_803.wav,VTTS_b-4_501-1014_803.wav,3780,4702,-922
13716,b-2_611-712_670.wav,VTTS_b-2_611-712_670.wav,3580,4122,-542
13717,b-4_1901-2000_1925.wav,VTTS_b-4_1901-2000_1925.wav,9510,9532,-22
13718,b-1_74-174_165.wav,VTTS_b-1_74-174_165.wav,3000,3193,-193
13719,b-2_1427-1562_1510.wav,VTTS_b-2_1427-1562_1510.wav,3450,2937,513
13720,b-4_1301-1400_1370.wav,VTTS_b-4_1301-1400_1370.wav,3970,3901,69
13721,b-4_2000-5164_2849.wav,VTTS_b-4_2000-5164_2849.wav,1955,2218,-263
13722,b-3_501-930_853.wav,VTTS_b-3_501-930_853.wav,5380,5224,156
13723,b-2_1801-1902_1824.wav,VTTS_b-2_1801-1902_1824.wav,1390,1138,252
13724,b-2_1801-1902_1901.wav,VTTS_b-2_1801-1902_1901.wav,3380,3831,-451
13725,b-2_2040-2072_2042.wav,VTTS_b-2_2040-2072_2042.wav,1340,1463,-123
13726,b-2_1699-1800_1784.wav,VTTS_b-2_1699-1800_1784.wav,1610,1533,77
13727,b-4_1014-1100_1020.wav,VTTS_b-4_1014-1100_1020.wav,2880,2763,117
13728,b-4_2000-5164_4499.wav,VTTS_b-4_2000-5164_4499.wav,4931,4284,647
13729,b-1_794-1009_982.wav,VTTS_b-1_794-1009_982.wav,3260,2972,288
13730,b-3_3889-4000_3962.wav,VTTS_b-3_3889-4000_3962.wav,3290,3239,51
13731,b-3_3279-3363_3299.wav,VTTS_b-3_3279-3363_3299.wav,4170,3286,884
13732,b-1_2624-2724_2647.wav,VTTS_b-1_2624-2724_2647.wav,1290,1242,48
13733,b-2_203-304_268.wav,VTTS_b-2_203-304_268.wav,1840,3657,-1817
13734,b-1_1414-1514_1419.wav,VTTS_b-1_1414-1514_1419.wav,3600,3599,1
13735,b-1_2523-2623_2578.wav,VTTS_b-1_2523-2623_2578.wav,5990,6246,-256
13736,b-3_294-391_311.wav,VTTS_b-3_294-391_311.wav,4510,4319,191
13737,b-4_151-300_273.wav,VTTS_b-4_151-300_273.wav,6790,6536,254
13738,b-1_1515-1615_1561.wav,VTTS_b-1_1515-1615_1561.wav,4930,6966,-2036
13739,b-3_5533-5638_5637.wav,VTTS_b-3_5533-5638_5637.wav,5590,5294,296
13740,b-3_1321-1568_1331.wav,VTTS_b-3_1321-1568_1331.wav,6870,6490,380
13741,b-2_1801-1902_1864.wav,VTTS_b-2_1801-1902_1864.wav,3290,3065,225
13742,b-1_1212-1312_1279.wav,VTTS_b-1_1212-1312_1279.wav,4690,3843,847
13743,b-3_5009-5427_5318.wav,VTTS_b-3_5009-5427_5318.wav,7230,8011,-781
13744,b-1_1414-1514_1446.wav,VTTS_b-1_1414-1514_1446.wav,3750,3750,0
13745,b-2_509-610_568.wav,VTTS_b-2_509-610_568.wav,5710,6467,-757
13746,b-4_2000-5164_5103.wav,VTTS_b-4_2000-5164_5103.wav,2897,3750,-853
13747,b-1_1919-2017_1951.wav,VTTS_b-1_1919-2017_1951.wav,3090,2984,106
13748,b-2_1427-1562_1443.wav,VTTS_b-2_1427-1562_1443.wav,4830,10855,-6025
13749,b-1_794-1009_963.wav,VTTS_b-1_794-1009_963.wav,3400,2914,486
13750,b-1_2523-2623_2523.wav,VTTS_b-1_2523-2623_2523.wav,1010,1103,-93
13751,b-1_3127-3227_3209.wav,VTTS_b-1_3127-3227_3209.wav,1260,1149,111
13752,b-4_2000-5164_3126.wav,VTTS_b-4_2000-5164_3126.wav,7104,7314,-210
13753,b-3_5533-5638_5619.wav,VTTS_b-3_5533-5638_5619.wav,8540,8278,262
13754,b-1_1919-2017_1964.wav,VTTS_b-1_1919-2017_1964.wav,2610,2543,67
13755,b-4_2000-5164_2867.wav,VTTS_b-4_2000-5164_2867.wav,5730,5584,146
13756,b-3_6801-6900_6834.wav,VTTS_b-3_6801-6900_6834.wav,1950,1521,429
13757,b-4_2000-5164_3729.wav,VTTS_b-4_2000-5164_3729.wav,12625,11610,1015
13758,b-1_4034-4069_4068.wav,VTTS_b-1_4034-4069_4068.wav,2330,2566,-236
13759,b-3_4498-4605_4599.wav,VTTS_b-3_4498-4605_4599.wav,6700,7558,-858
13760,b-2_2209-2310_2223.wav,VTTS_b-2_2209-2310_2223.wav,4870,7732,-2862
13761,b-2_2209-2310_2283.wav,VTTS_b-2_2209-2310_2283.wav,4340,3704,636
13762,b-2_2209-2310_2311.wav,VTTS_b-2_2209-2310_2311.wav,7950,6026,1924
13763,b-3_6801-6900_6866.wav,VTTS_b-3_6801-6900_6866.wav,4830,4911,-81
13764,b-1_686-793_702.wav,VTTS_b-1_686-793_702.wav,3760,5759,-1999
13765,b-2_1325-1426_1326.wav,VTTS_b-2_1325-1426_1326.wav,1830,1405,425
13766,b-2_1597-1698_1619.wav,VTTS_b-2_1597-1698_1619.wav,1500,1672,-172
13767,b-4_2000-5164_3664.wav,VTTS_b-4_2000-5164_3664.wav,3462,3564,-102
13768,b-3_1321-1568_1563.wav,VTTS_b-3_1321-1568_1563.wav,5250,5166,84
13769,b-3_2524-2854_2666.wav,VTTS_b-3_2524-2854_2666.wav,3940,4841,-901
13770,b-4_2000-5164_2588.wav,VTTS_b-4_2000-5164_2588.wav,5480,6873,-1393
13771,b-3_4607-5008_4691.wav,VTTS_b-3_4607-5008_4691.wav,9760,10379,-619
13772,b-3_3628-3714_3656.wav,VTTS_b-3_3628-3714_3656.wav,5970,5689,281
13773,b-4_1707-1813_1778.wav,VTTS_b-4_1707-1813_1778.wav,2470,2647,-177
13774,b-3_2524-2854_2617.wav,VTTS_b-3_2524-2854_2617.wav,6680,6385,295
13775,b-3_501-930_580.wav,VTTS_b-3_501-930_580.wav,3250,3402,-152
13776,b-1_1010-1110_1024.wav,VTTS_b-1_1010-1110_1024.wav,3790,3239,551
13777,b-3_5533-5638_5536.wav,VTTS_b-3_5533-5638_5536.wav,7280,7152,128
13778,b-1_4214-4285_4257.wav,VTTS_b-1_4214-4285_4257.wav,2270,2856,-586
13779,b-4_2000-5164_2467.wav,VTTS_b-4_2000-5164_2467.wav,8750,8359,391
13780,b-1_1616-1716_1705.wav,VTTS_b-1_1616-1716_1705.wav,1160,1115,45
13781,b-4_501-1014_996.wav,VTTS_b-4_501-1014_996.wav,3940,4017,-77
13782,b-4_501-1014_659.wav,VTTS_b-4_501-1014_659.wav,7740,7256,484
13783,b-3_1321-1568_1383.wav,VTTS_b-3_1321-1568_1383.wav,1680,1730,-50
13784,b-1_175-275_256.wav,VTTS_b-1_175-275_256.wav,1910,2891,-981
13785,b-2_2209-2310_2269.wav,VTTS_b-2_2209-2310_2269.wav,3690,6385,-2695
13786,b-3_6016-6115_6031.wav,VTTS_b-3_6016-6115_6031.wav,5340,5375,-35
13787,b-2_407-508_419.wav,VTTS_b-2_407-508_419.wav,1740,1672,68
13788,b-1_3531-3631_3532.wav,VTTS_b-1_3531-3631_3532.wav,1790,1718,72
13789,b-3_931-979_941.wav,VTTS_b-3_931-979_941.wav,3640,4098,-458
13790,b-3_1321-1568_1527.wav,VTTS_b-3_1321-1568_1527.wav,5310,6293,-983
13791,b-4_2000-5164_4359.wav,VTTS_b-4_2000-5164_4359.wav,1277,1184,93
13792,b-4_1707-1813_1799.wav,VTTS_b-4_1707-1813_1799.wav,3140,2856,284
13793,b-3_2943-3024_3006.wav,VTTS_b-3_2943-3024_3006.wav,3380,3646,-266
13794,b-3_1862-1959_1893.wav,VTTS_b-3_1862-1959_1893.wav,2960,2009,951
13795,b-3_2177-2266_2255.wav,VTTS_b-3_2177-2266_2255.wav,2960,3007,-47
13796,b-3_196-293_283.wav,VTTS_b-3_196-293_283.wav,6460,6815,-355
13797,b-4_151-300_230.wav,VTTS_b-4_151-300_230.wav,6860,6049,811
13798,b-3_6116-6215_6125.wav,VTTS_b-3_6116-6215_6125.wav,4060,4342,-282
13799,b-3_2000-2088_2087.wav,VTTS_b-3_2000-2088_2087.wav,3370,2891,479
13800,b-3_5009-5427_5349.wav,VTTS_b-3_5009-5427_5349.wav,3740,3727,13
13801,b-2_1223-1324_1272.wav,VTTS_b-2_1223-1324_1272.wav,10370,11610,-1240
13802,b-4_1707-1813_1730.wav,VTTS_b-4_1707-1813_1730.wav,7270,7163,107
13803,b-1_1010-1110_1064.wav,VTTS_b-1_1010-1110_1064.wav,2750,2786,-36
13804,b-4_2000-5164_2518.wav,VTTS_b-4_2000-5164_2518.wav,4120,4203,-83
13805,b-3_4607-5008_4686.wav,VTTS_b-3_4607-5008_4686.wav,6790,6571,219
13806,b-1_1010-1110_1015.wav,VTTS_b-1_1010-1110_1015.wav,2960,3053,-93
13807,b-2_1121-1222_1205.wav,VTTS_b-2_1121-1222_1205.wav,7570,8905,-1335
13808,b-3_1568-1665_1644.wav,VTTS_b-3_1568-1665_1644.wav,3090,2914,176
13809,b-2_101-202_135.wav,VTTS_b-2_101-202_135.wav,2770,3077,-307
13810,b-4_1301-1400_1356.wav,VTTS_b-4_1301-1400_1356.wav,8470,9009,-539
13811,b-4_2000-5164_3101.wav,VTTS_b-4_2000-5164_3101.wav,2485,2287,198
13812,b-3_6601-6700_6647.wav,VTTS_b-3_6601-6700_6647.wav,4180,3692,488
13813,b-3_501-930_634.wav,VTTS_b-3_501-930_634.wav,9460,8348,1112
13814,b-1_3531-3631_3596.wav,VTTS_b-1_3531-3631_3596.wav,2430,2496,-66
13815,b-1_377-477_412.wav,VTTS_b-1_377-477_412.wav,2340,2101,239
13816,b-3_3538-3627_3541.wav,VTTS_b-3_3538-3627_3541.wav,8180,7094,1086
13817,b-2_1597-1698_1683.wav,VTTS_b-2_1597-1698_1683.wav,1270,1068,202
13818,b-3_4104-4206_4205.wav,VTTS_b-3_4104-4206_4205.wav,6500,11610,-5110
13819,b-3_3803-3888_3865.wav,VTTS_b-3_3803-3888_3865.wav,6680,5956,724
13820,b-3_6701-6800_6733.wav,VTTS_b-3_6701-6800_6733.wav,8990,9729,-739
13821,b-1_478-578_502.wav,VTTS_b-1_478-578_502.wav,2400,2136,264
13822,b-3_2943-3024_2953.wav,VTTS_b-3_2943-3024_2953.wav,3900,4365,-465
13823,b-1_3329-3429_3394.wav,VTTS_b-1_3329-3429_3394.wav,1840,1695,145
13824,b-1_1919-2017_1922.wav,VTTS_b-1_1919-2017_1922.wav,2910,2926,-16
13825,b-1_3127-3227_3158.wav,VTTS_b-1_3127-3227_3158.wav,1520,1556,-36
13826,b-1_1414-1514_1422.wav,VTTS_b-1_1414-1514_1422.wav,4390,4075,315
13827,b-1_4034-4069_4057.wav,VTTS_b-1_4034-4069_4057.wav,1960,1927,33
13828,b-2_815-916_882.wav,VTTS_b-2_815-916_882.wav,5000,4772,228
13829,b-3_3538-3627_3597.wav,VTTS_b-3_3538-3627_3597.wav,5230,5271,-41
13830,b-1_4070-4105_4092.wav,VTTS_b-1_4070-4105_4092.wav,1720,1834,-114
13831,b-3_5009-5427_5099.wav,VTTS_b-3_5009-5427_5099.wav,4720,4690,30
13832,b-3_3538-3627_3574.wav,VTTS_b-3_3538-3627_3574.wav,3470,3193,277
13833,b-4_2000-5164_2369.wav,VTTS_b-4_2000-5164_2369.wav,7000,11610,-4610
13834,b-3_4607-5008_4705.wav,VTTS_b-3_4607-5008_4705.wav,2310,1428,882
13835,b-3_2177-2266_2219.wav,VTTS_b-3_2177-2266_2219.wav,2230,2078,152
13836,b-2_1903-2038_2008.wav,VTTS_b-2_1903-2038_2008.wav,1720,1567,153
13837,b-3_294-391_353.wav,VTTS_b-3_294-391_353.wav,6970,6827,143
13838,b-1_794-1009_844.wav,VTTS_b-1_794-1009_844.wav,2260,2496,-236
13839,b-1_794-1009_1003.wav,VTTS_b-1_794-1009_1003.wav,3290,2868,422
13840,b-3_6601-6700_6663.wav,VTTS_b-3_6601-6700_6663.wav,3390,3042,348
13841,b-1_3228-3328_3308.wav,VTTS_b-1_3228-3328_3308.wav,1310,1335,-25
13842,b-1_2826-2926_2842.wav,VTTS_b-1_2826-2926_2842.wav,3590,3924,-334
13843,b-3_1079-1320_1182.wav,VTTS_b-3_1079-1320_1182.wav,3900,3855,45
13844,b-4_2000-5164_2210.wav,VTTS_b-4_2000-5164_2210.wav,2980,3065,-85
13845,b-2_1563-1596_1585.wav,VTTS_b-2_1563-1596_1585.wav,8040,8162,-122
13846,b-3_2524-2854_2818.wav,VTTS_b-3_2524-2854_2818.wav,11460,10844,616
13847,b-1_1616-1716_1653.wav,VTTS_b-1_1616-1716_1653.wav,1590,1591,-1
13848,b-2_509-610_589.wav,VTTS_b-2_509-610_589.wav,3560,3506,54
13849,b-1_3834-3934_3879.wav,VTTS_b-1_3834-3934_3879.wav,3070,3181,-111
13850,b-4_2000-5164_4717.wav,VTTS_b-4_2000-5164_4717.wav,4405,4818,-413
13851,b-3_1079-1320_1147.wav,VTTS_b-3_1079-1320_1147.wav,6500,6815,-315
13852,b-1_2725-2825_2736.wav,VTTS_b-1_2725-2825_2736.wav,4470,5956,-1486
13853,b-4_2000-5164_5002.wav,VTTS_b-4_2000-5164_5002.wav,6120,7187,-1067
13854,b-3_1666-1763_1750.wav,VTTS_b-3_1666-1763_1750.wav,2530,2310,220
13855,b-2_407-508_441.wav,VTTS_b-2_407-508_441.wav,2620,2798,-178
13856,b-3_4607-5008_4853.wav,VTTS_b-3_4607-5008_4853.wav,4300,5248,-948
13857,b-4_1401-1505_1491.wav,VTTS_b-4_1401-1505_1491.wav,5370,5515,-145
13858,b-4_2000-5164_3987.wav,VTTS_b-4_2000-5164_3987.wav,6941,7999,-1058
13859,b-4_501-1014_794.wav,VTTS_b-4_501-1014_794.wav,6860,7837,-977
13860,b-3_3454-3537_3515.wav,VTTS_b-3_3454-3537_3515.wav,4420,4284,136
13861,b-2_611-712_695.wav,VTTS_b-2_611-712_695.wav,1530,1683,-153
13862,b-3_6601-6700_6690.wav,VTTS_b-3_6601-6700_6690.wav,5560,7558,-1998
13863,b-1_4214-4285_4236.wav,VTTS_b-1_4214-4285_4236.wav,4700,5143,-443
13864,b-4_2000-5164_3040.wav,VTTS_b-4_2000-5164_3040.wav,8663,11610,-2947
13865,b-4_2000-5164_3758.wav,VTTS_b-4_2000-5164_3758.wav,6450,5956,494
13866,b-4_2000-5164_3762.wav,VTTS_b-4_2000-5164_3762.wav,5800,5700,100
13867,b-1_4214-4285_4238.wav,VTTS_b-1_4214-4285_4238.wav,5860,3332,2528
13868,b-4_1101-1220_1118.wav,VTTS_b-4_1101-1220_1118.wav,4030,3808,222
13869,b-3_4425-4497_4462.wav,VTTS_b-3_4425-4497_4462.wav,3690,2705,985
13870,b-4_2000-5164_3667.wav,VTTS_b-4_2000-5164_3667.wav,3549,3181,368
13871,b-3_2177-2266_2180.wav,VTTS_b-3_2177-2266_2180.wav,3520,3971,-451
13872,b-4_401-500_420.wav,VTTS_b-4_401-500_420.wav,1960,1823,137
13873,b-1_1111-1211_1114.wav,VTTS_b-1_1111-1211_1114.wav,2530,3611,-1081
13874,b-3_5745-5852_5800.wav,VTTS_b-3_5745-5852_5800.wav,4670,4725,-55
13875,b-4_401-500_450.wav,VTTS_b-4_401-500_450.wav,3190,3123,67
13876,b-2_611-712_703.wav,VTTS_b-2_611-712_703.wav,1880,1846,34
13877,b-4_2000-5164_4454.wav,VTTS_b-4_2000-5164_4454.wav,11636,11610,26
13878,b-3_5009-5427_5121.wav,VTTS_b-3_5009-5427_5121.wav,3750,4946,-1196
13879,b-4_2000-5164_3738.wav,VTTS_b-4_2000-5164_3738.wav,9260,9927,-667
13880,b-4_1707-1813_1795.wav,VTTS_b-4_1707-1813_1795.wav,3460,3216,244
13881,b-2_2107-2193_2178.wav,VTTS_b-2_2107-2193_2178.wav,3470,3355,115
13882,b-3_1862-1959_1939.wav,VTTS_b-3_1862-1959_1939.wav,4560,3808,752
13883,b-3_392-500_478.wav,VTTS_b-3_392-500_478.wav,11020,10553,467
13884,b-3_2089-2176_2089.wav,VTTS_b-3_2089-2176_2089.wav,2980,2833,147
13885,b-4_1014-1100_1025.wav,VTTS_b-4_1014-1100_1025.wav,7200,6989,211
13886,b-1_4358-4393_4390.wav,VTTS_b-1_4358-4393_4390.wav,4850,4923,-73
13887,b-4_2000-5164_2421.wav,VTTS_b-4_2000-5164_2421.wav,1240,1126,114
13888,b-1_2624-2724_2627.wav,VTTS_b-1_2624-2724_2627.wav,1670,1196,474
13889,b-1_3632-3732_3642.wav,VTTS_b-1_3632-3732_3642.wav,3590,4667,-1077
13890,b-1_2119-2219_2205.wav,VTTS_b-1_2119-2219_2205.wav,3170,3181,-11
13891,b-3_5009-5427_5242.wav,VTTS_b-3_5009-5427_5242.wav,2220,2148,72
13892,b-2_1121-1222_1159.wav,VTTS_b-2_1121-1222_1159.wav,4430,5793,-1363
13893,b-1_2725-2825_2772.wav,VTTS_b-1_2725-2825_2772.wav,2450,2113,337
13894,b-3_98-195_182.wav,VTTS_b-3_98-195_182.wav,2130,2461,-331
13895,b-3_4104-4206_4189.wav,VTTS_b-3_4104-4206_4189.wav,6390,5654,736
13896,b-1_3430-3530_3520.wav,VTTS_b-1_3430-3530_3520.wav,1490,1486,4
13897,b-1_1010-1110_1026.wav,VTTS_b-1_1010-1110_1026.wav,4910,4632,278
13898,b-4_2000-5164_2186.wav,VTTS_b-4_2000-5164_2186.wav,4140,4598,-458
13899,b-3_980-1077_1047.wav,VTTS_b-3_980-1077_1047.wav,5140,5178,-38
13900,b-4_2000-5164_5085.wav,VTTS_b-4_2000-5164_5085.wav,4598,3959,639
13901,b-4_501-1014_560.wav,VTTS_b-4_501-1014_560.wav,5320,5097,223
13902,b-3_5853-5956_5904.wav,VTTS_b-3_5853-5956_5904.wav,5820,5944,-124
13903,b-2_1223-1324_1227.wav,VTTS_b-2_1223-1324_1227.wav,4700,5178,-478
13904,b-4_151-300_237.wav,VTTS_b-4_151-300_237.wav,3620,4540,-920
13905,b-3_5639-5744_5648.wav,VTTS_b-3_5639-5744_5648.wav,7270,6815,455
13906,b-3_2855-2942_2856.wav,VTTS_b-3_2855-2942_2856.wav,2770,2902,-132
13907,b-4_1506-1600_1530.wav,VTTS_b-4_1506-1600_1530.wav,3710,2810,900
13908,b-4_2000-5164_4623.wav,VTTS_b-4_2000-5164_4623.wav,1840,1753,87
13909,b-4_501-1014_596.wav,VTTS_b-4_501-1014_596.wav,3520,3471,49
13910,b-3_1321-1568_1486.wav,VTTS_b-3_1321-1568_1486.wav,2760,2403,357
13911,b-3_3454-3537_3510.wav,VTTS_b-3_3454-3537_3510.wav,3220,2357,863
13912,b-3_980-1077_1025.wav,VTTS_b-3_980-1077_1025.wav,5100,4423,677
13913,b-3_4207-4314_4315.wav,VTTS_b-3_4207-4314_4315.wav,7390,6211,1179
13914,b-3_5009-5427_5432.wav,VTTS_b-3_5009-5427_5432.wav,5680,4586,1094
13915,b-1_794-1009_1007.wav,VTTS_b-1_794-1009_1007.wav,2990,2810,180
13916,b-2_1801-1902_1886.wav,VTTS_b-2_1801-1902_1886.wav,2360,1718,642
13917,b-1_1212-1312_1274.wav,VTTS_b-1_1212-1312_1274.wav,1750,1463,287
13918,b-1_794-1009_985.wav,VTTS_b-1_794-1009_985.wav,2950,3495,-545
13919,b-4_2000-5164_3647.wav,VTTS_b-4_2000-5164_3647.wav,2039,1962,77
13920,b-3_4607-5008_4882.wav,VTTS_b-3_4607-5008_4882.wav,3910,3901,9
13921,b-3_4001-4103_4101.wav,VTTS_b-3_4001-4103_4101.wav,4750,5921,-1171
13922,b-3_3198-3278_3202.wav,VTTS_b-3_3198-3278_3202.wav,7390,6966,424
13923,b-3_1568-1665_1610.wav,VTTS_b-3_1568-1665_1610.wav,6650,5526,1124
13924,b-4_2000-5164_3604.wav,VTTS_b-4_2000-5164_3604.wav,2017,1788,229
13925,b-1_1111-1211_1136.wav,VTTS_b-1_1111-1211_1136.wav,4890,5248,-358
13926,b-2_611-712_622.wav,VTTS_b-2_611-712_622.wav,2040,1892,148
13927,b-2_2413-2500_2452.wav,VTTS_b-2_2413-2500_2452.wav,1660,1660,0
13928,b-4_53-150_131.wav,VTTS_b-4_53-150_131.wav,9080,8499,581
13929,b-4_2000-5164_3742.wav,VTTS_b-4_2000-5164_3742.wav,8810,9033,-223
13930,b-1_1717-1817_1719.wav,VTTS_b-1_1717-1817_1719.wav,5790,5016,774
13931,b-1_2422-2522_2467.wav,VTTS_b-1_2422-2522_2467.wav,1810,1823,-13
13932,b-1_2927-3025_2997.wav,VTTS_b-1_2927-3025_2997.wav,1770,1811,-41
13933,b-4_2000-5164_3577.wav,VTTS_b-4_2000-5164_3577.wav,4814,4725,89
13934,b-4_2000-5164_4837.wav,VTTS_b-4_2000-5164_4837.wav,5483,6130,-647
13935,b-3_5009-5427_5235.wav,VTTS_b-3_5009-5427_5235.wav,7120,6989,131
13936,b-4_2000-5164_4113.wav,VTTS_b-4_2000-5164_4113.wav,5202,5596,-394
13937,b-3_2524-2854_2600.wav,VTTS_b-3_2524-2854_2600.wav,8410,9114,-704
13938,b-1_3127-3227_3174.wav,VTTS_b-1_3127-3227_3174.wav,1380,1265,115
13939,b-3_3364-3453_3407.wav,VTTS_b-3_3364-3453_3407.wav,3550,3529,21
13940,b-3_2350-2433_2423.wav,VTTS_b-3_2350-2433_2423.wav,4710,6676,-1966
13941,b-3_2434-2523_2471.wav,VTTS_b-3_2434-2523_2471.wav,4290,4087,203
13942,b-1_4070-4105_4099.wav,VTTS_b-1_4070-4105_4099.wav,3240,3936,-696
13943,b-4_2000-5164_3655.wav,VTTS_b-4_2000-5164_3655.wav,4458,4818,-360
13944,b-3_4207-4314_4215.wav,VTTS_b-3_4207-4314_4215.wav,5170,6049,-879
13945,b-4_501-1014_899.wav,VTTS_b-4_501-1014_899.wav,7960,7860,100
13946,b-3_4498-4605_4604.wav,VTTS_b-3_4498-4605_4604.wav,3170,3634,-464
13947,b-3_1079-1320_1243.wav,VTTS_b-3_1079-1320_1243.wav,6840,6792,48
13948,b-1_3834-3934_3907.wav,VTTS_b-1_3834-3934_3907.wav,2140,2194,-54
13949,b-4_1814-1900_1873.wav,VTTS_b-4_1814-1900_1873.wav,1750,1591,159
13950,b-3_2524-2854_2564.wav,VTTS_b-3_2524-2854_2564.wav,8080,8533,-453
13951,b-1_2220-2320_2288.wav,VTTS_b-1_2220-2320_2288.wav,1980,2032,-52
13952,b-2_611-712_683.wav,VTTS_b-2_611-712_683.wav,1940,2020,-80
13953,b-1_2523-2623_2588.wav,VTTS_b-1_2523-2623_2588.wav,2920,2601,319
13954,b-1_74-174_89.wav,VTTS_b-1_74-174_89.wav,1250,1115,135
13955,b-1_4430-4465_4464.wav,VTTS_b-1_4430-4465_4464.wav,1920,2926,-1006
13956,b-4_2000-5164_2280.wav,VTTS_b-4_2000-5164_2280.wav,2740,2647,93
13957,b-4_2000-5164_4084.wav,VTTS_b-4_2000-5164_4084.wav,6418,6699,-281
13958,b-3_1079-1320_1278.wav,VTTS_b-3_1079-1320_1278.wav,7720,10043,-2323
13959,b-1_1111-1211_1150.wav,VTTS_b-1_1111-1211_1150.wav,1880,1393,487
13960,b-4_1506-1600_1589.wav,VTTS_b-4_1506-1600_1589.wav,4820,3982,838
13961,b-2_1121-1222_1181.wav,VTTS_b-2_1121-1222_1181.wav,1550,1428,122
13962,b-2_611-712_623.wav,VTTS_b-2_611-712_623.wav,5060,5596,-536
13963,b-3_6016-6115_6079.wav,VTTS_b-3_6016-6115_6079.wav,3690,3762,-72
13964,b-3_4607-5008_4808.wav,VTTS_b-3_4607-5008_4808.wav,7400,7407,-7
13965,b-3_3279-3363_3284.wav,VTTS_b-3_3279-3363_3284.wav,6280,6037,243
13966,b-1_4358-4393_4391.wav,VTTS_b-1_4358-4393_4391.wav,1550,1382,168
13967,b-4_2000-5164_4711.wav,VTTS_b-4_2000-5164_4711.wav,5621,5735,-114
13968,b-3_5009-5427_5107.wav,VTTS_b-3_5009-5427_5107.wav,6300,7221,-921
13969,b-3_1764-1861_1854.wav,VTTS_b-3_1764-1861_1854.wav,6950,6722,228
13970,b-3_501-930_590.wav,VTTS_b-3_501-930_590.wav,6220,5956,264
13971,b-2_1-100_33.wav,VTTS_b-2_1-100_33.wav,4820,6339,-1519
13972,b-4_2000-5164_3226.wav,VTTS_b-4_2000-5164_3226.wav,6216,5921,295
13973,b-3_4001-4103_4027.wav,VTTS_b-3_4001-4103_4027.wav,9200,8266,934
13974,b-4_2000-5164_3681.wav,VTTS_b-4_2000-5164_3681.wav,4227,4005,222
13975,b-4_1707-1813_1779.wav,VTTS_b-4_1707-1813_1779.wav,7440,6850,590
13976,b-3_4207-4314_4257.wav,VTTS_b-3_4207-4314_4257.wav,6000,6107,-107
13977,b-4_1101-1220_1143.wav,VTTS_b-4_1101-1220_1143.wav,10170,10275,-105
13978,b-4_151-300_198.wav,VTTS_b-4_151-300_198.wav,2980,3262,-282
13979,b-1_3531-3631_3621.wav,VTTS_b-1_3531-3631_3621.wav,1970,1985,-15
13980,b-3_1764-1861_1777.wav,VTTS_b-3_1764-1861_1777.wav,5520,5074,446
13981,b-3_4001-4103_4086.wav,VTTS_b-3_4001-4103_4086.wav,1190,1149,41
13982,b-3_4498-4605_4597.wav,VTTS_b-3_4498-4605_4597.wav,7340,7895,-555
13983,b-3_2177-2266_2251.wav,VTTS_b-3_2177-2266_2251.wav,5340,5213,127
13984,b-1_794-1009_893.wav,VTTS_b-1_794-1009_893.wav,3810,3785,25
13985,b-3_3454-3537_3506.wav,VTTS_b-3_3454-3537_3506.wav,3240,2879,361
13986,b-1_2624-2724_2664.wav,VTTS_b-1_2624-2724_2664.wav,2570,2426,144
13987,b-4_2000-5164_5043.wav,VTTS_b-4_2000-5164_5043.wav,3812,4551,-739
13988,b-3_980-1077_994.wav,VTTS_b-3_980-1077_994.wav,8080,7767,313
13989,b-1_478-578_535.wav,VTTS_b-1_478-578_535.wav,2830,3123,-293
13990,b-4_1301-1400_1324.wav,VTTS_b-4_1301-1400_1324.wav,2100,1591,509
13991,b-3_3889-4000_3957.wav,VTTS_b-3_3889-4000_3957.wav,4190,3251,939
13992,b-1_478-578_572.wav,VTTS_b-1_478-578_572.wav,3310,3309,1
13993,b-1_1616-1716_1712.wav,VTTS_b-1_1616-1716_1712.wav,4660,4818,-158
13994,b-4_501-1014_687.wav,VTTS_b-4_501-1014_687.wav,6190,6548,-358
13995,b-3_4607-5008_4888.wav,VTTS_b-3_4607-5008_4888.wav,9050,8069,981
13996,b-4_2000-5164_2646.wav,VTTS_b-4_2000-5164_2646.wav,3920,3971,-51
13997,b-3_1079-1320_1210.wav,VTTS_b-3_1079-1320_1210.wav,9280,9601,-321
13998,b-3_2177-2266_2244.wav,VTTS_b-3_2177-2266_2244.wav,5280,6060,-780
13999,b-4_2000-5164_3985.wav,VTTS_b-4_2000-5164_3985.wav,5833,6815,-982
14000,b-3_4607-5008_4634.wav,VTTS_b-3_4607-5008_4634.wav,2530,3785,-1255
14001,b-1_2321-2421_2345.wav,VTTS_b-1_2321-2421_2345.wav,4100,4470,-370
14002,b-4_501-1014_825.wav,VTTS_b-4_501-1014_825.wav,3620,3564,56
14003,b-4_2000-5164_3084.wav,VTTS_b-4_2000-5164_3084.wav,4491,4249,242
14004,b-3_3454-3537_3536.wav,VTTS_b-3_3454-3537_3536.wav,5830,4830,1000
14005,b-4_2000-5164_2403.wav,VTTS_b-4_2000-5164_2403.wav,9540,9996,-456
14006,b-1_4322-4357_4346.wav,VTTS_b-1_4322-4357_4346.wav,2600,2612,-12
14007,b-4_2000-5164_4606.wav,VTTS_b-4_2000-5164_4606.wav,4518,4818,-300
14008,b-1_1717-1817_1760.wav,VTTS_b-1_1717-1817_1760.wav,2400,2403,-3
14009,b-3_5639-5744_5685.wav,VTTS_b-3_5639-5744_5685.wav,5790,6525,-735
14010,b-2_713-814_746.wav,VTTS_b-2_713-814_746.wav,5060,7036,-1976
14011,b-1_2624-2724_2680.wav,VTTS_b-1_2624-2724_2680.wav,1570,1625,-55
14012,b-3_6601-6700_6655.wav,VTTS_b-3_6601-6700_6655.wav,6460,6200,260
14013,b-1_478-578_480.wav,VTTS_b-1_478-578_480.wav,3520,4145,-625
14014,b-3_1079-1320_1141.wav,VTTS_b-3_1079-1320_1141.wav,3670,4133,-463
14015,b-4_2000-5164_2307.wav,VTTS_b-4_2000-5164_2307.wav,4200,4133,67
14016,b-1_1313-1413_1411.wav,VTTS_b-1_1313-1413_1411.wav,3850,3634,216
14017,b-4_401-500_409.wav,VTTS_b-4_401-500_409.wav,8380,9903,-1523
14018,b-4_53-150_66.wav,VTTS_b-4_53-150_66.wav,9680,8406,1274
14019,b-1_2018-2118_2111.wav,VTTS_b-1_2018-2118_2111.wav,1690,1683,7
14020,b-4_501-1014_879.wav,VTTS_b-4_501-1014_879.wav,4710,4656,54
14021,b-3_931-979_966.wav,VTTS_b-3_931-979_966.wav,3860,3471,389
14022,b-2_611-712_655.wav,VTTS_b-2_611-712_655.wav,3190,3146,44
14023,b-2_1597-1698_1686.wav,VTTS_b-2_1597-1698_1686.wav,3700,5248,-1548
14024,b-3_4498-4605_4568.wav,VTTS_b-3_4498-4605_4568.wav,6240,6177,63
14025,b-4_2000-5164_2959.wav,VTTS_b-4_2000-5164_2959.wav,4383,3889,494
14026,b-1_3935-4033_3972.wav,VTTS_b-1_3935-4033_3972.wav,1060,1068,-8
14027,b-3_6900-7016_6959.wav,VTTS_b-3_6900-7016_6959.wav,9030,7454,1576
14028,b-3_3279-3363_3336.wav,VTTS_b-3_3279-3363_3336.wav,6650,6687,-37
14029,b-3_5009-5427_5382.wav,VTTS_b-3_5009-5427_5382.wav,7870,8185,-315
14030,b-3_4607-5008_4779.wav,VTTS_b-3_4607-5008_4779.wav,3690,6606,-2916
14031,b-4_2000-5164_3273.wav,VTTS_b-4_2000-5164_3273.wav,2309,2728,-419
14032,b-3_6801-6900_6897.wav,VTTS_b-3_6801-6900_6897.wav,2690,2728,-38
14033,b-4_2000-5164_2978.wav,VTTS_b-4_2000-5164_2978.wav,2598,2728,-130
14034,b-3_1-97_8.wav,VTTS_b-3_1-97_8.wav,2410,2647,-237
14035,b-3_5745-5852_5756.wav,VTTS_b-3_5745-5852_5756.wav,2400,2136,264
14036,b-2_1-100_68.wav,VTTS_b-2_1-100_68.wav,1430,1474,-44
14037,b-3_3198-3278_3224.wav,VTTS_b-3_3198-3278_3224.wav,4690,4540,150
14038,b-2_1325-1426_1400.wav,VTTS_b-2_1325-1426_1400.wav,1510,1869,-359
14039,b-1_1212-1312_1288.wav,VTTS_b-1_1212-1312_1288.wav,5250,4458,792
14040,b-4_2000-5164_3511.wav,VTTS_b-4_2000-5164_3511.wav,3322,3518,-196
14041,b-2_101-202_115.wav,VTTS_b-2_101-202_115.wav,1530,1474,56
14042,b-4_151-300_173.wav,VTTS_b-4_151-300_173.wav,5870,5480,390
14043,b-3_4315-4424_4392.wav,VTTS_b-3_4315-4424_4392.wav,5610,4865,745
14044,b-1_686-793_704.wav,VTTS_b-1_686-793_704.wav,840,917,-77
14045,b-2_611-712_673.wav,VTTS_b-2_611-712_673.wav,1020,1440,-420
14046,b-4_1401-1505_1455.wav,VTTS_b-4_1401-1505_1455.wav,7470,7140,330
14047,b-3_6501-6600_6539.wav,VTTS_b-3_6501-6600_6539.wav,3030,2183,847
14048,b-4_2000-5164_3847.wav,VTTS_b-4_2000-5164_3847.wav,7716,7314,402
14049,b-1_1212-1312_1275.wav,VTTS_b-1_1212-1312_1275.wav,4440,3355,1085
14050,b-3_3364-3453_3392.wav,VTTS_b-3_3364-3453_3392.wav,7530,11610,-4080
14051,b-2_2107-2193_2157.wav,VTTS_b-2_2107-2193_2157.wav,1460,1892,-432
14052,b-4_2000-5164_4982.wav,VTTS_b-4_2000-5164_4982.wav,10540,11610,-1070
14053,b-3_6801-6900_6810.wav,VTTS_b-3_6801-6900_6810.wav,4530,4888,-358
14054,b-1_276-376_336.wav,VTTS_b-1_276-376_336.wav,1540,2334,-794
14055,b-3_1079-1320_1214.wav,VTTS_b-3_1079-1320_1214.wav,7470,7105,365
14056,b-3_6900-7016_6909.wav,VTTS_b-3_6900-7016_6909.wav,3330,3518,-188
14057,b-4_2000-5164_3932.wav,VTTS_b-4_2000-5164_3932.wav,5850,6490,-640
14058,b-1_1010-1110_1051.wav,VTTS_b-1_1010-1110_1051.wav,2620,2426,194
14059,b-4_501-1014_544.wav,VTTS_b-4_501-1014_544.wav,5930,5875,55
14060,b-1_3632-3732_3720.wav,VTTS_b-1_3632-3732_3720.wav,2660,2810,-150
14061,b-3_1-97_39.wav,VTTS_b-3_1-97_39.wav,5570,5132,438
14062,b-4_2000-5164_3615.wav,VTTS_b-4_2000-5164_3615.wav,2608,2752,-144
14063,b-1_1818-1918_1879.wav,VTTS_b-1_1818-1918_1879.wav,1600,1591,9
14064,b-4_2000-5164_3598.wav,VTTS_b-4_2000-5164_3598.wav,5499,5259,240
14065,b-3_6701-6800_6725.wav,VTTS_b-3_6701-6800_6725.wav,4890,5190,-300
14066,b-4_2000-5164_4077.wav,VTTS_b-4_2000-5164_4077.wav,2923,2635,288
14067,b-3_1321-1568_1459.wav,VTTS_b-3_1321-1568_1459.wav,5770,6513,-743
14068,b-4_2000-5164_3956.wav,VTTS_b-4_2000-5164_3956.wav,7638,8742,-1104
14069,b-3_501-930_726.wav,VTTS_b-3_501-930_726.wav,7090,6838,252
14070,b-4_1601-1706_1648.wav,VTTS_b-4_1601-1706_1648.wav,12230,11610,620
14071,b-4_2000-5164_4574.wav,VTTS_b-4_2000-5164_4574.wav,7192,6943,249
14072,b-3_6601-6700_6657.wav,VTTS_b-3_6601-6700_6657.wav,4390,4725,-335
14073,b-3_4001-4103_4102.wav,VTTS_b-3_4001-4103_4102.wav,4500,4296,204
14074,b-4_2000-5164_4439.wav,VTTS_b-4_2000-5164_4439.wav,2226,2043,183
14075,b-3_3715-3802_3729.wav,VTTS_b-3_3715-3802_3729.wav,2170,2183,-13
14076,b-1_1010-1110_1090.wav,VTTS_b-1_1010-1110_1090.wav,1550,1324,226
14077,b-1_2119-2219_2217.wav,VTTS_b-1_2119-2219_2217.wav,1410,1498,-88
14078,b-2_917-1018_975.wav,VTTS_b-2_917-1018_975.wav,2350,2682,-332
14079,b-3_5009-5427_5096.wav,VTTS_b-3_5009-5427_5096.wav,7980,8591,-611
14080,b-1_2018-2118_2092.wav,VTTS_b-1_2018-2118_2092.wav,1680,1811,-131
14081,b-3_5639-5744_5661.wav,VTTS_b-3_5639-5744_5661.wav,3690,3994,-304
14082,b-4_501-1014_768.wav,VTTS_b-4_501-1014_768.wav,3920,11610,-7690
14083,b-1_686-793_748.wav,VTTS_b-1_686-793_748.wav,3090,2670,420
14084,b-4_1601-1706_1617.wav,VTTS_b-4_1601-1706_1617.wav,4330,3913,417
14085,b-4_1814-1900_1885.wav,VTTS_b-4_1814-1900_1885.wav,4290,3750,540
14086,b-2_2209-2310_2275.wav,VTTS_b-2_2209-2310_2275.wav,4480,4725,-245
14087,b-4_1101-1220_1101.wav,VTTS_b-4_1101-1220_1101.wav,5500,7976,-2476
14088,b-3_3628-3714_3675.wav,VTTS_b-3_3628-3714_3675.wav,10120,5317,4803
14089,b-1_1414-1514_1426.wav,VTTS_b-1_1414-1514_1426.wav,1620,1707,-87
14090,b-3_6116-6215_6179.wav,VTTS_b-3_6116-6215_6179.wav,4330,4586,-256
14091,b-3_2855-2942_2865.wav,VTTS_b-3_2855-2942_2865.wav,2790,2682,108
14092,b-3_4425-4497_4427.wav,VTTS_b-3_4425-4497_4427.wav,9360,8359,1001
14093,b-1_3935-4033_4004.wav,VTTS_b-1_3935-4033_4004.wav,1390,1509,-119
14094,b-1_3632-3732_3634.wav,VTTS_b-1_3632-3732_3634.wav,3380,3332,48
14095,b-1_2927-3025_2976.wav,VTTS_b-1_2927-3025_2976.wav,1680,1602,78
14096,b-3_6016-6115_6089.wav,VTTS_b-3_6016-6115_6089.wav,6460,7930,-1470
14097,b-4_2000-5164_4143.wav,VTTS_b-4_2000-5164_4143.wav,1285,1544,-259
14098,b-3_1321-1568_1490.wav,VTTS_b-3_1321-1568_1490.wav,3980,6513,-2533
14099,b-3_4104-4206_4198.wav,VTTS_b-3_4104-4206_4198.wav,3710,4017,-307
14100,b-3_5853-5956_5917.wav,VTTS_b-3_5853-5956_5917.wav,2510,2078,432
14101,b-3_1862-1959_1917.wav,VTTS_b-3_1862-1959_1917.wav,5220,5074,146
14102,b-2_2107-2193_2170.wav,VTTS_b-2_2107-2193_2170.wav,1720,1834,-114
14103,b-4_151-300_184.wav,VTTS_b-4_151-300_184.wav,2760,3065,-305
14104,b-3_2267-2349_2310.wav,VTTS_b-3_2267-2349_2310.wav,4680,4574,106
14105,b-4_1707-1813_1714.wav,VTTS_b-4_1707-1813_1714.wav,6330,6072,258
14106,b-3_6501-6600_6545.wav,VTTS_b-3_6501-6600_6545.wav,1220,1196,24
14107,b-1_4214-4285_4233.wav,VTTS_b-1_4214-4285_4233.wav,3450,4644,-1194
14108,b-1_4430-4465_4462.wav,VTTS_b-1_4430-4465_4462.wav,3270,2984,286
14109,b-4_501-1014_748.wav,VTTS_b-4_501-1014_748.wav,2160,1939,221
14110,b-2_1597-1698_1668.wav,VTTS_b-2_1597-1698_1668.wav,6050,7094,-1044
14111,b-3_6701-6800_6728.wav,VTTS_b-3_6701-6800_6728.wav,9610,9207,403
14112,b-1_2321-2421_2322.wav,VTTS_b-1_2321-2421_2322.wav,3140,2438,702
14113,b-3_1568-1665_1596.wav,VTTS_b-3_1568-1665_1596.wav,6370,5399,971
14114,b-3_2350-2433_2360.wav,VTTS_b-3_2350-2433_2360.wav,3760,3727,33
14115,b-4_1-52_22.wav,VTTS_b-4_1-52_22.wav,6020,5213,807
14116,b-1_4034-4069_4037.wav,VTTS_b-1_4034-4069_4037.wav,2010,2299,-289
14117,b-3_3628-3714_3665.wav,VTTS_b-3_3628-3714_3665.wav,4390,4493,-103
14118,b-4_2000-5164_5152.wav,VTTS_b-4_2000-5164_5152.wav,7735,9358,-1623
14119,b-1_4322-4357_4350.wav,VTTS_b-1_4322-4357_4350.wav,1340,1312,28
14120,b-4_2000-5164_3617.wav,VTTS_b-4_2000-5164_3617.wav,4158,3808,350
14121,b-1_175-275_209.wav,VTTS_b-1_175-275_209.wav,1320,1242,78
14122,b-3_2000-2088_2019.wav,VTTS_b-3_2000-2088_2019.wav,6510,8266,-1756
14123,b-4_2000-5164_4932.wav,VTTS_b-4_2000-5164_4932.wav,5041,5213,-172
14124,b-3_1764-1861_1799.wav,VTTS_b-3_1764-1861_1799.wav,10370,11610,-1240
14125,b-4_1506-1600_1547.wav,VTTS_b-4_1506-1600_1547.wav,2210,1800,410
14126,b-1_1212-1312_1299.wav,VTTS_b-1_1212-1312_1299.wav,3710,3228,482
14127,b-4_2000-5164_3464.wav,VTTS_b-4_2000-5164_3464.wav,4978,7500,-2522
14128,b-3_1666-1763_1712.wav,VTTS_b-3_1666-1763_1712.wav,5820,6142,-322
14129,b-4_2000-5164_4008.wav,VTTS_b-4_2000-5164_4008.wav,3600,3785,-185
14130,b-1_686-793_733.wav,VTTS_b-1_686-793_733.wav,5210,4133,1077
14131,b-4_2000-5164_2337.wav,VTTS_b-4_2000-5164_2337.wav,10590,11610,-1020
14132,b-1_74-174_131.wav,VTTS_b-1_74-174_131.wav,2170,2322,-152
14133,b-2_2040-2072_2070.wav,VTTS_b-2_2040-2072_2070.wav,1370,1149,221
14134,b-1_1818-1918_1837.wav,VTTS_b-1_1818-1918_1837.wav,3890,3669,221
14135,b-1_650-685_662.wav,VTTS_b-1_650-685_662.wav,1460,1265,195
14136,b-1_276-376_332.wav,VTTS_b-1_276-376_332.wav,2060,3007,-947
14137,b-3_4498-4605_4593.wav,VTTS_b-3_4498-4605_4593.wav,11120,10356,764
14138,b-3_3364-3453_3454.wav,VTTS_b-3_3364-3453_3454.wav,3240,3053,187
14139,b-4_2000-5164_3060.wav,VTTS_b-4_2000-5164_3060.wav,5890,6072,-182
14140,b-4_2000-5164_3230.wav,VTTS_b-4_2000-5164_3230.wav,6555,7419,-864
14141,b-1_3329-3429_3348.wav,VTTS_b-1_3329-3429_3348.wav,3050,4063,-1013
14142,b-1_2220-2320_2249.wav,VTTS_b-1_2220-2320_2249.wav,2390,2368,22
14143,b-3_1079-1320_1297.wav,VTTS_b-3_1079-1320_1297.wav,2460,2485,-25
14144,b-3_501-930_701.wav,VTTS_b-3_501-930_701.wav,3690,3158,532
14145,b-3_1079-1320_1165.wav,VTTS_b-3_1079-1320_1165.wav,8620,9520,-900
14146,b-1_3430-3530_3514.wav,VTTS_b-1_3430-3530_3514.wav,2780,2995,-215
14147,b-3_5428-5533_5490.wav,VTTS_b-3_5428-5533_5490.wav,3710,3843,-133
14148,b-1_1818-1918_1826.wav,VTTS_b-1_1818-1918_1826.wav,1180,1196,-16
14149,b-2_1-100_66.wav,VTTS_b-2_1-100_66.wav,2000,1741,259
14150,b-2_1903-2038_1995.wav,VTTS_b-2_1903-2038_1995.wav,1370,1324,46
14151,b-3_4607-5008_4960.wav,VTTS_b-3_4607-5008_4960.wav,5460,4853,607
14152,b-1_2725-2825_2727.wav,VTTS_b-1_2725-2825_2727.wav,1360,1416,-56
14153,b-1_3834-3934_3892.wav,VTTS_b-1_3834-3934_3892.wav,4450,4540,-90
14154,b-3_5639-5744_5670.wav,VTTS_b-3_5639-5744_5670.wav,8010,8870,-860
14155,b-3_501-930_670.wav,VTTS_b-3_501-930_670.wav,5530,5712,-182
14156,b-4_2000-5164_3278.wav,VTTS_b-4_2000-5164_3278.wav,1667,1544,123
14157,b-3_6401-6500_6496.wav,VTTS_b-3_6401-6500_6496.wav,5620,4748,872
14158,b-3_501-930_622.wav,VTTS_b-3_501-930_622.wav,5960,10925,-4965
14159,b-3_1321-1568_1514.wav,VTTS_b-3_1321-1568_1514.wav,4980,4214,766
14160,b-3_6116-6215_6148.wav,VTTS_b-3_6116-6215_6148.wav,5670,5410,260
14161,b-1_2220-2320_2278.wav,VTTS_b-1_2220-2320_2278.wav,2010,2125,-115
14162,b-3_196-293_220.wav,VTTS_b-3_196-293_220.wav,4160,4005,155
14163,b-2_1903-2038_2012.wav,VTTS_b-2_1903-2038_2012.wav,1530,1498,32
14164,b-3_3364-3453_3413.wav,VTTS_b-3_3364-3453_3413.wav,2660,2554,106
14165,b-4_1301-1400_1302.wav,VTTS_b-4_1301-1400_1302.wav,5510,5236,274
14166,b-1_3329-3429_3363.wav,VTTS_b-1_3329-3429_3363.wav,1820,1741,79
14167,b-3_2524-2854_2553.wav,VTTS_b-3_2524-2854_2553.wav,3610,3622,-12
14168,b-3_3889-4000_3960.wav,VTTS_b-3_3889-4000_3960.wav,3190,4180,-990
14169,b-1_478-578_551.wav,VTTS_b-1_478-578_551.wav,2490,2566,-76
14170,b-4_2000-5164_2468.wav,VTTS_b-4_2000-5164_2468.wav,3340,7779,-4439
14171,b-2_2209-2310_2278.wav,VTTS_b-2_2209-2310_2278.wav,2140,1660,480
14172,b-1_4394-4429_4396.wav,VTTS_b-1_4394-4429_4396.wav,2620,2914,-294
14173,b-4_1301-1400_1343.wav,VTTS_b-4_1301-1400_1343.wav,1990,1985,5
14174,b-3_6116-6215_6195.wav,VTTS_b-3_6116-6215_6195.wav,3350,2810,540
14175,b-2_1597-1698_1598.wav,VTTS_b-2_1597-1698_1598.wav,10200,7535,2665
14176,b-4_1901-2000_1962.wav,VTTS_b-4_1901-2000_1962.wav,7420,6850,570
14177,b-1_4070-4105_4070.wav,VTTS_b-1_4070-4105_4070.wav,2780,2775,5
14178,b-4_1901-2000_1967.wav,VTTS_b-4_1901-2000_1967.wav,6600,7268,-668
14179,b-2_1019-1120_1032.wav,VTTS_b-2_1019-1120_1032.wav,2050,1765,285
14180,b-2_2413-2500_2462.wav,VTTS_b-2_2413-2500_2462.wav,1850,1834,16
14181,b-3_4607-5008_4973.wav,VTTS_b-3_4607-5008_4973.wav,6160,5828,332
14182,b-4_2000-5164_2666.wav,VTTS_b-4_2000-5164_2666.wav,3320,3425,-105
14183,b-1_2018-2118_2074.wav,VTTS_b-1_2018-2118_2074.wav,3610,2775,835
14184,b-1_175-275_203.wav,VTTS_b-1_175-275_203.wav,1510,1207,303
14185,b-4_53-150_62.wav,VTTS_b-4_53-150_62.wav,8910,9381,-471
14186,b-3_4607-5008_4988.wav,VTTS_b-3_4607-5008_4988.wav,5460,6687,-1227
14187,b-3_98-195_192.wav,VTTS_b-3_98-195_192.wav,4340,3762,578
14188,b-2_2311-2412_2356.wav,VTTS_b-2_2311-2412_2356.wav,1530,1486,44
14189,b-4_1601-1706_1682.wav,VTTS_b-4_1601-1706_1682.wav,3010,2682,328
14190,b-2_407-508_496.wav,VTTS_b-2_407-508_496.wav,990,929,61
14191,b-4_2000-5164_2435.wav,VTTS_b-4_2000-5164_2435.wav,1950,1962,-12
14192,b-1_3329-3429_3397.wav,VTTS_b-1_3329-3429_3397.wav,1650,1544,106
14193,b-3_3454-3537_3458.wav,VTTS_b-3_3454-3537_3458.wav,4280,4412,-132
14194,b-3_6401-6500_6472.wav,VTTS_b-3_6401-6500_6472.wav,4350,3634,716
14195,b-3_2267-2349_2327.wav,VTTS_b-3_2267-2349_2327.wav,6700,6664,36
14196,b-2_1223-1324_1281.wav,VTTS_b-2_1223-1324_1281.wav,2900,3367,-467
14197,b-3_501-930_617.wav,VTTS_b-3_501-930_617.wav,2070,2299,-229
14198,b-2_1597-1698_1612.wav,VTTS_b-2_1597-1698_1612.wav,1850,1985,-135
14199,b-3_392-500_479.wav,VTTS_b-3_392-500_479.wav,7130,7581,-451
14200,b-4_2000-5164_3723.wav,VTTS_b-4_2000-5164_3723.wav,1290,987,303
14201,b-2_407-508_492.wav,VTTS_b-2_407-508_492.wav,4400,2914,1486
14202,b-3_1-97_1.wav,VTTS_b-3_1-97_1.wav,8190,8533,-343
14203,b-3_1764-1861_1833.wav,VTTS_b-3_1764-1861_1833.wav,1940,1683,257
14204,b-3_5533-5638_5556.wav,VTTS_b-3_5533-5638_5556.wav,5830,5190,640
14205,b-2_1597-1698_1695.wav,VTTS_b-2_1597-1698_1695.wav,5790,5283,507
14206,b-1_1515-1615_1608.wav,VTTS_b-1_1515-1615_1608.wav,4500,4122,378
14207,b-2_1223-1324_1295.wav,VTTS_b-2_1223-1324_1295.wav,2250,1939,311
14208,b-2_1699-1800_1717.wav,VTTS_b-2_1699-1800_1717.wav,1090,1010,80
14209,b-1_3026-3126_3085.wav,VTTS_b-1_3026-3126_3085.wav,4290,3785,505
14210,b-1_3834-3934_3882.wav,VTTS_b-1_3834-3934_3882.wav,2740,2705,35
14211,b-1_478-578_523.wav,VTTS_b-1_478-578_523.wav,1670,1695,-25
14212,b-3_1568-1665_1654.wav,VTTS_b-3_1568-1665_1654.wav,6210,5968,242
14213,b-1_1818-1918_1864.wav,VTTS_b-1_1818-1918_1864.wav,1540,1533,7
14214,b-1_1818-1918_1887.wav,VTTS_b-1_1818-1918_1887.wav,2030,2020,10
14215,b-3_5009-5427_5029.wav,VTTS_b-3_5009-5427_5029.wav,2580,2775,-195
14216,b-2_713-814_797.wav,VTTS_b-2_713-814_797.wav,4920,4540,380
14217,b-4_151-300_215.wav,VTTS_b-4_151-300_215.wav,6010,6211,-201
14218,b-3_1568-1665_1646.wav,VTTS_b-3_1568-1665_1646.wav,3500,3379,121
14219,b-4_2000-5164_3899.wav,VTTS_b-4_2000-5164_3899.wav,5244,5387,-143
14220,b-3_2524-2854_2764.wav,VTTS_b-3_2524-2854_2764.wav,4360,4145,215
14221,b-3_5009-5427_5293.wav,VTTS_b-3_5009-5427_5293.wav,7080,7047,33
14222,b-1_478-578_532.wav,VTTS_b-1_478-578_532.wav,2040,2322,-282
14223,b-3_2267-2349_2273.wav,VTTS_b-3_2267-2349_2273.wav,7370,7523,-153
14224,b-3_4607-5008_4875.wav,VTTS_b-3_4607-5008_4875.wav,4480,4249,231
14225,b-3_5009-5427_5317.wav,VTTS_b-3_5009-5427_5317.wav,5280,5294,-14
14226,b-3_1-97_2.wav,VTTS_b-3_1-97_2.wav,2050,2043,7
14227,b-4_2000-5164_3718.wav,VTTS_b-4_2000-5164_3718.wav,6520,6107,413
14228,b-3_501-930_712.wav,VTTS_b-3_501-930_712.wav,5690,5166,524
14229,b-1_1010-1110_1095.wav,VTTS_b-1_1010-1110_1095.wav,2960,2380,580
14230,b-2_1563-1596_1589.wav,VTTS_b-2_1563-1596_1589.wav,5940,6339,-399
14231,b-3_6801-6900_6853.wav,VTTS_b-3_6801-6900_6853.wav,3880,4052,-172
14232,b-2_1427-1562_1448.wav,VTTS_b-2_1427-1562_1448.wav,2630,3587,-957
14233,b-2_1-100_30.wav,VTTS_b-2_1-100_30.wav,1400,1649,-249
14234,b-1_2220-2320_2308.wav,VTTS_b-1_2220-2320_2308.wav,1190,1057,133
14235,b-2_2107-2193_2123.wav,VTTS_b-2_2107-2193_2123.wav,4590,4644,-54
14236,b-4_2000-5164_2481.wav,VTTS_b-4_2000-5164_2481.wav,3120,2891,229
14237,b-3_980-1077_1013.wav,VTTS_b-3_980-1077_1013.wav,2880,2937,-57
14238,b-1_3935-4033_3957.wav,VTTS_b-1_3935-4033_3957.wav,2060,2392,-332
14239,b-3_1666-1763_1752.wav,VTTS_b-3_1666-1763_1752.wav,6200,8092,-1892
14240,b-3_3112-3197_3136.wav,VTTS_b-3_3112-3197_3136.wav,4460,4040,420
14241,b-3_2089-2176_2155.wav,VTTS_b-3_2089-2176_2155.wav,8070,10577,-2507
14242,b-3_5533-5638_5602.wav,VTTS_b-3_5533-5638_5602.wav,2650,2566,84
14243,b-3_6116-6215_6181.wav,VTTS_b-3_6116-6215_6181.wav,3370,3796,-426
14244,b-1_2826-2926_2879.wav,VTTS_b-1_2826-2926_2879.wav,1310,1254,56
14245,b-4_501-1014_529.wav,VTTS_b-4_501-1014_529.wav,2350,2009,341
14246,b-4_2000-5164_4885.wav,VTTS_b-4_2000-5164_4885.wav,3510,3251,259
14247,b-4_2000-5164_3726.wav,VTTS_b-4_2000-5164_3726.wav,4780,4934,-154
14248,b-1_794-1009_822.wav,VTTS_b-1_794-1009_822.wav,2170,1649,521
14249,b-4_2000-5164_3791.wav,VTTS_b-4_2000-5164_3791.wav,3170,2810,360
14250,b-4_2000-5164_2794.wav,VTTS_b-4_2000-5164_2794.wav,2865,2868,-3
14251,b-2_1699-1800_1786.wav,VTTS_b-2_1699-1800_1786.wav,3780,3332,448
14252,b-4_1301-1400_1323.wav,VTTS_b-4_1301-1400_1323.wav,4290,4040,250
14253,b-3_2089-2176_2142.wav,VTTS_b-3_2089-2176_2142.wav,5570,8348,-2778
14254,b-1_579-649_613.wav,VTTS_b-1_579-649_613.wav,1130,1149,-19
14255,b-3_1321-1568_1389.wav,VTTS_b-3_1321-1568_1389.wav,4060,3738,322
14256,b-3_6601-6700_6638.wav,VTTS_b-3_6601-6700_6638.wav,2450,2485,-35
14257,b-1_175-275_261.wav,VTTS_b-1_175-275_261.wav,1730,1904,-174
14258,b-3_501-930_899.wav,VTTS_b-3_501-930_899.wav,6800,6188,612
14259,b-4_2000-5164_2776.wav,VTTS_b-4_2000-5164_2776.wav,2150,3053,-903
14260,b-4_2000-5164_2131.wav,VTTS_b-4_2000-5164_2131.wav,2110,1881,229
14261,b-2_1019-1120_1076.wav,VTTS_b-2_1019-1120_1076.wav,1270,1695,-425
14262,b-3_501-930_673.wav,VTTS_b-3_501-930_673.wav,5970,5619,351
14263,b-4_2000-5164_2166.wav,VTTS_b-4_2000-5164_2166.wav,3325,3518,-193
14264,b-3_2855-2942_2884.wav,VTTS_b-3_2855-2942_2884.wav,4830,5178,-348
14265,b-2_713-814_773.wav,VTTS_b-2_713-814_773.wav,4340,3564,776
14266,b-1_1717-1817_1770.wav,VTTS_b-1_1717-1817_1770.wav,1350,1347,3
14267,b-3_2267-2349_2302.wav,VTTS_b-3_2267-2349_2302.wav,2530,2728,-198
14268,b-1_4034-4069_4053.wav,VTTS_b-1_4034-4069_4053.wav,3060,2984,76
14269,b-3_501-930_820.wav,VTTS_b-3_501-930_820.wav,6870,6130,740
14270,b-3_6116-6215_6211.wav,VTTS_b-3_6116-6215_6211.wav,3940,3576,364
14271,b-4_1901-2000_1934.wav,VTTS_b-4_1901-2000_1934.wav,5230,5050,180
14272,b-1_276-376_365.wav,VTTS_b-1_276-376_365.wav,1530,1463,67
14273,b-4_2000-5164_3855.wav,VTTS_b-4_2000-5164_3855.wav,762,743,19
14274,b-4_2000-5164_3483.wav,VTTS_b-4_2000-5164_3483.wav,3531,3367,164
14275,b-4_1221-1300_1257.wav,VTTS_b-4_1221-1300_1257.wav,4980,4389,591
14276,b-1_2018-2118_2042.wav,VTTS_b-1_2018-2118_2042.wav,2050,2229,-179
14277,b-3_2089-2176_2125.wav,VTTS_b-3_2089-2176_2125.wav,8050,8115,-65
14278,b-1_3733-3833_3800.wav,VTTS_b-1_3733-3833_3800.wav,3590,3483,107
14279,b-4_2000-5164_3327.wav,VTTS_b-4_2000-5164_3327.wav,2808,2984,-176
14280,b-3_392-500_481.wav,VTTS_b-3_392-500_481.wav,4750,4272,478
14281,b-3_931-979_952.wav,VTTS_b-3_931-979_952.wav,8320,8626,-306
14282,b-3_4607-5008_4685.wav,VTTS_b-3_4607-5008_4685.wav,4550,4296,254
14283,b-3_2524-2854_2543.wav,VTTS_b-3_2524-2854_2543.wav,3020,2810,210
14284,b-3_4425-4497_4470.wav,VTTS_b-3_4425-4497_4470.wav,7030,5666,1364
14285,b-4_2000-5164_3005.wav,VTTS_b-4_2000-5164_3005.wav,4369,4563,-194
14286,b-4_1707-1813_1784.wav,VTTS_b-4_1707-1813_1784.wav,2400,2357,43
14287,b-2_2107-2193_2147.wav,VTTS_b-2_2107-2193_2147.wav,2620,2833,-213
14288,b-3_6701-6800_6768.wav,VTTS_b-3_6701-6800_6768.wav,2760,2833,-73
14289,b-3_980-1077_984.wav,VTTS_b-3_980-1077_984.wav,5160,5283,-123
14290,b-3_4498-4605_4583.wav,VTTS_b-3_4498-4605_4583.wav,4810,4807,3
14291,b-1_1818-1918_1834.wav,VTTS_b-1_1818-1918_1834.wav,4900,4969,-69
14292,b-3_4315-4424_4394.wav,VTTS_b-3_4315-4424_4394.wav,2540,3100,-560
14293,b-1_1414-1514_1450.wav,VTTS_b-1_1414-1514_1450.wav,4280,4098,182
14294,b-4_2000-5164_3186.wav,VTTS_b-4_2000-5164_3186.wav,5079,5050,29
14295,b-3_5009-5427_5329.wav,VTTS_b-3_5009-5427_5329.wav,2170,2345,-175
14296,b-4_2000-5164_4042.wav,VTTS_b-4_2000-5164_4042.wav,4001,3762,239
14297,b-4_2000-5164_3326.wav,VTTS_b-4_2000-5164_3326.wav,4695,4586,109
14298,b-3_5957-6015_5995.wav,VTTS_b-3_5957-6015_5995.wav,4500,4470,30
14299,b-3_2524-2854_2787.wav,VTTS_b-3_2524-2854_2787.wav,6690,6374,316
14300,b-4_2000-5164_5073.wav,VTTS_b-4_2000-5164_5073.wav,6027,5991,36
14301,b-4_1-52_8.wav,VTTS_b-4_1-52_8.wav,7240,8022,-782
14302,b-1_4070-4105_4096.wav,VTTS_b-1_4070-4105_4096.wav,2820,4214,-1394
14303,b-3_4607-5008_4731.wav,VTTS_b-3_4607-5008_4731.wav,3290,3181,109
14304,b-3_2000-2088_2049.wav,VTTS_b-3_2000-2088_2049.wav,4140,4400,-260
14305,b-2_1121-1222_1200.wav,VTTS_b-2_1121-1222_1200.wav,3280,3947,-667
14306,b-1_2220-2320_2275.wav,VTTS_b-1_2220-2320_2275.wav,1290,1196,94
14307,b-3_3538-3627_3615.wav,VTTS_b-3_3538-3627_3615.wav,3760,3599,161
14308,b-3_6401-6500_6446.wav,VTTS_b-3_6401-6500_6446.wav,5200,4946,254
14309,b-3_4001-4103_4084.wav,VTTS_b-3_4001-4103_4084.wav,7410,7721,-311
14310,b-2_1699-1800_1749.wav,VTTS_b-2_1699-1800_1749.wav,2230,2554,-324
14311,b-1_4070-4105_4104.wav,VTTS_b-1_4070-4105_4104.wav,4170,4331,-161
14312,b-4_501-1014_981.wav,VTTS_b-4_501-1014_981.wav,8090,9938,-1848
14313,b-4_1221-1300_1248.wav,VTTS_b-4_1221-1300_1248.wav,3370,3413,-43
14314,b-3_1-97_97.wav,VTTS_b-3_1-97_97.wav,7750,7094,656
14315,b-3_4001-4103_4104.wav,VTTS_b-3_4001-4103_4104.wav,4120,4145,-25
14316,b-4_2000-5164_2233.wav,VTTS_b-4_2000-5164_2233.wav,1795,1741,54
14317,b-3_4001-4103_4077.wav,VTTS_b-3_4001-4103_4077.wav,3570,3773,-203
14318,b-3_5745-5852_5828.wav,VTTS_b-3_5745-5852_5828.wav,1930,1800,130
14319,b-4_2000-5164_4101.wav,VTTS_b-4_2000-5164_4101.wav,2248,2090,158
14320,b-1_3935-4033_4010.wav,VTTS_b-1_3935-4033_4010.wav,1580,1579,1
14321,b-1_2321-2421_2383.wav,VTTS_b-1_2321-2421_2383.wav,5130,5468,-338
14322,b-2_2209-2310_2266.wav,VTTS_b-2_2209-2310_2266.wav,3450,2786,664
14323,b-3_4425-4497_4491.wav,VTTS_b-3_4425-4497_4491.wav,7430,7755,-325
14324,b-4_2000-5164_3258.wav,VTTS_b-4_2000-5164_3258.wav,3564,6525,-2961
14325,b-1_4214-4285_4264.wav,VTTS_b-1_4214-4285_4264.wav,5130,6095,-965
14326,b-3_3279-3363_3306.wav,VTTS_b-3_3279-3363_3306.wav,2950,2589,361
14327,b-3_98-195_156.wav,VTTS_b-3_98-195_156.wav,5050,5399,-349
14328,b-3_4607-5008_4802.wav,VTTS_b-3_4607-5008_4802.wav,7370,6327,1043
14329,b-3_4607-5008_4666.wav,VTTS_b-3_4607-5008_4666.wav,4190,4145,45
14330,b-1_3935-4033_3936.wav,VTTS_b-1_3935-4033_3936.wav,3500,3437,63
14331,b-3_3628-3714_3697.wav,VTTS_b-3_3628-3714_3697.wav,10120,10867,-747
14332,b-4_2000-5164_2263.wav,VTTS_b-4_2000-5164_2263.wav,4460,5039,-579
14333,b-1_4358-4393_4370.wav,VTTS_b-1_4358-4393_4370.wav,3060,3913,-853
14334,b-1_579-649_635.wav,VTTS_b-1_579-649_635.wav,2600,2148,452
14335,b-4_2000-5164_4562.wav,VTTS_b-4_2000-5164_4562.wav,3628,2728,900
14336,b-4_1221-1300_1230.wav,VTTS_b-4_1221-1300_1230.wav,4320,4551,-231
14337,b-2_917-1018_928.wav,VTTS_b-2_917-1018_928.wav,1360,1498,-138
14338,b-3_5533-5638_5533.wav,VTTS_b-3_5533-5638_5533.wav,4610,4795,-185
14339,b-3_5745-5852_5764.wav,VTTS_b-3_5745-5852_5764.wav,4570,4644,-74
14340,b-4_2000-5164_3196.wav,VTTS_b-4_2000-5164_3196.wav,1673,1637,36
14341,b-2_509-610_549.wav,VTTS_b-2_509-610_549.wav,1930,1579,351
14342,b-4_2000-5164_4594.wav,VTTS_b-4_2000-5164_4594.wav,14062,11610,2452
14343,b-3_6301-6400_6304.wav,VTTS_b-3_6301-6400_6304.wav,4500,4365,135
14344,b-4_2000-5164_3873.wav,VTTS_b-4_2000-5164_3873.wav,5249,5944,-695
14345,b-1_3228-3328_3315.wav,VTTS_b-1_3228-3328_3315.wav,880,894,-14
14346,b-1_4214-4285_4219.wav,VTTS_b-1_4214-4285_4219.wav,3860,4180,-320
14347,b-2_1-100_12.wav,VTTS_b-2_1-100_12.wav,2310,4911,-2601
14348,b-2_1-100_84.wav,VTTS_b-2_1-100_84.wav,2870,2345,525
14349,b-1_74-174_82.wav,VTTS_b-1_74-174_82.wav,870,998,-128
14350,b-4_501-1014_800.wav,VTTS_b-4_501-1014_800.wav,3050,2937,113
14351,b-4_501-1014_758.wav,VTTS_b-4_501-1014_758.wav,5240,4447,793
14352,b-3_6900-7016_6913.wav,VTTS_b-3_6900-7016_6913.wav,9520,9451,69
14353,b-4_1814-1900_1891.wav,VTTS_b-4_1814-1900_1891.wav,5750,4795,955
14354,b-4_2000-5164_4728.wav,VTTS_b-4_2000-5164_4728.wav,5265,4923,342
14355,b-4_2000-5164_2576.wav,VTTS_b-4_2000-5164_2576.wav,5100,4714,386
14356,b-4_2000-5164_4857.wav,VTTS_b-4_2000-5164_4857.wav,7785,7779,6
14357,b-3_196-293_269.wav,VTTS_b-3_196-293_269.wav,4290,3831,459
14358,b-2_1903-2038_2015.wav,VTTS_b-2_1903-2038_2015.wav,2250,2101,149
14359,b-3_1079-1320_1212.wav,VTTS_b-3_1079-1320_1212.wav,7250,6711,539
14360,b-3_5009-5427_5302.wav,VTTS_b-3_5009-5427_5302.wav,5030,4087,943
14361,b-3_5428-5533_5511.wav,VTTS_b-3_5428-5533_5511.wav,4850,4795,55
14362,b-4_2000-5164_3100.wav,VTTS_b-4_2000-5164_3100.wav,3330,3007,323
14363,b-1_4214-4285_4271.wav,VTTS_b-1_4214-4285_4271.wav,2940,3460,-520
14364,b-3_6301-6400_6339.wav,VTTS_b-3_6301-6400_6339.wav,2750,2775,-25
14365,b-3_4607-5008_4845.wav,VTTS_b-3_4607-5008_4845.wav,3240,3413,-173
14366,b-4_2000-5164_2534.wav,VTTS_b-4_2000-5164_2534.wav,7810,8173,-363
14367,b-4_2000-5164_3750.wav,VTTS_b-4_2000-5164_3750.wav,2900,2763,137
14368,b-1_2018-2118_2094.wav,VTTS_b-1_2018-2118_2094.wav,1160,1149,11
14369,b-4_151-300_174.wav,VTTS_b-4_151-300_174.wav,1730,1741,-11
14370,b-3_4425-4497_4466.wav,VTTS_b-3_4425-4497_4466.wav,8180,7663,517
14371,b-2_1019-1120_1093.wav,VTTS_b-2_1019-1120_1093.wav,1540,1474,66
14372,b-2_1223-1324_1248.wav,VTTS_b-2_1223-1324_1248.wav,4710,5132,-422
14373,b-4_2000-5164_5083.wav,VTTS_b-4_2000-5164_5083.wav,3972,3831,141
14374,b-3_2350-2433_2395.wav,VTTS_b-3_2350-2433_2395.wav,8100,8464,-364
14375,b-1_3127-3227_3214.wav,VTTS_b-1_3127-3227_3214.wav,1230,1231,-1
14376,b-1_2119-2219_2154.wav,VTTS_b-1_2119-2219_2154.wav,1420,1533,-113
14377,b-2_917-1018_963.wav,VTTS_b-2_917-1018_963.wav,1830,1753,77
14378,b-2_917-1018_947.wav,VTTS_b-2_917-1018_947.wav,2490,2868,-378
14379,b-1_2826-2926_2912.wav,VTTS_b-1_2826-2926_2912.wav,2610,2810,-200
14380,b-1_1313-1413_1364.wav,VTTS_b-1_1313-1413_1364.wav,3110,2752,358
14381,b-3_1079-1320_1300.wav,VTTS_b-3_1079-1320_1300.wav,5800,6026,-226
14382,b-3_6900-7016_6983.wav,VTTS_b-3_6900-7016_6983.wav,2030,1753,277
14383,b-3_5009-5427_5430.wav,VTTS_b-3_5009-5427_5430.wav,3340,3135,205
14384,b-4_501-1014_722.wav,VTTS_b-4_501-1014_722.wav,5320,5561,-241
14385,b-3_6801-6900_6804.wav,VTTS_b-3_6801-6900_6804.wav,3610,3123,487
14386,b-4_501-1014_558.wav,VTTS_b-4_501-1014_558.wav,3050,4853,-1803
14387,b-4_501-1014_839.wav,VTTS_b-4_501-1014_839.wav,6930,8034,-1104
14388,b-3_5533-5638_5624.wav,VTTS_b-3_5533-5638_5624.wav,3130,3193,-63
14389,b-4_2000-5164_4884.wav,VTTS_b-4_2000-5164_4884.wav,3042,2868,174
14390,b-2_101-202_141.wav,VTTS_b-2_101-202_141.wav,990,987,3
14391,b-2_2413-2500_2454.wav,VTTS_b-2_2413-2500_2454.wav,2040,2775,-735
14392,b-3_2089-2176_2107.wav,VTTS_b-3_2089-2176_2107.wav,5750,6049,-299
14393,b-4_2000-5164_3533.wav,VTTS_b-4_2000-5164_3533.wav,7864,8034,-170
14394,b-1_579-649_636.wav,VTTS_b-1_579-649_636.wav,2050,1916,134
14395,b-3_196-293_265.wav,VTTS_b-3_196-293_265.wav,5720,6606,-886
14396,b-1_3329-3429_3415.wav,VTTS_b-1_3329-3429_3415.wav,2000,2368,-368
14397,b-3_5957-6015_5967.wav,VTTS_b-3_5957-6015_5967.wav,9000,9091,-91
14398,b-2_1019-1120_1019.wav,VTTS_b-2_1019-1120_1019.wav,2230,3030,-800
14399,b-2_2209-2310_2271.wav,VTTS_b-2_2209-2310_2271.wav,2140,2345,-205
14400,b-1_1717-1817_1812.wav,VTTS_b-1_1717-1817_1812.wav,3290,3448,-158
14401,b-1_1111-1211_1215.wav,VTTS_b-1_1111-1211_1215.wav,3120,3111,9
14402,b-1_1414-1514_1516.wav,VTTS_b-1_1414-1514_1516.wav,3420,2531,889
14403,b-4_2000-5164_4836.wav,VTTS_b-4_2000-5164_4836.wav,2753,2287,466
14404,b-4_2000-5164_3607.wav,VTTS_b-4_2000-5164_3607.wav,2980,3634,-654
14405,b-3_6301-6400_6313.wav,VTTS_b-3_6301-6400_6313.wav,4430,4052,378
14406,b-4_501-1014_706.wav,VTTS_b-4_501-1014_706.wav,4050,3773,277
14407,b-3_6016-6115_6092.wav,VTTS_b-3_6016-6115_6092.wav,5520,5364,156
14408,b-1_2220-2320_2283.wav,VTTS_b-1_2220-2320_2283.wav,2620,3785,-1165
14409,b-2_1427-1562_1471.wav,VTTS_b-2_1427-1562_1471.wav,1740,1602,138
14410,b-4_2000-5164_2445.wav,VTTS_b-4_2000-5164_2445.wav,2370,2496,-126
14411,b-1_74-174_85.wav,VTTS_b-1_74-174_85.wav,1840,1416,424
14412,b-1_2624-2724_2708.wav,VTTS_b-1_2624-2724_2708.wav,1120,1126,-6
14413,b-1_175-275_236.wav,VTTS_b-1_175-275_236.wav,2570,2763,-193
14414,b-1_2927-3025_2929.wav,VTTS_b-1_2927-3025_2929.wav,2540,2531,9
14415,b-3_501-930_918.wav,VTTS_b-3_501-930_918.wav,4550,4354,196
14416,b-4_2000-5164_4491.wav,VTTS_b-4_2000-5164_4491.wav,4796,5445,-649
14417,b-2_2040-2072_2040.wav,VTTS_b-2_2040-2072_2040.wav,1120,987,133
14418,b-2_2413-2500_2419.wav,VTTS_b-2_2413-2500_2419.wav,1750,1974,-224
14419,b-3_501-930_628.wav,VTTS_b-3_501-930_628.wav,6950,7163,-213
14420,b-3_4104-4206_4132.wav,VTTS_b-3_4104-4206_4132.wav,6540,6258,282
14421,b-3_5745-5852_5812.wav,VTTS_b-3_5745-5852_5812.wav,3020,3181,-161
14422,b-3_2434-2523_2484.wav,VTTS_b-3_2434-2523_2484.wav,7310,6536,774
14423,b-3_6116-6215_6171.wav,VTTS_b-3_6116-6215_6171.wav,3320,3204,116
14424,b-3_2089-2176_2174.wav,VTTS_b-3_2089-2176_2174.wav,4510,3785,725
14425,b-1_3834-3934_3884.wav,VTTS_b-1_3834-3934_3884.wav,1890,1741,149
14426,b-4_2000-5164_3423.wav,VTTS_b-4_2000-5164_3423.wav,7462,7848,-386
14427,b-4_2000-5164_4972.wav,VTTS_b-4_2000-5164_4972.wav,5524,3913,1611
14428,b-1_794-1009_923.wav,VTTS_b-1_794-1009_923.wav,1590,2171,-581
14429,b-1_794-1009_960.wav,VTTS_b-1_794-1009_960.wav,2970,2949,21
14430,b-3_6900-7016_6978.wav,VTTS_b-3_6900-7016_6978.wav,2320,2101,219
14431,b-3_5009-5427_5046.wav,VTTS_b-3_5009-5427_5046.wav,2860,2961,-101
14432,b-4_301-400_344.wav,VTTS_b-4_301-400_344.wav,11780,11610,170
14433,b-3_501-930_736.wav,VTTS_b-3_501-930_736.wav,8060,7628,432
14434,b-1_4178-4213_4180.wav,VTTS_b-1_4178-4213_4180.wav,2190,2543,-353
14435,b-3_3803-3888_3820.wav,VTTS_b-3_3803-3888_3820.wav,5350,5074,276
14436,b-1_1212-1312_1263.wav,VTTS_b-1_1212-1312_1263.wav,5220,4574,646
14437,b-4_2000-5164_2702.wav,VTTS_b-4_2000-5164_2702.wav,5460,5341,119
14438,b-1_2018-2118_2084.wav,VTTS_b-1_2018-2118_2084.wav,2740,4331,-1591
14439,b-3_3803-3888_3846.wav,VTTS_b-3_3803-3888_3846.wav,5530,4783,747
14440,b-1_2321-2421_2401.wav,VTTS_b-1_2321-2421_2401.wav,3220,2624,596
14441,b-2_2040-2072_2044.wav,VTTS_b-2_2040-2072_2044.wav,1360,1660,-300
14442,b-2_1597-1698_1682.wav,VTTS_b-2_1597-1698_1682.wav,2380,1800,580
14443,b-1_579-649_641.wav,VTTS_b-1_579-649_641.wav,1780,1834,-54
14444,b-1_3531-3631_3544.wav,VTTS_b-1_3531-3631_3544.wav,2170,2206,-36
14445,b-3_6900-7016_6917.wav,VTTS_b-3_6900-7016_6917.wav,6860,7825,-965
14446,b-4_1901-2000_1908.wav,VTTS_b-4_1901-2000_1908.wav,6670,5515,1155
14447,b-1_579-649_603.wav,VTTS_b-1_579-649_603.wav,4640,4052,588
14448,b-4_2000-5164_5106.wav,VTTS_b-4_2000-5164_5106.wav,2801,3228,-427
14449,b-4_1-52_14.wav,VTTS_b-4_1-52_14.wav,8650,9648,-998
14450,b-1_2422-2522_2457.wav,VTTS_b-1_2422-2522_2457.wav,1500,1486,14
14451,b-3_4607-5008_4725.wav,VTTS_b-3_4607-5008_4725.wav,5430,5480,-50
14452,b-3_3538-3627_3572.wav,VTTS_b-3_3538-3627_3572.wav,4280,4296,-16
14453,b-2_101-202_196.wav,VTTS_b-2_101-202_196.wav,1490,1289,201
14454,b-3_3025-3111_3028.wav,VTTS_b-3_3025-3111_3028.wav,2990,2786,204
14455,b-4_2000-5164_4389.wav,VTTS_b-4_2000-5164_4389.wav,3177,4133,-956
14456,b-3_2943-3024_2957.wav,VTTS_b-3_2943-3024_2957.wav,6700,7570,-870
14457,b-4_2000-5164_2883.wav,VTTS_b-4_2000-5164_2883.wav,7615,7454,161
14458,b-3_4607-5008_4834.wav,VTTS_b-3_4607-5008_4834.wav,2730,4214,-1484
14459,b-3_2350-2433_2420.wav,VTTS_b-3_2350-2433_2420.wav,3680,11610,-7930
14460,b-3_4001-4103_4066.wav,VTTS_b-3_4001-4103_4066.wav,3260,3437,-177
14461,b-1_3329-3429_3374.wav,VTTS_b-1_3329-3429_3374.wav,4290,3390,900
14462,b-4_2000-5164_3824.wav,VTTS_b-4_2000-5164_3824.wav,3184,3181,3
14463,b-4_2000-5164_2755.wav,VTTS_b-4_2000-5164_2755.wav,4995,5956,-961
14464,b-1_3228-3328_3247.wav,VTTS_b-1_3228-3328_3247.wav,1480,1416,64
14465,b-4_2000-5164_3773.wav,VTTS_b-4_2000-5164_3773.wav,3860,3924,-64
14466,b-4_2000-5164_3778.wav,VTTS_b-4_2000-5164_3778.wav,6970,7744,-774
14467,b-4_2000-5164_2086.wav,VTTS_b-4_2000-5164_2086.wav,1425,1393,32
14468,b-4_2000-5164_2070.wav,VTTS_b-4_2000-5164_2070.wav,7085,8371,-1286
14469,b-1_2321-2421_2372.wav,VTTS_b-1_2321-2421_2372.wav,1840,2183,-343
14470,b-3_501-930_536.wav,VTTS_b-3_501-930_536.wav,3880,3669,211
14471,b-4_1221-1300_1269.wav,VTTS_b-4_1221-1300_1269.wav,5520,4807,713
14472,b-2_2073-2106_2104.wav,VTTS_b-2_2073-2106_2104.wav,5500,6374,-874
14473,b-3_501-930_661.wav,VTTS_b-3_501-930_661.wav,6820,6734,86
14474,b-4_1601-1706_1664.wav,VTTS_b-4_1601-1706_1664.wav,5930,5817,113
14475,b-3_2943-3024_2985.wav,VTTS_b-3_2943-3024_2985.wav,3990,4005,-15
14476,b-1_2523-2623_2623.wav,VTTS_b-1_2523-2623_2623.wav,1770,1788,-18
14477,b-3_3538-3627_3588.wav,VTTS_b-3_3538-3627_3588.wav,3450,3413,37
14478,b-2_2107-2193_2113.wav,VTTS_b-2_2107-2193_2113.wav,1500,1509,-9
14479,b-3_5009-5427_5043.wav,VTTS_b-3_5009-5427_5043.wav,5210,5039,171
14480,b-1_1414-1514_1478.wav,VTTS_b-1_1414-1514_1478.wav,2980,3030,-50
14481,b-4_2000-5164_4984.wav,VTTS_b-4_2000-5164_4984.wav,8135,8313,-178
14482,b-3_1321-1568_1544.wav,VTTS_b-3_1321-1568_1544.wav,6200,6281,-81
14483,b-1_579-649_621.wav,VTTS_b-1_579-649_621.wav,1340,1091,249
14484,b-3_5009-5427_5199.wav,VTTS_b-3_5009-5427_5199.wav,3470,3204,266
14485,b-4_2000-5164_4193.wav,VTTS_b-4_2000-5164_4193.wav,1060,917,143
14486,b-3_2524-2854_2678.wav,VTTS_b-3_2524-2854_2678.wav,5280,4807,473
14487,b-3_980-1077_1056.wav,VTTS_b-3_980-1077_1056.wav,7760,7570,190
14488,b-4_2000-5164_2428.wav,VTTS_b-4_2000-5164_2428.wav,6620,6803,-183
14489,b-4_501-1014_741.wav,VTTS_b-4_501-1014_741.wav,5280,6803,-1523
14490,b-3_6217-6274_6258.wav,VTTS_b-3_6217-6274_6258.wav,6780,7140,-360
14491,b-4_501-1014_739.wav,VTTS_b-4_501-1014_739.wav,2670,2612,58
14492,b-3_4607-5008_4717.wav,VTTS_b-3_4607-5008_4717.wav,3530,3692,-162
14493,b-3_3025-3111_3107.wav,VTTS_b-3_3025-3111_3107.wav,5630,4586,1044
14494,b-2_1325-1426_1393.wav,VTTS_b-2_1325-1426_1393.wav,1810,1579,231
14495,b-4_2000-5164_3131.wav,VTTS_b-4_2000-5164_3131.wav,3524,3251,273
14496,b-2_2107-2193_2121.wav,VTTS_b-2_2107-2193_2121.wav,4110,3518,592
14497,b-4_2000-5164_2766.wav,VTTS_b-4_2000-5164_2766.wav,4745,4040,705
14498,b-3_1764-1861_1837.wav,VTTS_b-3_1764-1861_1837.wav,3540,4644,-1104
14499,b-4_2000-5164_2926.wav,VTTS_b-4_2000-5164_2926.wav,6373,6188,185
14500,b-4_2000-5164_2698.wav,VTTS_b-4_2000-5164_2698.wav,8395,10948,-2553
14501,b-1_2826-2926_2858.wav,VTTS_b-1_2826-2926_2858.wav,4960,4783,177
14502,b-3_4607-5008_4899.wav,VTTS_b-3_4607-5008_4899.wav,8880,8359,521
14503,b-3_3889-4000_3949.wav,VTTS_b-3_3889-4000_3949.wav,4450,5097,-647
14504,b-3_6016-6115_6038.wav,VTTS_b-3_6016-6115_6038.wav,5200,4725,475
14505,b-1_3228-3328_3279.wav,VTTS_b-1_3228-3328_3279.wav,2970,3019,-49
14506,b-3_294-391_334.wav,VTTS_b-3_294-391_334.wav,6470,6641,-171
14507,b-3_1-97_80.wav,VTTS_b-3_1-97_80.wav,7780,7500,280
14508,b-3_2267-2349_2301.wav,VTTS_b-3_2267-2349_2301.wav,4450,4528,-78
14509,b-1_1111-1211_1194.wav,VTTS_b-1_1111-1211_1194.wav,4140,3657,483
14510,b-4_2000-5164_3653.wav,VTTS_b-4_2000-5164_3653.wav,5282,6676,-1394
14511,b-1_2220-2320_2240.wav,VTTS_b-1_2220-2320_2240.wav,1840,1939,-99
14512,b-3_3628-3714_3696.wav,VTTS_b-3_3628-3714_3696.wav,6610,6896,-286
14513,b-4_2000-5164_4779.wav,VTTS_b-4_2000-5164_4779.wav,2872,2821,51
14514,b-3_6801-6900_6891.wav,VTTS_b-3_6801-6900_6891.wav,7590,7349,241
14515,b-4_1101-1220_1178.wav,VTTS_b-4_1101-1220_1178.wav,3870,3111,759
14516,b-3_2434-2523_2495.wav,VTTS_b-3_2434-2523_2495.wav,3120,3065,55
14517,b-3_5745-5852_5793.wav,VTTS_b-3_5745-5852_5793.wav,4380,4249,131
14518,b-4_53-150_111.wav,VTTS_b-4_53-150_111.wav,9730,9300,430
14519,b-1_1212-1312_1305.wav,VTTS_b-1_1212-1312_1305.wav,1740,1474,266
14520,b-2_2413-2500_2439.wav,VTTS_b-2_2413-2500_2439.wav,5210,11610,-6400
14521,b-4_401-500_490.wav,VTTS_b-4_401-500_490.wav,3290,3297,-7
14522,b-3_5009-5427_5086.wav,VTTS_b-3_5009-5427_5086.wav,10340,11610,-1270
14523,b-3_2524-2854_2603.wav,VTTS_b-3_2524-2854_2603.wav,2220,2171,49
14524,b-3_3198-3278_3258.wav,VTTS_b-3_3198-3278_3258.wav,3980,3448,532
14525,b-1_3329-3429_3400.wav,VTTS_b-1_3329-3429_3400.wav,2160,2183,-23
14526,b-3_3454-3537_3471.wav,VTTS_b-3_3454-3537_3471.wav,10570,9276,1294
14527,b-1_2725-2825_2762.wav,VTTS_b-1_2725-2825_2762.wav,3570,3135,435
14528,b-1_1515-1615_1538.wav,VTTS_b-1_1515-1615_1538.wav,1530,1533,-3
14529,b-3_1666-1763_1754.wav,VTTS_b-3_1666-1763_1754.wav,2620,2635,-15
14530,b-1_4322-4357_4344.wav,VTTS_b-1_4322-4357_4344.wav,4610,7419,-2809
14531,b-1_1515-1615_1557.wav,VTTS_b-1_1515-1615_1557.wav,1250,1312,-62
14532,b-2_1019-1120_1086.wav,VTTS_b-2_1019-1120_1086.wav,1320,1219,101
14533,b-4_2000-5164_5097.wav,VTTS_b-4_2000-5164_5097.wav,13491,11610,1881
14534,b-2_2194-2208_2200.wav,VTTS_b-2_2194-2208_2200.wav,2500,2612,-112
14535,b-3_6501-6600_6510.wav,VTTS_b-3_6501-6600_6510.wav,4700,4505,195
14536,b-2_1427-1562_1549.wav,VTTS_b-2_1427-1562_1549.wav,2640,3030,-390
14537,b-1_1010-1110_1044.wav,VTTS_b-1_1010-1110_1044.wav,1000,998,2
14538,b-2_203-304_240.wav,VTTS_b-2_203-304_240.wav,1850,1788,62
14539,b-2_917-1018_997.wav,VTTS_b-2_917-1018_997.wav,780,685,95
14540,b-3_2855-2942_2885.wav,VTTS_b-3_2855-2942_2885.wav,3920,4481,-561
14541,b-4_2000-5164_4803.wav,VTTS_b-4_2000-5164_4803.wav,4420,3262,1158
14542,b-3_1-97_10.wav,VTTS_b-3_1-97_10.wav,5370,5700,-330
14543,b-1_686-793_742.wav,VTTS_b-1_686-793_742.wav,2850,3866,-1016
14544,b-1_3430-3530_3509.wav,VTTS_b-1_3430-3530_3509.wav,2100,1916,184
14545,b-3_2524-2854_2530.wav,VTTS_b-3_2524-2854_2530.wav,3050,2902,148
14546,b-1_3228-3328_3239.wav,VTTS_b-1_3228-3328_3239.wav,2600,2914,-314
14547,b-4_2000-5164_4791.wav,VTTS_b-4_2000-5164_4791.wav,6242,5898,344
14548,b-3_4207-4314_4267.wav,VTTS_b-3_4207-4314_4267.wav,6660,6269,391
14549,b-2_2194-2208_2206.wav,VTTS_b-2_2194-2208_2206.wav,1440,1149,291
14550,b-4_1814-1900_1852.wav,VTTS_b-4_1814-1900_1852.wav,2470,3239,-769
14551,b-4_1601-1706_1615.wav,VTTS_b-4_1601-1706_1615.wav,4460,4063,397
14552,b-4_2000-5164_4787.wav,VTTS_b-4_2000-5164_4787.wav,5410,5062,348
14553,b-3_3112-3197_3121.wav,VTTS_b-3_3112-3197_3121.wav,2840,3286,-446
14554,b-3_5009-5427_5227.wav,VTTS_b-3_5009-5427_5227.wav,3640,3738,-98
14555,b-3_4498-4605_4585.wav,VTTS_b-3_4498-4605_4585.wav,4470,4423,47
14556,b-4_2000-5164_4830.wav,VTTS_b-4_2000-5164_4830.wav,4311,6235,-1924
14557,b-4_1101-1220_1171.wav,VTTS_b-4_1101-1220_1171.wav,4000,6641,-2641
14558,b-4_501-1014_854.wav,VTTS_b-4_501-1014_854.wav,6380,5654,726
14559,b-2_1699-1800_1702.wav,VTTS_b-2_1699-1800_1702.wav,3960,4342,-382
14560,b-3_6116-6215_6119.wav,VTTS_b-3_6116-6215_6119.wav,3440,4853,-1413
14561,b-1_377-477_476.wav,VTTS_b-1_377-477_476.wav,1330,2345,-1015
14562,b-3_4104-4206_4170.wav,VTTS_b-3_4104-4206_4170.wav,2010,1834,176
14563,b-4_2000-5164_5100.wav,VTTS_b-4_2000-5164_5100.wav,6154,6374,-220
14564,b-2_1019-1120_1036.wav,VTTS_b-2_1019-1120_1036.wav,2780,3320,-540
14565,b-3_98-195_172.wav,VTTS_b-3_98-195_172.wav,5460,5155,305
14566,b-2_611-712_693.wav,VTTS_b-2_611-712_693.wav,3280,3924,-644
14567,b-1_175-275_233.wav,VTTS_b-1_175-275_233.wav,2320,2229,91
14568,b-2_2107-2193_2139.wav,VTTS_b-2_2107-2193_2139.wav,2970,2763,207
14569,b-1_3127-3227_3187.wav,VTTS_b-1_3127-3227_3187.wav,4420,4540,-120
14570,b-3_5009-5427_5110.wav,VTTS_b-3_5009-5427_5110.wav,3330,3158,172
14571,b-3_2524-2854_2846.wav,VTTS_b-3_2524-2854_2846.wav,4420,4795,-375
14572,b-1_3026-3126_3110.wav,VTTS_b-1_3026-3126_3110.wav,3560,3228,332
14573,b-3_501-930_879.wav,VTTS_b-3_501-930_879.wav,5820,5956,-136
14574,b-3_3454-3537_3459.wav,VTTS_b-3_3454-3537_3459.wav,6280,7152,-872
14575,b-4_1014-1100_1053.wav,VTTS_b-4_1014-1100_1053.wav,3420,3390,30
14576,b-1_74-174_88.wav,VTTS_b-1_74-174_88.wav,1170,1068,102
14577,b-3_5745-5852_5841.wav,VTTS_b-3_5745-5852_5841.wav,3240,3750,-510
14578,b-3_5009-5427_5406.wav,VTTS_b-3_5009-5427_5406.wav,3390,4551,-1161
14579,b-1_377-477_455.wav,VTTS_b-1_377-477_455.wav,2680,3193,-513
14580,b-2_1597-1698_1669.wav,VTTS_b-2_1597-1698_1669.wav,1710,2078,-368
14581,b-4_2000-5164_2880.wav,VTTS_b-4_2000-5164_2880.wav,6195,5747,448
14582,b-2_101-202_158.wav,VTTS_b-2_101-202_158.wav,1110,952,158
14583,b-3_2350-2433_2355.wav,VTTS_b-3_2350-2433_2355.wav,3600,3448,152
14584,b-3_5009-5427_5067.wav,VTTS_b-3_5009-5427_5067.wav,4660,4760,-100
14585,b-4_2000-5164_3918.wav,VTTS_b-4_2000-5164_3918.wav,4832,5608,-776
14586,b-2_713-814_760.wav,VTTS_b-2_713-814_760.wav,3510,3344,166
14587,b-2_1597-1698_1690.wav,VTTS_b-2_1597-1698_1690.wav,2930,3100,-170
14588,b-3_3538-3627_3609.wav,VTTS_b-3_3538-3627_3609.wav,7100,6745,355
14589,b-1_1010-1110_1107.wav,VTTS_b-1_1010-1110_1107.wav,1930,1927,3
14590,b-3_1079-1320_1128.wav,VTTS_b-3_1079-1320_1128.wav,5570,4981,589
14591,b-1_1-73_19.wav,VTTS_b-1_1-73_19.wav,2680,4272,-1592
14592,b-4_1221-1300_1258.wav,VTTS_b-4_1221-1300_1258.wav,1360,1382,-22
14593,b-1_175-275_180.wav,VTTS_b-1_175-275_180.wav,1760,1776,-16
14594,b-3_501-930_729.wav,VTTS_b-3_501-930_729.wav,2490,2566,-76
14595,b-3_2000-2088_2031.wav,VTTS_b-3_2000-2088_2031.wav,5310,5190,120
14596,b-1_1717-1817_1731.wav,VTTS_b-1_1717-1817_1731.wav,3900,4865,-965
14597,b-4_1601-1706_1683.wav,VTTS_b-4_1601-1706_1683.wav,3730,3773,-43
14598,b-4_2000-5164_4981.wav,VTTS_b-4_2000-5164_4981.wav,1993,1823,170
14599,b-3_2524-2854_2813.wav,VTTS_b-3_2524-2854_2813.wav,5440,7860,-2420
14600,b-4_301-400_373.wav,VTTS_b-4_301-400_373.wav,6220,11610,-5390
14601,b-3_5009-5427_5240.wav,VTTS_b-3_5009-5427_5240.wav,3110,2914,196
14602,b-1_3127-3227_3224.wav,VTTS_b-1_3127-3227_3224.wav,3950,3611,339
14603,b-3_6401-6500_6433.wav,VTTS_b-3_6401-6500_6433.wav,3630,3889,-259
14604,b-3_5533-5638_5597.wav,VTTS_b-3_5533-5638_5597.wav,3920,3913,7
14605,b-4_2000-5164_2519.wav,VTTS_b-4_2000-5164_2519.wav,2810,2670,140
14606,b-3_2089-2176_2154.wav,VTTS_b-3_2089-2176_2154.wav,5940,5561,379
14607,b-4_501-1014_750.wav,VTTS_b-4_501-1014_750.wav,2420,2125,295
14608,b-4_2000-5164_4459.wav,VTTS_b-4_2000-5164_4459.wav,3009,3634,-625
14609,b-2_1597-1698_1685.wav,VTTS_b-2_1597-1698_1685.wav,5210,5155,55
14610,b-1_4286-4321_4301.wav,VTTS_b-1_4286-4321_4301.wav,2780,3495,-715
14611,b-3_980-1077_996.wav,VTTS_b-3_980-1077_996.wav,2140,2020,120
14612,b-1_1313-1413_1409.wav,VTTS_b-1_1313-1413_1409.wav,2350,2485,-135
14613,b-3_5428-5533_5430.wav,VTTS_b-3_5428-5533_5430.wav,4080,4296,-216
14614,b-2_1223-1324_1245.wav,VTTS_b-2_1223-1324_1245.wav,1290,1533,-243
14615,b-3_6217-6274_6268.wav,VTTS_b-3_6217-6274_6268.wav,4500,4272,228
14616,b-1_1414-1514_1492.wav,VTTS_b-1_1414-1514_1492.wav,3410,8568,-5158
14617,b-1_4394-4429_4420.wav,VTTS_b-1_4394-4429_4420.wav,1840,1939,-99
14618,b-3_2943-3024_3002.wav,VTTS_b-3_2943-3024_3002.wav,5230,4783,447
14619,b-4_1101-1220_1205.wav,VTTS_b-4_1101-1220_1205.wav,4310,4191,119
14620,b-3_4425-4497_4481.wav,VTTS_b-3_4425-4497_4481.wav,3700,4447,-747
14621,b-2_713-814_721.wav,VTTS_b-2_713-814_721.wav,1970,2055,-85
14622,b-4_2000-5164_4160.wav,VTTS_b-4_2000-5164_4160.wav,3801,6664,-2863
14623,b-4_501-1014_971.wav,VTTS_b-4_501-1014_971.wav,3950,5782,-1832
14624,b-4_2000-5164_3150.wav,VTTS_b-4_2000-5164_3150.wav,3748,4830,-1082
14625,b-4_2000-5164_2663.wav,VTTS_b-4_2000-5164_2663.wav,1540,1614,-74
14626,b-3_3279-3363_3353.wav,VTTS_b-3_3279-3363_3353.wav,9190,8673,517
14627,b-1_794-1009_989.wav,VTTS_b-1_794-1009_989.wav,1600,1382,218
14628,b-1_4394-4429_4428.wav,VTTS_b-1_4394-4429_4428.wav,1950,2635,-685
14629,b-4_2000-5164_3389.wav,VTTS_b-4_2000-5164_3389.wav,2950,2972,-22
14630,b-4_2000-5164_3188.wav,VTTS_b-4_2000-5164_3188.wav,2325,2055,270
14631,b-2_203-304_239.wav,VTTS_b-2_203-304_239.wav,1970,2043,-73
14632,b-1_2927-3025_2964.wav,VTTS_b-1_2927-3025_2964.wav,3380,4029,-649
14633,b-4_501-1014_756.wav,VTTS_b-4_501-1014_756.wav,4870,4110,760
14634,b-3_2434-2523_2493.wav,VTTS_b-3_2434-2523_2493.wav,4920,4632,288
14635,b-3_392-500_497.wav,VTTS_b-3_392-500_497.wav,7480,11610,-4130
14636,b-3_392-500_446.wav,VTTS_b-3_392-500_446.wav,4020,3576,444
14637,b-4_1814-1900_1896.wav,VTTS_b-4_1814-1900_1896.wav,3650,4957,-1307
14638,b-4_2000-5164_3458.wav,VTTS_b-4_2000-5164_3458.wav,5150,5596,-446
14639,b-3_1321-1568_1358.wav,VTTS_b-3_1321-1568_1358.wav,3720,3158,562
14640,b-4_501-1014_726.wav,VTTS_b-4_501-1014_726.wav,6580,5851,729
14641,b-3_1764-1861_1765.wav,VTTS_b-3_1764-1861_1765.wav,6360,5492,868
14642,b-4_501-1014_719.wav,VTTS_b-4_501-1014_719.wav,6100,4911,1189
14643,b-3_4104-4206_4203.wav,VTTS_b-3_4104-4206_4203.wav,5820,4296,1524
14644,b-1_2624-2724_2700.wav,VTTS_b-1_2624-2724_2700.wav,2790,2601,189
14645,b-4_2000-5164_2969.wav,VTTS_b-4_2000-5164_2969.wav,6713,7976,-1263
14646,b-3_6116-6215_6145.wav,VTTS_b-3_6116-6215_6145.wav,3420,3553,-133
14647,b-3_3889-4000_3911.wav,VTTS_b-3_3889-4000_3911.wav,4990,4923,67
14648,b-4_2000-5164_4130.wav,VTTS_b-4_2000-5164_4130.wav,3410,3796,-386
14649,b-3_1079-1320_1263.wav,VTTS_b-3_1079-1320_1263.wav,10830,10937,-107
14650,b-3_501-930_653.wav,VTTS_b-3_501-930_653.wav,4680,4598,82
14651,b-3_6301-6400_6380.wav,VTTS_b-3_6301-6400_6380.wav,4870,4238,632
14652,b-1_2422-2522_2473.wav,VTTS_b-1_2422-2522_2473.wav,3240,3843,-603
14653,b-3_6601-6700_6669.wav,VTTS_b-3_6601-6700_6669.wav,2930,2914,16
14654,b-3_5428-5533_5515.wav,VTTS_b-3_5428-5533_5515.wav,6950,6966,-16
14655,b-1_1818-1918_1873.wav,VTTS_b-1_1818-1918_1873.wav,1380,1370,10
14656,b-4_1506-1600_1538.wav,VTTS_b-4_1506-1600_1538.wav,3180,2891,289
14657,b-3_501-930_813.wav,VTTS_b-3_501-930_813.wav,5940,4714,1226
14658,b-3_5428-5533_5471.wav,VTTS_b-3_5428-5533_5471.wav,3830,3506,324
14659,b-1_478-578_515.wav,VTTS_b-1_478-578_515.wav,2320,2113,207
14660,b-2_2413-2500_2474.wav,VTTS_b-2_2413-2500_2474.wav,2370,3669,-1299
14661,b-3_3112-3197_3158.wav,VTTS_b-3_3112-3197_3158.wav,10410,11598,-1188
14662,b-4_2000-5164_4785.wav,VTTS_b-4_2000-5164_4785.wav,1789,1649,140
14663,b-3_5639-5744_5690.wav,VTTS_b-3_5639-5744_5690.wav,7310,6571,739
14664,b-4_2000-5164_4340.wav,VTTS_b-4_2000-5164_4340.wav,2445,2577,-132
14665,b-1_2624-2724_2672.wav,VTTS_b-1_2624-2724_2672.wav,1510,2879,-1369
14666,b-2_101-202_188.wav,VTTS_b-2_101-202_188.wav,2800,2961,-161
14667,b-1_1515-1615_1558.wav,VTTS_b-1_1515-1615_1558.wav,4850,4296,554
14668,b-3_5009-5427_5184.wav,VTTS_b-3_5009-5427_5184.wav,2600,2589,11
14669,b-3_501-930_556.wav,VTTS_b-3_501-930_556.wav,4020,4238,-218
14670,b-3_3279-3363_3325.wav,VTTS_b-3_3279-3363_3325.wav,2520,2450,70
14671,b-3_392-500_395.wav,VTTS_b-3_392-500_395.wav,6460,6432,28
14672,b-3_4207-4314_4251.wav,VTTS_b-3_4207-4314_4251.wav,5130,4772,358
14673,b-4_1301-1400_1339.wav,VTTS_b-4_1301-1400_1339.wav,5720,5654,66
14674,b-4_501-1014_796.wav,VTTS_b-4_501-1014_796.wav,2820,2740,80
14675,b-3_1568-1665_1568.wav,VTTS_b-3_1568-1665_1568.wav,5940,5793,147
14676,b-2_1223-1324_1232.wav,VTTS_b-2_1223-1324_1232.wav,2310,4122,-1812
14677,b-4_2000-5164_5062.wav,VTTS_b-4_2000-5164_5062.wav,7609,8301,-692
14678,b-2_1699-1800_1798.wav,VTTS_b-2_1699-1800_1798.wav,2340,2183,157
14679,b-4_2000-5164_4295.wav,VTTS_b-4_2000-5164_4295.wav,5848,6258,-410
14680,b-1_1313-1413_1322.wav,VTTS_b-1_1313-1413_1322.wav,5410,4957,453
14681,b-4_1506-1600_1599.wav,VTTS_b-4_1506-1600_1599.wav,9300,10797,-1497
14682,b-2_1427-1562_1557.wav,VTTS_b-2_1427-1562_1557.wav,2570,2995,-425
14683,b-4_501-1014_693.wav,VTTS_b-4_501-1014_693.wav,1650,1637,13
14684,b-3_1666-1763_1745.wav,VTTS_b-3_1666-1763_1745.wav,3900,4505,-605
14685,b-1_3733-3833_3824.wav,VTTS_b-1_3733-3833_3824.wav,5720,6409,-689
14686,b-3_196-293_211.wav,VTTS_b-3_196-293_211.wav,9450,8173,1277
14687,b-3_294-391_378.wav,VTTS_b-3_294-391_378.wav,7470,7802,-332
14688,b-2_815-916_902.wav,VTTS_b-2_815-916_902.wav,2580,3030,-450
14689,b-4_501-1014_935.wav,VTTS_b-4_501-1014_935.wav,4760,3738,1022
14690,b-1_478-578_565.wav,VTTS_b-1_478-578_565.wav,2240,2067,173
14691,b-1_2624-2724_2724.wav,VTTS_b-1_2624-2724_2724.wav,1430,1393,37
14692,b-3_4207-4314_4219.wav,VTTS_b-3_4207-4314_4219.wav,5940,5851,89
14693,b-3_6116-6215_6169.wav,VTTS_b-3_6116-6215_6169.wav,4680,5526,-846
14694,b-3_3198-3278_3216.wav,VTTS_b-3_3198-3278_3216.wav,5200,4783,417
14695,b-3_501-930_924.wav,VTTS_b-3_501-930_924.wav,4440,3889,551
14696,b-3_2524-2854_2613.wav,VTTS_b-3_2524-2854_2613.wav,2590,2798,-208
14697,b-2_1801-1902_1843.wav,VTTS_b-2_1801-1902_1843.wav,4110,3553,557
14698,b-3_5009-5427_5176.wav,VTTS_b-3_5009-5427_5176.wav,4000,3750,250
14699,b-2_1121-1222_1169.wav,VTTS_b-2_1121-1222_1169.wav,3590,5735,-2145
14700,b-4_2000-5164_2910.wav,VTTS_b-4_2000-5164_2910.wav,7584,8115,-531
14701,b-4_1401-1505_1473.wav,VTTS_b-4_1401-1505_1473.wav,10130,9578,552
14702,b-3_3715-3802_3749.wav,VTTS_b-3_3715-3802_3749.wav,5120,4690,430
14703,b-3_6701-6800_6766.wav,VTTS_b-3_6701-6800_6766.wav,5570,8022,-2452
14704,b-3_1862-1959_1949.wav,VTTS_b-3_1862-1959_1949.wav,5490,5573,-83
14705,b-1_1313-1413_1385.wav,VTTS_b-1_1313-1413_1385.wav,3650,3959,-309
14706,b-3_6301-6400_6375.wav,VTTS_b-3_6301-6400_6375.wav,5440,5828,-388
14707,b-4_2000-5164_2971.wav,VTTS_b-4_2000-5164_2971.wav,4207,4226,-19
14708,b-3_5428-5533_5441.wav,VTTS_b-3_5428-5533_5441.wav,5670,5480,190
14709,b-3_1960-2000_1970.wav,VTTS_b-3_1960-2000_1970.wav,7560,7349,211
14710,b-3_4001-4103_4031.wav,VTTS_b-3_4001-4103_4031.wav,5720,5445,275
14711,b-4_501-1014_733.wav,VTTS_b-4_501-1014_733.wav,3940,3100,840
14712,b-3_2350-2433_2359.wav,VTTS_b-3_2350-2433_2359.wav,5170,5503,-333
14713,b-3_1764-1861_1853.wav,VTTS_b-3_1764-1861_1853.wav,6190,5329,861
14714,b-1_1515-1615_1583.wav,VTTS_b-1_1515-1615_1583.wav,3820,3901,-81
14715,b-1_478-578_562.wav,VTTS_b-1_478-578_562.wav,950,801,149
14716,b-3_5533-5638_5545.wav,VTTS_b-3_5533-5638_5545.wav,4030,3913,117
14717,b-3_2000-2088_2041.wav,VTTS_b-3_2000-2088_2041.wav,6350,6420,-70
14718,b-1_794-1009_889.wav,VTTS_b-1_794-1009_889.wav,4340,4772,-432
14719,b-3_6301-6400_6301.wav,VTTS_b-3_6301-6400_6301.wav,2100,1869,231
14720,b-3_1960-2000_1964.wav,VTTS_b-3_1960-2000_1964.wav,3370,3646,-276
14721,b-1_3228-3328_3275.wav,VTTS_b-1_3228-3328_3275.wav,1750,1718,32
14722,b-1_1212-1312_1215.wav,VTTS_b-1_1212-1312_1215.wav,2410,2183,227
14723,b-1_3127-3227_3186.wav,VTTS_b-1_3127-3227_3186.wav,1330,1335,-5
14724,b-2_1903-2038_1909.wav,VTTS_b-2_1903-2038_1909.wav,2000,1916,84
14725,b-3_4607-5008_4682.wav,VTTS_b-3_4607-5008_4682.wav,4100,4122,-22
14726,b-4_2000-5164_3553.wav,VTTS_b-4_2000-5164_3553.wav,5963,5666,297
14727,b-4_1506-1600_1508.wav,VTTS_b-4_1506-1600_1508.wav,4860,4307,553
14728,b-1_3127-3227_3178.wav,VTTS_b-1_3127-3227_3178.wav,1590,1091,499
14729,b-2_203-304_276.wav,VTTS_b-2_203-304_276.wav,1640,1939,-299
14730,b-2_1699-1800_1774.wav,VTTS_b-2_1699-1800_1774.wav,4080,3971,109
14731,b-3_5009-5427_5217.wav,VTTS_b-3_5009-5427_5217.wav,3970,3692,278
14732,b-4_2000-5164_2018.wav,VTTS_b-4_2000-5164_2018.wav,1480,1649,-169
14733,b-1_4214-4285_4279.wav,VTTS_b-1_4214-4285_4279.wav,4830,5259,-429
14734,b-4_2000-5164_5060.wav,VTTS_b-4_2000-5164_5060.wav,4630,4226,404
14735,b-3_1321-1568_1431.wav,VTTS_b-3_1321-1568_1431.wav,3410,3390,20
14736,b-4_2000-5164_2293.wav,VTTS_b-4_2000-5164_2293.wav,8760,7860,900
14737,b-1_2220-2320_2228.wav,VTTS_b-1_2220-2320_2228.wav,1830,1533,297
14738,b-4_1014-1100_1062.wav,VTTS_b-4_1014-1100_1062.wav,5750,5584,166
14739,b-3_1862-1959_1951.wav,VTTS_b-3_1862-1959_1951.wav,8040,7651,389
14740,b-1_579-649_598.wav,VTTS_b-1_579-649_598.wav,1930,1997,-67
14741,b-4_2000-5164_3532.wav,VTTS_b-4_2000-5164_3532.wav,3036,2972,64
14742,b-3_2943-3024_2965.wav,VTTS_b-3_2943-3024_2965.wav,5490,5631,-141
14743,b-1_2422-2522_2443.wav,VTTS_b-1_2422-2522_2443.wav,3680,3262,418
14744,b-1_3733-3833_3752.wav,VTTS_b-1_3733-3833_3752.wav,3970,3738,232
14745,b-4_1014-1100_1067.wav,VTTS_b-4_1014-1100_1067.wav,1750,1649,101
14746,b-3_98-195_122.wav,VTTS_b-3_98-195_122.wav,8230,9276,-1046
14747,b-1_1919-2017_2008.wav,VTTS_b-1_1919-2017_2008.wav,1490,1393,97
14748,b-4_2000-5164_4572.wav,VTTS_b-4_2000-5164_4572.wav,5178,5259,-81
14749,b-3_2524-2854_2829.wav,VTTS_b-3_2524-2854_2829.wav,3780,3529,251
14750,b-4_501-1014_636.wav,VTTS_b-4_501-1014_636.wav,7920,7117,803
14751,b-3_1764-1861_1821.wav,VTTS_b-3_1764-1861_1821.wav,1410,1126,284
14752,b-3_4001-4103_4006.wav,VTTS_b-3_4001-4103_4006.wav,9880,9741,139
14753,b-4_2000-5164_4772.wav,VTTS_b-4_2000-5164_4772.wav,3360,11610,-8250
14754,b-4_2000-5164_3310.wav,VTTS_b-4_2000-5164_3310.wav,1943,1776,167
14755,b-3_6801-6900_6877.wav,VTTS_b-3_6801-6900_6877.wav,3300,2624,676
14756,b-4_2000-5164_3225.wav,VTTS_b-4_2000-5164_3225.wav,4924,5085,-161
14757,b-3_1764-1861_1770.wav,VTTS_b-3_1764-1861_1770.wav,4000,4481,-481
14758,b-1_4430-4465_4445.wav,VTTS_b-1_4430-4465_4445.wav,1840,1765,75
14759,b-4_1101-1220_1213.wav,VTTS_b-4_1101-1220_1213.wav,2270,1753,517
14760,b-3_501-930_904.wav,VTTS_b-3_501-930_904.wav,7640,6943,697
14761,b-1_3430-3530_3432.wav,VTTS_b-1_3430-3530_3432.wav,1320,1393,-73
14762,b-4_1901-2000_1926.wav,VTTS_b-4_1901-2000_1926.wav,10290,9416,874
14763,b-4_2000-5164_4848.wav,VTTS_b-4_2000-5164_4848.wav,1266,1115,151
14764,b-2_917-1018_946.wav,VTTS_b-2_917-1018_946.wav,2040,1974,66
14765,b-4_2000-5164_2031.wav,VTTS_b-4_2000-5164_2031.wav,1260,1509,-249
14766,b-1_794-1009_937.wav,VTTS_b-1_794-1009_937.wav,2090,2113,-23
14767,b-4_1101-1220_1177.wav,VTTS_b-4_1101-1220_1177.wav,3270,3193,77
14768,b-1_794-1009_904.wav,VTTS_b-1_794-1009_904.wav,4010,4540,-530
14769,b-1_2725-2825_2744.wav,VTTS_b-1_2725-2825_2744.wav,1840,1683,157
14770,b-4_501-1014_602.wav,VTTS_b-4_501-1014_602.wav,3150,3123,27
14771,b-1_377-477_447.wav,VTTS_b-1_377-477_447.wav,4480,4899,-419
14772,b-3_6701-6800_6738.wav,VTTS_b-3_6701-6800_6738.wav,5010,4934,76
14773,b-4_501-1014_583.wav,VTTS_b-4_501-1014_583.wav,8740,8371,369
14774,b-3_2524-2854_2847.wav,VTTS_b-3_2524-2854_2847.wav,5180,4957,223
14775,b-3_2350-2433_2407.wav,VTTS_b-3_2350-2433_2407.wav,4050,3587,463
14776,b-1_4322-4357_4349.wav,VTTS_b-1_4322-4357_4349.wav,2520,2426,94
14777,b-1_1212-1312_1213.wav,VTTS_b-1_1212-1312_1213.wav,1790,2833,-1043
14778,b-4_501-1014_555.wav,VTTS_b-4_501-1014_555.wav,1360,1196,164
14779,b-2_1325-1426_1408.wav,VTTS_b-2_1325-1426_1408.wav,3590,5538,-1948
14780,b-3_1321-1568_1510.wav,VTTS_b-3_1321-1568_1510.wav,3440,3111,329
14781,b-3_1321-1568_1536.wav,VTTS_b-3_1321-1568_1536.wav,3390,2879,511
14782,b-4_2000-5164_3555.wav,VTTS_b-4_2000-5164_3555.wav,4858,5944,-1086
14783,b-3_4607-5008_4720.wav,VTTS_b-3_4607-5008_4720.wav,6040,6455,-415
14784,b-3_4607-5008_4640.wav,VTTS_b-3_4607-5008_4640.wav,1400,1231,169
14785,b-2_713-814_810.wav,VTTS_b-2_713-814_810.wav,2820,2473,347
14786,b-4_501-1014_565.wav,VTTS_b-4_501-1014_565.wav,6480,7059,-579
14787,b-1_1313-1413_1394.wav,VTTS_b-1_1313-1413_1394.wav,1450,1347,103
14788,b-1_377-477_409.wav,VTTS_b-1_377-477_409.wav,3220,3042,178
14789,b-1_1414-1514_1456.wav,VTTS_b-1_1414-1514_1456.wav,2190,2635,-445
14790,b-3_2855-2942_2890.wav,VTTS_b-3_2855-2942_2890.wav,3950,4063,-113
14791,b-3_1321-1568_1397.wav,VTTS_b-3_1321-1568_1397.wav,5430,5735,-305
14792,b-3_5639-5744_5734.wav,VTTS_b-3_5639-5744_5734.wav,3070,3065,5
14793,b-3_3025-3111_3035.wav,VTTS_b-3_3025-3111_3035.wav,3610,3390,220
14794,b-1_2220-2320_2252.wav,VTTS_b-1_2220-2320_2252.wav,1780,1695,85
14795,b-1_3127-3227_3200.wav,VTTS_b-1_3127-3227_3200.wav,2340,2206,134
14796,b-2_2413-2500_2473.wav,VTTS_b-2_2413-2500_2473.wav,1490,1451,39
14797,b-4_401-500_431.wav,VTTS_b-4_401-500_431.wav,4500,5190,-690
14798,b-4_501-1014_846.wav,VTTS_b-4_501-1014_846.wav,4770,4656,114
14799,b-1_3632-3732_3731.wav,VTTS_b-1_3632-3732_3731.wav,1420,1416,4
14800,b-3_4607-5008_4647.wav,VTTS_b-3_4607-5008_4647.wav,3360,3077,283
14801,b-3_1321-1568_1339.wav,VTTS_b-3_1321-1568_1339.wav,13770,11610,2160
14802,b-2_1699-1800_1723.wav,VTTS_b-2_1699-1800_1723.wav,3100,3007,93
14803,b-3_2177-2266_2245.wav,VTTS_b-3_2177-2266_2245.wav,4950,4818,132
14804,b-1_478-578_489.wav,VTTS_b-1_478-578_489.wav,2970,2833,137
14805,b-3_2855-2942_2879.wav,VTTS_b-3_2855-2942_2879.wav,3070,3274,-204
14806,b-3_3628-3714_3662.wav,VTTS_b-3_3628-3714_3662.wav,5650,4934,716
14807,b-4_1301-1400_1396.wav,VTTS_b-4_1301-1400_1396.wav,2740,2276,464
14808,b-3_5745-5852_5773.wav,VTTS_b-3_5745-5852_5773.wav,2820,2728,92
14809,b-4_2000-5164_3390.wav,VTTS_b-4_2000-5164_3390.wav,3377,3367,10
14810,b-4_2000-5164_4226.wav,VTTS_b-4_2000-5164_4226.wav,3468,3564,-96
14811,b-1_478-578_517.wav,VTTS_b-1_478-578_517.wav,1790,2334,-544
14812,b-3_196-293_203.wav,VTTS_b-3_196-293_203.wav,1850,1776,74
14813,b-2_2311-2412_2354.wav,VTTS_b-2_2311-2412_2354.wav,1620,1776,-156
14814,b-1_2725-2825_2790.wav,VTTS_b-1_2725-2825_2790.wav,1890,1765,125
14815,b-3_501-930_827.wav,VTTS_b-3_501-930_827.wav,8200,8742,-542
14816,b-1_1212-1312_1307.wav,VTTS_b-1_1212-1312_1307.wav,2900,2717,183
14817,b-2_1801-1902_1828.wav,VTTS_b-2_1801-1902_1828.wav,3740,3541,199
14818,b-3_5745-5852_5797.wav,VTTS_b-3_5745-5852_5797.wav,3610,3529,81
14819,b-3_4607-5008_4664.wav,VTTS_b-3_4607-5008_4664.wav,1750,1660,90
14820,b-3_5009-5427_5285.wav,VTTS_b-3_5009-5427_5285.wav,810,778,32
14821,b-2_1563-1596_1567.wav,VTTS_b-2_1563-1596_1567.wav,3360,3332,28
14822,b-4_2000-5164_4196.wav,VTTS_b-4_2000-5164_4196.wav,3680,4029,-349
14823,b-1_4214-4285_4274.wav,VTTS_b-1_4214-4285_4274.wav,3700,4876,-1176
14824,b-3_5009-5427_5080.wav,VTTS_b-3_5009-5427_5080.wav,7570,7140,430
14825,b-4_1601-1706_1675.wav,VTTS_b-4_1601-1706_1675.wav,4470,6107,-1637
14826,b-2_1427-1562_1498.wav,VTTS_b-2_1427-1562_1498.wav,3310,3286,24
14827,b-3_5639-5744_5662.wav,VTTS_b-3_5639-5744_5662.wav,3600,3379,221
14828,b-1_3834-3934_3851.wav,VTTS_b-1_3834-3934_3851.wav,1870,1776,94
14829,b-4_2000-5164_2478.wav,VTTS_b-4_2000-5164_2478.wav,1830,1846,-16
14830,b-1_3228-3328_3277.wav,VTTS_b-1_3228-3328_3277.wav,5580,5770,-190
14831,b-1_579-649_579.wav,VTTS_b-1_579-649_579.wav,1320,1277,43
14832,b-1_377-477_400.wav,VTTS_b-1_377-477_400.wav,4120,5642,-1522
14833,b-3_3628-3714_3653.wav,VTTS_b-3_3628-3714_3653.wav,2850,2891,-41
14834,b-3_5957-6015_5957.wav,VTTS_b-3_5957-6015_5957.wav,5240,4238,1002
14835,b-3_1-97_40.wav,VTTS_b-3_1-97_40.wav,3040,3019,21
14836,b-4_2000-5164_2094.wav,VTTS_b-4_2000-5164_2094.wav,2780,2752,28
14837,b-1_2826-2926_2826.wav,VTTS_b-1_2826-2926_2826.wav,940,952,-12
14838,b-3_2177-2266_2186.wav,VTTS_b-3_2177-2266_2186.wav,3750,3344,406
14839,b-3_5428-5533_5456.wav,VTTS_b-3_5428-5533_5456.wav,4680,5921,-1241
14840,b-4_53-150_55.wav,VTTS_b-4_53-150_55.wav,9530,8139,1391
14841,b-1_4142-4177_4168.wav,VTTS_b-1_4142-4177_4168.wav,2130,2566,-436
14842,b-3_980-1077_1066.wav,VTTS_b-3_980-1077_1066.wav,8680,7245,1435
14843,b-2_1699-1800_1720.wav,VTTS_b-2_1699-1800_1720.wav,5570,5027,543
14844,b-3_3803-3888_3838.wav,VTTS_b-3_3803-3888_3838.wav,4410,4841,-431
14845,b-1_2018-2118_2061.wav,VTTS_b-1_2018-2118_2061.wav,1270,1312,-42
14846,b-3_5533-5638_5590.wav,VTTS_b-3_5533-5638_5590.wav,3390,3704,-314
14847,b-3_2943-3024_2988.wav,VTTS_b-3_2943-3024_2988.wav,5410,4911,499
14848,b-3_98-195_127.wav,VTTS_b-3_98-195_127.wav,5690,5956,-266
14849,b-3_5428-5533_5531.wav,VTTS_b-3_5428-5533_5531.wav,4670,5201,-531
14850,b-1_175-275_184.wav,VTTS_b-1_175-275_184.wav,2000,2415,-415
14851,b-1_794-1009_861.wav,VTTS_b-1_794-1009_861.wav,1560,1741,-181
14852,b-3_6116-6215_6191.wav,VTTS_b-3_6116-6215_6191.wav,7120,6896,224
14853,b-4_2000-5164_5009.wav,VTTS_b-4_2000-5164_5009.wav,3016,2670,346
14854,b-3_3803-3888_3889.wav,VTTS_b-3_3803-3888_3889.wav,5260,5840,-580
14855,b-3_6301-6400_6367.wav,VTTS_b-3_6301-6400_6367.wav,5880,5863,17
14856,b-4_2000-5164_3404.wav,VTTS_b-4_2000-5164_3404.wav,2286,3007,-721
14857,b-1_2826-2926_2838.wav,VTTS_b-1_2826-2926_2838.wav,900,1045,-145
14858,b-3_2267-2349_2298.wav,VTTS_b-3_2267-2349_2298.wav,4050,3762,288
14859,b-1_794-1009_816.wav,VTTS_b-1_794-1009_816.wav,1580,1567,13
14860,b-4_2000-5164_3907.wav,VTTS_b-4_2000-5164_3907.wav,7565,7419,146
14861,b-2_917-1018_1003.wav,VTTS_b-2_917-1018_1003.wav,3420,2902,518
14862,b-1_1212-1312_1310.wav,VTTS_b-1_1212-1312_1310.wav,2210,2067,143
14863,b-3_1862-1959_1920.wav,VTTS_b-3_1862-1959_1920.wav,5040,4783,257
14864,b-1_3834-3934_3901.wav,VTTS_b-1_3834-3934_3901.wav,1680,2635,-955
14865,b-3_3715-3802_3731.wav,VTTS_b-3_3715-3802_3731.wav,2400,2635,-235
14866,b-2_917-1018_918.wav,VTTS_b-2_917-1018_918.wav,2170,2345,-175
14867,b-4_2000-5164_2654.wav,VTTS_b-4_2000-5164_2654.wav,2640,2310,330
14868,b-4_2000-5164_2784.wav,VTTS_b-4_2000-5164_2784.wav,1470,1080,390
14869,b-4_2000-5164_5117.wav,VTTS_b-4_2000-5164_5117.wav,4280,3843,437
14870,b-3_5533-5638_5587.wav,VTTS_b-3_5533-5638_5587.wav,7180,6734,446
14871,b-2_1597-1698_1666.wav,VTTS_b-2_1597-1698_1666.wav,3360,2415,945
14872,b-3_3025-3111_3039.wav,VTTS_b-3_3025-3111_3039.wav,3880,3448,432
14873,b-4_2000-5164_4365.wav,VTTS_b-4_2000-5164_4365.wav,7029,7187,-158
14874,b-1_4286-4321_4300.wav,VTTS_b-1_4286-4321_4300.wav,2240,2136,104
14875,b-2_1699-1800_1763.wav,VTTS_b-2_1699-1800_1763.wav,2730,3529,-799
14876,b-3_4607-5008_4761.wav,VTTS_b-3_4607-5008_4761.wav,4780,4621,159
14877,b-2_203-304_248.wav,VTTS_b-2_203-304_248.wav,3870,3913,-43
14878,b-1_3127-3227_3222.wav,VTTS_b-1_3127-3227_3222.wav,3410,3181,229
14879,b-2_2209-2310_2229.wav,VTTS_b-2_2209-2310_2229.wav,1830,1614,216
14880,b-1_1313-1413_1347.wav,VTTS_b-1_1313-1413_1347.wav,1020,1010,10
14881,b-4_401-500_413.wav,VTTS_b-4_401-500_413.wav,11310,10507,803
14882,b-1_1818-1918_1918.wav,VTTS_b-1_1818-1918_1918.wav,2670,2798,-128
14883,b-4_501-1014_616.wav,VTTS_b-4_501-1014_616.wav,4070,3669,401
14884,b-3_98-195_145.wav,VTTS_b-3_98-195_145.wav,2810,2705,105
14885,b-3_1862-1959_1868.wav,VTTS_b-3_1862-1959_1868.wav,7150,7407,-257
14886,b-4_2000-5164_4150.wav,VTTS_b-4_2000-5164_4150.wav,5428,5561,-133
14887,b-4_2000-5164_2777.wav,VTTS_b-4_2000-5164_2777.wav,5200,5074,126
14888,b-2_203-304_226.wav,VTTS_b-2_203-304_226.wav,3590,4098,-508
14889,b-4_2000-5164_4171.wav,VTTS_b-4_2000-5164_4171.wav,9772,10728,-956
14890,b-3_5009-5427_5218.wav,VTTS_b-3_5009-5427_5218.wav,5200,4783,417
14891,b-4_1814-1900_1822.wav,VTTS_b-4_1814-1900_1822.wav,3930,4087,-157
14892,b-1_3026-3126_3047.wav,VTTS_b-1_3026-3126_3047.wav,3750,3808,-58
14893,b-3_1079-1320_1218.wav,VTTS_b-3_1079-1320_1218.wav,5980,5584,396
14894,b-1_1212-1312_1228.wav,VTTS_b-1_1212-1312_1228.wav,1380,1254,126
14895,b-1_650-685_659.wav,VTTS_b-1_650-685_659.wav,1520,1440,80
14896,b-4_2000-5164_2740.wav,VTTS_b-4_2000-5164_2740.wav,1870,1788,82
14897,b-4_1221-1300_1275.wav,VTTS_b-4_1221-1300_1275.wav,3080,3495,-415
14898,b-3_1-97_46.wav,VTTS_b-3_1-97_46.wav,7480,6815,665
14899,b-1_2927-3025_2995.wav,VTTS_b-1_2927-3025_2995.wav,2660,3170,-510
14900,b-2_1325-1426_1348.wav,VTTS_b-2_1325-1426_1348.wav,8650,10844,-2194
14901,b-1_3935-4033_3964.wav,VTTS_b-1_3935-4033_3964.wav,1270,1254,16
14902,b-4_2000-5164_3627.wav,VTTS_b-4_2000-5164_3627.wav,3387,3390,-3
14903,b-4_1601-1706_1601.wav,VTTS_b-4_1601-1706_1601.wav,3710,4005,-295
14904,b-3_4607-5008_4690.wav,VTTS_b-3_4607-5008_4690.wav,8770,8301,469
14905,b-1_3733-3833_3803.wav,VTTS_b-1_3733-3833_3803.wav,2050,1950,100
14906,b-4_1221-1300_1279.wav,VTTS_b-4_1221-1300_1279.wav,3900,3866,34
14907,b-4_151-300_227.wav,VTTS_b-4_151-300_227.wav,4510,4389,121
14908,b-3_3715-3802_3784.wav,VTTS_b-3_3715-3802_3784.wav,8310,7419,891
14909,b-4_1101-1220_1149.wav,VTTS_b-4_1101-1220_1149.wav,10700,10054,646
14910,b-4_2000-5164_4469.wav,VTTS_b-4_2000-5164_4469.wav,7221,8406,-1185
14911,b-3_2943-3024_2945.wav,VTTS_b-3_2943-3024_2945.wav,3580,4052,-472
14912,b-2_1903-2038_1924.wav,VTTS_b-2_1903-2038_1924.wav,1840,1800,40
14913,b-4_501-1014_937.wav,VTTS_b-4_501-1014_937.wav,3810,4760,-950
14914,b-1_3026-3126_3056.wav,VTTS_b-1_3026-3126_3056.wav,2510,4226,-1716
14915,b-3_2855-2942_2880.wav,VTTS_b-3_2855-2942_2880.wav,4890,4702,188
14916,b-1_3834-3934_3898.wav,VTTS_b-1_3834-3934_3898.wav,1390,1324,66
14917,b-3_6116-6215_6213.wav,VTTS_b-3_6116-6215_6213.wav,2870,2961,-91
14918,b-1_2927-3025_3012.wav,VTTS_b-1_2927-3025_3012.wav,1810,1811,-1
14919,b-3_4104-4206_4162.wav,VTTS_b-3_4104-4206_4162.wav,3240,4098,-858
14920,b-1_2523-2623_2551.wav,VTTS_b-1_2523-2623_2551.wav,2090,1892,198
14921,b-1_3834-3934_3932.wav,VTTS_b-1_3834-3934_3932.wav,1180,1115,65
14922,b-2_1427-1562_1502.wav,VTTS_b-2_1427-1562_1502.wav,2440,3390,-950
14923,b-4_501-1014_816.wav,VTTS_b-4_501-1014_816.wav,15180,11610,3570
14924,b-2_713-814_759.wav,VTTS_b-2_713-814_759.wav,2570,2218,352
14925,b-3_3803-3888_3827.wav,VTTS_b-3_3803-3888_3827.wav,5420,5155,265
14926,b-3_6401-6500_6439.wav,VTTS_b-3_6401-6500_6439.wav,5000,4992,8
14927,b-4_2000-5164_3757.wav,VTTS_b-4_2000-5164_3757.wav,3330,3309,21
14928,b-4_2000-5164_2510.wav,VTTS_b-4_2000-5164_2510.wav,4680,4795,-115
14929,b-3_294-391_328.wav,VTTS_b-3_294-391_328.wav,6250,5770,480
14930,b-4_501-1014_549.wav,VTTS_b-4_501-1014_549.wav,7740,7314,426
14931,b-3_501-930_548.wav,VTTS_b-3_501-930_548.wav,3040,2879,161
14932,b-3_294-391_327.wav,VTTS_b-3_294-391_327.wav,3570,3715,-145
14933,b-3_980-1077_1032.wav,VTTS_b-3_980-1077_1032.wav,4100,4191,-91
14934,b-1_686-793_718.wav,VTTS_b-1_686-793_718.wav,2560,2287,273
14935,b-2_1121-1222_1173.wav,VTTS_b-2_1121-1222_1173.wav,2300,2403,-103
14936,b-3_501-930_630.wav,VTTS_b-3_501-930_630.wav,5770,4865,905
14937,b-3_1666-1763_1694.wav,VTTS_b-3_1666-1763_1694.wav,8130,7152,978
14938,b-1_2826-2926_2875.wav,VTTS_b-1_2826-2926_2875.wav,4900,8870,-3970
14939,b-1_2725-2825_2800.wav,VTTS_b-1_2725-2825_2800.wav,3180,3042,138
14940,b-4_1101-1220_1209.wav,VTTS_b-4_1101-1220_1209.wav,1680,1637,43
14941,b-1_1010-1110_1091.wav,VTTS_b-1_1010-1110_1091.wav,2940,2659,281
14942,b-1_74-174_129.wav,VTTS_b-1_74-174_129.wav,1370,1509,-139
14943,b-4_2000-5164_2890.wav,VTTS_b-4_2000-5164_2890.wav,1140,1091,49
14944,b-3_2943-3024_2952.wav,VTTS_b-3_2943-3024_2952.wav,3140,2833,307
14945,b-1_4214-4285_4276.wav,VTTS_b-1_4214-4285_4276.wav,2020,1997,23
14946,b-4_2000-5164_2041.wav,VTTS_b-4_2000-5164_2041.wav,3440,3866,-426
14947,b-3_1568-1665_1632.wav,VTTS_b-3_1568-1665_1632.wav,3910,4005,-95
14948,b-3_501-930_799.wav,VTTS_b-3_501-930_799.wav,3510,3274,236
14949,b-3_2943-3024_2981.wav,VTTS_b-3_2943-3024_2981.wav,4850,5759,-909
14950,b-3_5853-5956_5940.wav,VTTS_b-3_5853-5956_5940.wav,2390,2055,335
14951,b-3_1079-1320_1159.wav,VTTS_b-3_1079-1320_1159.wav,5440,5387,53
14952,b-3_3025-3111_3055.wav,VTTS_b-3_3025-3111_3055.wav,5790,6153,-363
14953,b-2_1597-1698_1642.wav,VTTS_b-2_1597-1698_1642.wav,2010,2043,-33
14954,b-2_305-406_340.wav,VTTS_b-2_305-406_340.wav,3310,3262,48
14955,b-4_2000-5164_3608.wav,VTTS_b-4_2000-5164_3608.wav,3241,3100,141
14956,b-1_4394-4429_4418.wav,VTTS_b-1_4394-4429_4418.wav,2500,2601,-101
14957,b-1_686-793_708.wav,VTTS_b-1_686-793_708.wav,1940,1800,140
14958,b-3_3628-3714_3705.wav,VTTS_b-3_3628-3714_3705.wav,3520,3553,-33
14959,b-1_1313-1413_1358.wav,VTTS_b-1_1313-1413_1358.wav,3530,3924,-394
14960,b-3_1079-1320_1196.wav,VTTS_b-3_1079-1320_1196.wav,5850,5840,10
14961,b-4_501-1014_909.wav,VTTS_b-4_501-1014_909.wav,5190,4598,592
14962,b-2_1223-1324_1233.wav,VTTS_b-2_1223-1324_1233.wav,2460,2101,359
14963,b-2_1325-1426_1385.wav,VTTS_b-2_1325-1426_1385.wav,4710,5886,-1176
14964,b-3_3715-3802_3726.wav,VTTS_b-3_3715-3802_3726.wav,4970,4690,280
14965,b-2_509-610_531.wav,VTTS_b-2_509-610_531.wav,4570,4307,263
14966,b-1_276-376_354.wav,VTTS_b-1_276-376_354.wav,1020,1033,-13
14967,b-1_1313-1413_1401.wav,VTTS_b-1_1313-1413_1401.wav,1250,1126,124
14968,b-3_501-930_606.wav,VTTS_b-3_501-930_606.wav,6230,5538,692
14969,b-3_1079-1320_1202.wav,VTTS_b-3_1079-1320_1202.wav,3770,3959,-189
14970,b-1_2018-2118_2046.wav,VTTS_b-1_2018-2118_2046.wav,1910,1730,180
14971,b-1_1212-1312_1242.wav,VTTS_b-1_1212-1312_1242.wav,1670,2043,-373
14972,b-1_579-649_631.wav,VTTS_b-1_579-649_631.wav,2080,1776,304
14973,b-3_5853-5956_5914.wav,VTTS_b-3_5853-5956_5914.wav,3970,3715,255
14974,b-3_4607-5008_4972.wav,VTTS_b-3_4607-5008_4972.wav,5880,5097,783
14975,b-1_2826-2926_2859.wav,VTTS_b-1_2826-2926_2859.wav,2090,4272,-2182
14976,b-4_2000-5164_2542.wav,VTTS_b-4_2000-5164_2542.wav,11170,11610,-440
14977,b-2_1121-1222_1220.wav,VTTS_b-2_1121-1222_1220.wav,1600,1660,-60
14978,b-3_5009-5427_5309.wav,VTTS_b-3_5009-5427_5309.wav,4920,4145,775
14979,b-4_151-300_247.wav,VTTS_b-4_151-300_247.wav,5460,5201,259
14980,b-3_3454-3537_3486.wav,VTTS_b-3_3454-3537_3486.wav,3850,3936,-86
14981,b-3_501-930_844.wav,VTTS_b-3_501-930_844.wav,6380,5909,471
14982,b-1_4466-4498_4492.wav,VTTS_b-1_4466-4498_4492.wav,4500,6304,-1804
14983,b-4_501-1014_594.wav,VTTS_b-4_501-1014_594.wav,4580,4029,551
14984,b-1_175-275_201.wav,VTTS_b-1_175-275_201.wav,1130,1126,4
14985,b-2_1427-1562_1561.wav,VTTS_b-2_1427-1562_1561.wav,2440,2368,72
14986,b-4_2000-5164_4629.wav,VTTS_b-4_2000-5164_4629.wav,5813,6084,-271
14987,b-4_1101-1220_1142.wav,VTTS_b-4_1101-1220_1142.wav,6370,5851,519
14988,b-3_5009-5427_5187.wav,VTTS_b-3_5009-5427_5187.wav,5250,5236,14
14989,b-4_401-500_423.wav,VTTS_b-4_401-500_423.wav,4050,4110,-60
14990,b-3_5009-5427_5422.wav,VTTS_b-3_5009-5427_5422.wav,3800,3123,677
14991,b-2_1903-2038_1956.wav,VTTS_b-2_1903-2038_1956.wav,2710,3495,-785
14992,b-3_6801-6900_6898.wav,VTTS_b-3_6801-6900_6898.wav,5660,5120,540
14993,b-2_1903-2038_1913.wav,VTTS_b-2_1903-2038_1913.wav,2370,2984,-614
14994,b-1_478-578_569.wav,VTTS_b-1_478-578_569.wav,1190,1242,-52
14995,b-3_3364-3453_3400.wav,VTTS_b-3_3364-3453_3400.wav,2720,2485,235
14996,b-1_1212-1312_1277.wav,VTTS_b-1_1212-1312_1277.wav,4040,4029,11
14997,b-3_6701-6800_6753.wav,VTTS_b-3_6701-6800_6753.wav,3400,3518,-118
14998,b-3_4315-4424_4409.wav,VTTS_b-3_4315-4424_4409.wav,2760,3007,-247
14999,b-4_2000-5164_3489.wav,VTTS_b-4_2000-5164_3489.wav,6986,6513,473
15000,b-2_1597-1698_1656.wav,VTTS_b-2_1597-1698_1656.wav,8580,7697,883
15001,b-4_2000-5164_3904.wav,VTTS_b-4_2000-5164_3904.wav,5775,5805,-30
15002,b-3_1321-1568_1394.wav,VTTS_b-3_1321-1568_1394.wav,8050,6931,1119
15003,b-4_2000-5164_2201.wav,VTTS_b-4_2000-5164_2201.wav,4395,4644,-249
15004,b-3_3112-3197_3176.wav,VTTS_b-3_3112-3197_3176.wav,4650,4516,134
15005,b-4_2000-5164_2098.wav,VTTS_b-4_2000-5164_2098.wav,5230,5515,-285
15006,b-3_1862-1959_1902.wav,VTTS_b-3_1862-1959_1902.wav,4200,3855,345
15007,b-3_3364-3453_3372.wav,VTTS_b-3_3364-3453_3372.wav,5110,11610,-6500
15008,b-1_276-376_303.wav,VTTS_b-1_276-376_303.wav,1570,1776,-206
15009,b-3_2855-2942_2907.wav,VTTS_b-3_2855-2942_2907.wav,3780,4737,-957
15010,b-1_2725-2825_2818.wav,VTTS_b-1_2725-2825_2818.wav,1870,1695,175
15011,b-4_1601-1706_1609.wav,VTTS_b-4_1601-1706_1609.wav,5930,7581,-1651
15012,b-3_5853-5956_5955.wav,VTTS_b-3_5853-5956_5955.wav,4320,4075,245
15013,b-3_4104-4206_4165.wav,VTTS_b-3_4104-4206_4165.wav,8030,7941,89
15014,b-3_6301-6400_6310.wav,VTTS_b-3_6301-6400_6310.wav,2860,3413,-553
15015,b-1_4466-4498_4487.wav,VTTS_b-1_4466-4498_4487.wav,3960,4133,-173
15016,b-3_6501-6600_6547.wav,VTTS_b-3_6501-6600_6547.wav,2730,2635,95
15017,b-2_2209-2310_2308.wav,VTTS_b-2_2209-2310_2308.wav,1560,1544,16
15018,b-3_5639-5744_5743.wav,VTTS_b-3_5639-5744_5743.wav,4360,4586,-226
15019,b-4_501-1014_675.wav,VTTS_b-4_501-1014_675.wav,8800,9102,-302
15020,b-1_686-793_740.wav,VTTS_b-1_686-793_740.wav,2300,2218,82
15021,b-4_2000-5164_3719.wav,VTTS_b-4_2000-5164_3719.wav,1540,1196,344
15022,b-4_501-1014_907.wav,VTTS_b-4_501-1014_907.wav,4590,3262,1328
15023,b-1_3531-3631_3575.wav,VTTS_b-1_3531-3631_3575.wav,2480,2426,54
15024,b-1_1717-1817_1776.wav,VTTS_b-1_1717-1817_1776.wav,3430,3762,-332
15025,b-4_151-300_255.wav,VTTS_b-4_151-300_255.wav,2260,2032,228
15026,b-1_650-685_683.wav,VTTS_b-1_650-685_683.wav,1370,1289,81
15027,b-3_5009-5427_5047.wav,VTTS_b-3_5009-5427_5047.wav,7410,7024,386
15028,b-1_1818-1918_1900.wav,VTTS_b-1_1818-1918_1900.wav,3130,4029,-899
15029,b-3_5745-5852_5789.wav,VTTS_b-3_5745-5852_5789.wav,2520,2821,-301
15030,b-4_501-1014_679.wav,VTTS_b-4_501-1014_679.wav,5100,5201,-101
15031,b-3_5639-5744_5674.wav,VTTS_b-3_5639-5744_5674.wav,5350,8231,-2881
15032,b-3_6401-6500_6475.wav,VTTS_b-3_6401-6500_6475.wav,6020,6978,-958
15033,b-2_611-712_642.wav,VTTS_b-2_611-712_642.wav,1710,1683,27
15034,b-3_294-391_317.wav,VTTS_b-3_294-391_317.wav,7260,6780,480
15035,b-3_3364-3453_3365.wav,VTTS_b-3_3364-3453_3365.wav,790,906,-116
15036,b-1_2018-2118_2069.wav,VTTS_b-1_2018-2118_2069.wav,1710,1753,-43
15037,b-2_407-508_417.wav,VTTS_b-2_407-508_417.wav,2950,2868,82
15038,b-3_3364-3453_3438.wav,VTTS_b-3_3364-3453_3438.wav,7900,7488,412
15039,b-3_1079-1320_1089.wav,VTTS_b-3_1079-1320_1089.wav,7750,7396,354
15040,b-4_2000-5164_2944.wav,VTTS_b-4_2000-5164_2944.wav,3423,3309,114
15041,b-3_4498-4605_4584.wav,VTTS_b-3_4498-4605_4584.wav,3800,3634,166
15042,b-3_5009-5427_5434.wav,VTTS_b-3_5009-5427_5434.wav,6630,7396,-766
15043,b-3_2524-2854_2633.wav,VTTS_b-3_2524-2854_2633.wav,7100,5817,1283
15044,b-1_3733-3833_3816.wav,VTTS_b-1_3733-3833_3816.wav,4470,4632,-162
15045,b-1_2624-2724_2633.wav,VTTS_b-1_2624-2724_2633.wav,1830,1985,-155
15046,b-3_4607-5008_4683.wav,VTTS_b-3_4607-5008_4683.wav,6000,8173,-2173
15047,b-3_6116-6215_6187.wav,VTTS_b-3_6116-6215_6187.wav,1510,1556,-46
15048,b-3_6601-6700_6666.wav,VTTS_b-3_6601-6700_6666.wav,6070,5817,253
15049,b-4_501-1014_742.wav,VTTS_b-4_501-1014_742.wav,3540,3448,92
15050,b-1_377-477_382.wav,VTTS_b-1_377-477_382.wav,2300,1997,303
15051,b-2_509-610_571.wav,VTTS_b-2_509-610_571.wav,3710,3738,-28
15052,b-2_1223-1324_1312.wav,VTTS_b-2_1223-1324_1312.wav,4430,4516,-86
15053,b-3_6801-6900_6819.wav,VTTS_b-3_6801-6900_6819.wav,2870,2856,14
15054,b-3_1764-1861_1830.wav,VTTS_b-3_1764-1861_1830.wav,8120,7837,283
15055,b-4_151-300_220.wav,VTTS_b-4_151-300_220.wav,5260,5550,-290
15056,b-3_3279-3363_3297.wav,VTTS_b-3_3279-3363_3297.wav,5810,5561,249
15057,b-1_686-793_691.wav,VTTS_b-1_686-793_691.wav,2510,2368,142
15058,b-4_2000-5164_3024.wav,VTTS_b-4_2000-5164_3024.wav,5126,4923,203
15059,b-3_1321-1568_1540.wav,VTTS_b-3_1321-1568_1540.wav,7090,6873,217
15060,b-4_501-1014_998.wav,VTTS_b-4_501-1014_998.wav,2830,3088,-258
15061,b-2_1019-1120_1071.wav,VTTS_b-2_1019-1120_1071.wav,2320,2299,21
15062,b-2_407-508_425.wav,VTTS_b-2_407-508_425.wav,2610,2647,-37
15063,b-3_5533-5638_5589.wav,VTTS_b-3_5533-5638_5589.wav,3960,2821,1139
15064,b-4_2000-5164_2291.wav,VTTS_b-4_2000-5164_2291.wav,2240,2485,-245
15065,b-1_3935-4033_3995.wav,VTTS_b-1_3935-4033_3995.wav,1730,7338,-5608
15066,b-3_501-930_558.wav,VTTS_b-3_501-930_558.wav,3670,3413,257
15067,b-3_196-293_219.wav,VTTS_b-3_196-293_219.wav,8550,8580,-30
15068,b-4_2000-5164_3122.wav,VTTS_b-4_2000-5164_3122.wav,6115,9857,-3742
15069,b-1_686-793_784.wav,VTTS_b-1_686-793_784.wav,1830,1834,-4
15070,b-3_1079-1320_1230.wav,VTTS_b-3_1079-1320_1230.wav,4330,4017,313
15071,b-2_203-304_223.wav,VTTS_b-2_203-304_223.wav,1220,1173,47
15072,b-3_6801-6900_6849.wav,VTTS_b-3_6801-6900_6849.wav,4650,5898,-1248
15073,b-4_1301-1400_1333.wav,VTTS_b-4_1301-1400_1333.wav,5150,5886,-736
15074,b-1_1515-1615_1613.wav,VTTS_b-1_1515-1615_1613.wav,5030,4574,456
15075,b-4_2000-5164_3969.wav,VTTS_b-4_2000-5164_3969.wav,5876,6060,-184
15076,b-3_4315-4424_4348.wav,VTTS_b-3_4315-4424_4348.wav,4670,4168,502
15077,b-3_1321-1568_1551.wav,VTTS_b-3_1321-1568_1551.wav,7990,7198,792
15078,b-3_196-293_226.wav,VTTS_b-3_196-293_226.wav,2850,2566,284
15079,b-3_5009-5427_5278.wav,VTTS_b-3_5009-5427_5278.wav,6700,6548,152
15080,b-3_5533-5638_5563.wav,VTTS_b-3_5533-5638_5563.wav,3390,3506,-116
15081,b-3_4315-4424_4338.wav,VTTS_b-3_4315-4424_4338.wav,7280,8626,-1346
15082,b-3_392-500_418.wav,VTTS_b-3_392-500_418.wav,6690,7221,-531
15083,b-3_1321-1568_1373.wav,VTTS_b-3_1321-1568_1373.wav,2110,2136,-26
15084,b-3_980-1077_1010.wav,VTTS_b-3_980-1077_1010.wav,3320,3077,243
15085,b-1_2927-3025_2956.wav,VTTS_b-1_2927-3025_2956.wav,1100,1091,9
15086,b-3_1-97_35.wav,VTTS_b-3_1-97_35.wav,4780,4447,333
15087,b-4_1601-1706_1650.wav,VTTS_b-4_1601-1706_1650.wav,5670,5271,399
15088,b-3_2350-2433_2410.wav,VTTS_b-3_2350-2433_2410.wav,5240,4992,248
15089,b-2_2209-2310_2222.wav,VTTS_b-2_2209-2310_2222.wav,4380,4679,-299
15090,b-1_377-477_442.wav,VTTS_b-1_377-477_442.wav,2430,2136,294
15091,b-2_203-304_209.wav,VTTS_b-2_203-304_209.wav,2890,2868,22
15092,b-1_686-793_753.wav,VTTS_b-1_686-793_753.wav,1580,1800,-220
15093,b-1_3430-3530_3519.wav,VTTS_b-1_3430-3530_3519.wav,2280,2241,39
15094,b-3_1321-1568_1541.wav,VTTS_b-3_1321-1568_1541.wav,4800,4365,435
15095,b-4_2000-5164_3733.wav,VTTS_b-4_2000-5164_3733.wav,6340,6734,-394
15096,b-3_6601-6700_6699.wav,VTTS_b-3_6601-6700_6699.wav,7500,6571,929
15097,b-3_5853-5956_5873.wav,VTTS_b-3_5853-5956_5873.wav,3660,3379,281
15098,b-4_2000-5164_2643.wav,VTTS_b-4_2000-5164_2643.wav,2830,3135,-305
15099,b-3_4607-5008_4711.wav,VTTS_b-3_4607-5008_4711.wav,4590,4621,-31
15100,b-3_501-930_575.wav,VTTS_b-3_501-930_575.wav,5430,5190,240
15101,b-3_3715-3802_3733.wav,VTTS_b-3_3715-3802_3733.wav,2450,2543,-93
15102,b-1_794-1009_832.wav,VTTS_b-1_794-1009_832.wav,2540,2345,195
15103,b-4_1301-1400_1353.wav,VTTS_b-4_1301-1400_1353.wav,5950,6618,-668
15104,b-2_1019-1120_1109.wav,VTTS_b-2_1019-1120_1109.wav,8560,7465,1095
15105,b-4_2000-5164_2838.wav,VTTS_b-4_2000-5164_2838.wav,5200,6095,-895
15106,b-3_5745-5852_5822.wav,VTTS_b-3_5745-5852_5822.wav,5390,5364,26
15107,b-4_2000-5164_4003.wav,VTTS_b-4_2000-5164_4003.wav,3942,4574,-632
15108,b-3_3198-3278_3246.wav,VTTS_b-3_3198-3278_3246.wav,5620,6049,-429
15109,b-4_1601-1706_1658.wav,VTTS_b-4_1601-1706_1658.wav,5640,5166,474
15110,b-2_1699-1800_1741.wav,VTTS_b-2_1699-1800_1741.wav,4140,3053,1087
15111,b-1_478-578_553.wav,VTTS_b-1_478-578_553.wav,1790,1730,60
15112,b-1_3127-3227_3165.wav,VTTS_b-1_3127-3227_3165.wav,5610,5224,386
15113,b-3_2000-2088_2071.wav,VTTS_b-3_2000-2088_2071.wav,1300,1196,104
15114,b-3_501-930_836.wav,VTTS_b-3_501-930_836.wav,6980,7198,-218
15115,b-4_2000-5164_3894.wav,VTTS_b-4_2000-5164_3894.wav,4167,4168,-1
15116,b-3_2524-2854_2733.wav,VTTS_b-3_2524-2854_2733.wav,9760,11111,-1351
15117,b-3_1862-1959_1924.wav,VTTS_b-3_1862-1959_1924.wav,7290,7338,-48
15118,b-1_1717-1817_1748.wav,VTTS_b-1_1717-1817_1748.wav,4850,4795,55
15119,b-2_1597-1698_1614.wav,VTTS_b-2_1597-1698_1614.wav,1530,1382,148
15120,b-1_2523-2623_2570.wav,VTTS_b-1_2523-2623_2570.wav,5220,5050,170
15121,b-4_501-1014_944.wav,VTTS_b-4_501-1014_944.wav,5860,5492,368
15122,b-4_2000-5164_2035.wav,VTTS_b-4_2000-5164_2035.wav,2080,2125,-45
15123,b-4_501-1014_717.wav,VTTS_b-4_501-1014_717.wav,9910,11215,-1305
15124,b-3_4425-4497_4483.wav,VTTS_b-3_4425-4497_4483.wav,2940,3030,-90
15125,b-3_5533-5638_5559.wav,VTTS_b-3_5533-5638_5559.wav,8380,8916,-536
15126,b-1_3329-3429_3409.wav,VTTS_b-1_3329-3429_3409.wav,2150,2194,-44
15127,b-3_4315-4424_4358.wav,VTTS_b-3_4315-4424_4358.wav,5150,5074,76
15128,b-4_2000-5164_3175.wav,VTTS_b-4_2000-5164_3175.wav,1323,1173,150
15129,b-3_2943-3024_2955.wav,VTTS_b-3_2943-3024_2955.wav,4220,4087,133
15130,b-4_501-1014_682.wav,VTTS_b-4_501-1014_682.wav,4750,4923,-173
15131,b-3_2434-2523_2475.wav,VTTS_b-3_2434-2523_2475.wav,4150,3855,295
15132,b-4_2000-5164_2553.wav,VTTS_b-4_2000-5164_2553.wav,5465,6757,-1292
15133,b-3_4315-4424_4391.wav,VTTS_b-3_4315-4424_4391.wav,5610,4981,629
15134,b-3_2434-2523_2497.wav,VTTS_b-3_2434-2523_2497.wav,4000,5735,-1735
15135,b-3_5745-5852_5847.wav,VTTS_b-3_5745-5852_5847.wav,5880,6002,-122
15136,b-4_2000-5164_3162.wav,VTTS_b-4_2000-5164_3162.wav,4460,4377,83
15137,b-1_175-275_197.wav,VTTS_b-1_175-275_197.wav,1150,1091,59
15138,b-3_5853-5956_5930.wav,VTTS_b-3_5853-5956_5930.wav,9690,10159,-469
15139,b-2_2413-2500_2499.wav,VTTS_b-2_2413-2500_2499.wav,1980,1695,285
15140,b-4_501-1014_683.wav,VTTS_b-4_501-1014_683.wav,5980,6060,-80
15141,b-3_1-97_72.wav,VTTS_b-3_1-97_72.wav,1780,1776,4
15142,b-4_2000-5164_2426.wav,VTTS_b-4_2000-5164_2426.wav,7000,9207,-2207
15143,b-4_1814-1900_1818.wav,VTTS_b-4_1814-1900_1818.wav,4170,3773,397
15144,b-2_1223-1324_1241.wav,VTTS_b-2_1223-1324_1241.wav,870,906,-36
15145,b-3_501-930_647.wav,VTTS_b-3_501-930_647.wav,2230,1730,500
15146,b-3_98-195_175.wav,VTTS_b-3_98-195_175.wav,3680,3913,-233
15147,b-4_1506-1600_1552.wav,VTTS_b-4_1506-1600_1552.wav,4160,3448,712
15148,b-3_2434-2523_2506.wav,VTTS_b-3_2434-2523_2506.wav,5120,4981,139
15149,b-2_917-1018_921.wav,VTTS_b-2_917-1018_921.wav,990,789,201
15150,b-3_6900-7016_6952.wav,VTTS_b-3_6900-7016_6952.wav,4090,4133,-43
15151,b-3_6501-6600_6542.wav,VTTS_b-3_6501-6600_6542.wav,7320,6165,1155
15152,b-1_1111-1211_1135.wav,VTTS_b-1_1111-1211_1135.wav,1850,4226,-2376
15153,b-1_478-578_534.wav,VTTS_b-1_478-578_534.wav,1080,871,209
15154,b-3_6501-6600_6561.wav,VTTS_b-3_6501-6600_6561.wav,1700,1695,5
15155,b-2_2209-2310_2250.wav,VTTS_b-2_2209-2310_2250.wav,1490,1382,108
15156,b-3_3715-3802_3745.wav,VTTS_b-3_3715-3802_3745.wav,3830,3622,208
15157,b-4_2000-5164_2214.wav,VTTS_b-4_2000-5164_2214.wav,3360,3599,-239
15158,b-4_2000-5164_2877.wav,VTTS_b-4_2000-5164_2877.wav,9110,8452,658
15159,b-4_2000-5164_4716.wav,VTTS_b-4_2000-5164_4716.wav,3836,4307,-471
15160,b-1_2220-2320_2244.wav,VTTS_b-1_2220-2320_2244.wav,1180,1254,-74
15161,b-2_2040-2072_2041.wav,VTTS_b-2_2040-2072_2041.wav,2850,3390,-540
15162,b-3_501-930_915.wav,VTTS_b-3_501-930_915.wav,6530,5898,632
15163,b-3_5009-5427_5306.wav,VTTS_b-3_5009-5427_5306.wav,3500,3158,342
15164,b-3_501-930_620.wav,VTTS_b-3_501-930_620.wav,2490,2368,122
15165,b-3_3025-3111_3036.wav,VTTS_b-3_3025-3111_3036.wav,7230,6362,868
15166,b-3_5957-6015_5973.wav,VTTS_b-3_5957-6015_5973.wav,6060,7697,-1637
15167,b-1_478-578_530.wav,VTTS_b-1_478-578_530.wav,2080,1741,339
15168,b-4_2000-5164_3177.wav,VTTS_b-4_2000-5164_3177.wav,5101,5120,-19
15169,b-1_377-477_440.wav,VTTS_b-1_377-477_440.wav,1450,1881,-431
15170,b-4_501-1014_965.wav,VTTS_b-4_501-1014_965.wav,1010,1057,-47
15171,b-4_53-150_148.wav,VTTS_b-4_53-150_148.wav,7800,8057,-257
15172,b-3_1321-1568_1513.wav,VTTS_b-3_1321-1568_1513.wav,3180,3320,-140
15173,b-4_2000-5164_3868.wav,VTTS_b-4_2000-5164_3868.wav,1760,2194,-434
15174,b-4_2000-5164_3472.wav,VTTS_b-4_2000-5164_3472.wav,3866,5248,-1382
15175,b-3_5009-5427_5390.wav,VTTS_b-3_5009-5427_5390.wav,3120,3100,20
15176,b-1_3026-3126_3106.wav,VTTS_b-1_3026-3126_3106.wav,1200,1207,-7
15177,b-3_5009-5427_5058.wav,VTTS_b-3_5009-5427_5058.wav,3290,3135,155
15178,b-3_501-930_752.wav,VTTS_b-3_501-930_752.wav,3400,3123,277
15179,b-3_5428-5533_5454.wav,VTTS_b-3_5428-5533_5454.wav,2180,2380,-200
15180,b-4_2000-5164_3587.wav,VTTS_b-4_2000-5164_3587.wav,2423,2299,124
15181,b-2_2413-2500_2460.wav,VTTS_b-2_2413-2500_2460.wav,2540,3332,-792
15182,b-3_5745-5852_5748.wav,VTTS_b-3_5745-5852_5748.wav,2250,2508,-258
15183,b-2_2413-2500_2456.wav,VTTS_b-2_2413-2500_2456.wav,2310,2368,-58
15184,b-1_1111-1211_1163.wav,VTTS_b-1_1111-1211_1163.wav,1750,1614,136
15185,b-4_2000-5164_3828.wav,VTTS_b-4_2000-5164_3828.wav,4687,4841,-154
15186,b-2_1597-1698_1684.wav,VTTS_b-2_1597-1698_1684.wav,5280,5933,-653
15187,b-3_5009-5427_5104.wav,VTTS_b-3_5009-5427_5104.wav,6610,5759,851
15188,b-2_1903-2038_2010.wav,VTTS_b-2_1903-2038_2010.wav,1610,2276,-666
15189,b-4_2000-5164_2594.wav,VTTS_b-4_2000-5164_2594.wav,7695,8231,-536
15190,b-2_203-304_291.wav,VTTS_b-2_203-304_291.wav,2120,1788,332
15191,b-3_3889-4000_3941.wav,VTTS_b-3_3889-4000_3941.wav,4670,4516,154
15192,b-4_1814-1900_1897.wav,VTTS_b-4_1814-1900_1897.wav,12070,11610,460
15193,b-1_2725-2825_2757.wav,VTTS_b-1_2725-2825_2757.wav,3120,3541,-421
15194,b-2_305-406_308.wav,VTTS_b-2_305-406_308.wav,2880,3286,-406
15195,b-2_2311-2412_2398.wav,VTTS_b-2_2311-2412_2398.wav,3670,2740,930
15196,b-3_294-391_350.wav,VTTS_b-3_294-391_350.wav,7060,7221,-161
15197,b-1_74-174_154.wav,VTTS_b-1_74-174_154.wav,3700,7210,-3510
15198,b-4_1601-1706_1660.wav,VTTS_b-4_1601-1706_1660.wav,6330,5538,792
15199,b-1_4358-4393_4388.wav,VTTS_b-1_4358-4393_4388.wav,5730,5596,134
15200,b-1_3228-3328_3258.wav,VTTS_b-1_3228-3328_3258.wav,3890,4679,-789
15201,b-4_151-300_177.wav,VTTS_b-4_151-300_177.wav,7090,6629,461
15202,b-2_815-916_875.wav,VTTS_b-2_815-916_875.wav,2230,2136,94
15203,b-3_1079-1320_1086.wav,VTTS_b-3_1079-1320_1086.wav,3920,4760,-840
15204,b-1_1414-1514_1462.wav,VTTS_b-1_1414-1514_1462.wav,1470,1463,7
15205,b-3_4607-5008_4827.wav,VTTS_b-3_4607-5008_4827.wav,5010,5248,-238
15206,b-3_5009-5427_5132.wav,VTTS_b-3_5009-5427_5132.wav,6740,6478,262
15207,b-3_501-930_525.wav,VTTS_b-3_501-930_525.wav,2800,3111,-311
15208,b-3_196-293_208.wav,VTTS_b-3_196-293_208.wav,8600,7790,810
15209,b-4_1221-1300_1231.wav,VTTS_b-4_1221-1300_1231.wav,6130,5689,441
15210,b-4_401-500_405.wav,VTTS_b-4_401-500_405.wav,7330,6722,608
15211,b-3_3112-3197_3113.wav,VTTS_b-3_3112-3197_3113.wav,10420,11610,-1190
15212,b-1_3733-3833_3806.wav,VTTS_b-1_3733-3833_3806.wav,2100,1997,103
15213,b-4_401-500_467.wav,VTTS_b-4_401-500_467.wav,2820,2763,57
15214,b-3_6701-6800_6774.wav,VTTS_b-3_6701-6800_6774.wav,5660,6699,-1039
15215,b-4_1014-1100_1092.wav,VTTS_b-4_1014-1100_1092.wav,7780,7036,744
15216,b-3_5533-5638_5605.wav,VTTS_b-3_5533-5638_5605.wav,4570,5364,-794
15217,b-4_2000-5164_2213.wav,VTTS_b-4_2000-5164_2213.wav,3040,3193,-153
15218,b-1_1515-1615_1604.wav,VTTS_b-1_1515-1615_1604.wav,5110,4516,594
15219,b-4_2000-5164_2507.wav,VTTS_b-4_2000-5164_2507.wav,2785,2740,45
15220,b-2_713-814_715.wav,VTTS_b-2_713-814_715.wav,5450,4760,690
15221,b-1_3430-3530_3491.wav,VTTS_b-1_3430-3530_3491.wav,2360,2937,-577
15222,b-3_5009-5427_5344.wav,VTTS_b-3_5009-5427_5344.wav,5510,11610,-6100
15223,b-4_2000-5164_3069.wav,VTTS_b-4_2000-5164_3069.wav,2873,2961,-88
15224,b-1_4466-4498_4473.wav,VTTS_b-1_4466-4498_4473.wav,6430,5224,1206
15225,b-3_1079-1320_1298.wav,VTTS_b-3_1079-1320_1298.wav,5930,6815,-885
15226,b-1_1919-2017_1928.wav,VTTS_b-1_1919-2017_1928.wav,3140,3286,-146
15227,b-4_501-1014_1001.wav,VTTS_b-4_501-1014_1001.wav,6700,6095,605
15228,b-1_794-1009_947.wav,VTTS_b-1_794-1009_947.wav,4120,3309,811
15229,b-3_5533-5638_5588.wav,VTTS_b-3_5533-5638_5588.wav,2790,2821,-31
15230,b-1_2624-2724_2649.wav,VTTS_b-1_2624-2724_2649.wav,2050,2276,-226
15231,b-4_2000-5164_2040.wav,VTTS_b-4_2000-5164_2040.wav,6700,9149,-2449
15232,b-4_2000-5164_2789.wav,VTTS_b-4_2000-5164_2789.wav,5965,5410,555
15233,b-4_2000-5164_2558.wav,VTTS_b-4_2000-5164_2558.wav,7860,7744,116
15234,b-2_1-100_9.wav,VTTS_b-2_1-100_9.wav,1760,1625,135
15235,b-1_2927-3025_2973.wav,VTTS_b-1_2927-3025_2973.wav,3810,4342,-532
15236,b-1_377-477_386.wav,VTTS_b-1_377-477_386.wav,1570,1823,-253
15237,b-2_1903-2038_2029.wav,VTTS_b-2_1903-2038_2029.wav,1170,1115,55
15238,b-2_1801-1902_1894.wav,VTTS_b-2_1801-1902_1894.wav,4500,5155,-655
15239,b-1_2018-2118_2097.wav,VTTS_b-1_2018-2118_2097.wav,2720,2438,282
15240,b-2_1325-1426_1352.wav,VTTS_b-2_1325-1426_1352.wav,1970,2136,-166
15241,b-3_2855-2942_2899.wav,VTTS_b-3_2855-2942_2899.wav,7240,7883,-643
15242,b-2_1903-2038_1904.wav,VTTS_b-2_1903-2038_1904.wav,3700,3216,484
15243,b-3_6401-6500_6413.wav,VTTS_b-3_6401-6500_6413.wav,5380,4679,701
15244,b-3_1960-2000_1999.wav,VTTS_b-3_1960-2000_1999.wav,4520,4145,375
15245,b-2_1223-1324_1301.wav,VTTS_b-2_1223-1324_1301.wav,1860,1800,60
15246,b-1_3935-4033_3966.wav,VTTS_b-1_3935-4033_3966.wav,1760,1347,413
15247,b-3_5957-6015_5986.wav,VTTS_b-3_5957-6015_5986.wav,5990,6095,-105
15248,b-3_3538-3627_3578.wav,VTTS_b-3_3538-3627_3578.wav,4050,3971,79
15249,b-3_3889-4000_3991.wav,VTTS_b-3_3889-4000_3991.wav,8540,10101,-1561
15250,b-4_2000-5164_3386.wav,VTTS_b-4_2000-5164_3386.wav,1357,1312,45
15251,b-3_2524-2854_2637.wav,VTTS_b-3_2524-2854_2637.wav,6040,5596,444
15252,b-3_5009-5427_5190.wav,VTTS_b-3_5009-5427_5190.wav,7160,6803,357
15253,b-2_1121-1222_1148.wav,VTTS_b-2_1121-1222_1148.wav,1240,1277,-37
15254,b-1_3531-3631_3594.wav,VTTS_b-1_3531-3631_3594.wav,1320,1498,-178
15255,b-1_377-477_423.wav,VTTS_b-1_377-477_423.wav,1050,1022,28
15256,b-1_1111-1211_1186.wav,VTTS_b-1_1111-1211_1186.wav,2900,2415,485
15257,b-1_377-477_448.wav,VTTS_b-1_377-477_448.wav,2810,2844,-34
15258,b-2_305-406_400.wav,VTTS_b-2_305-406_400.wav,1460,1474,-14
15259,b-4_2000-5164_3022.wav,VTTS_b-4_2000-5164_3022.wav,6183,5991,192
15260,b-2_2413-2500_2425.wav,VTTS_b-2_2413-2500_2425.wav,1530,1370,160
15261,b-1_1717-1817_1740.wav,VTTS_b-1_1717-1817_1740.wav,1210,1265,-55
15262,b-3_4607-5008_4684.wav,VTTS_b-3_4607-5008_4684.wav,3720,3947,-227
15263,b-3_980-1077_1014.wav,VTTS_b-3_980-1077_1014.wav,2590,2264,326
15264,b-1_4394-4429_4413.wav,VTTS_b-1_4394-4429_4413.wav,2400,3286,-886
15265,b-4_2000-5164_2960.wav,VTTS_b-4_2000-5164_2960.wav,5277,5341,-64
15266,b-2_509-610_517.wav,VTTS_b-2_509-610_517.wav,2090,2159,-69
15267,b-1_2725-2825_2811.wav,VTTS_b-1_2725-2825_2811.wav,2040,3262,-1222
15268,b-1_3834-3934_3850.wav,VTTS_b-1_3834-3934_3850.wav,2390,3297,-907
15269,b-1_2422-2522_2429.wav,VTTS_b-1_2422-2522_2429.wav,1410,1393,17
15270,b-2_1801-1902_1818.wav,VTTS_b-2_1801-1902_1818.wav,1510,1625,-115
15271,b-3_4315-4424_4360.wav,VTTS_b-3_4315-4424_4360.wav,3670,3495,175
15272,b-4_2000-5164_4823.wav,VTTS_b-4_2000-5164_4823.wav,6294,5596,698
15273,b-4_2000-5164_5151.wav,VTTS_b-4_2000-5164_5151.wav,3745,4307,-562
15274,b-1_3430-3530_3435.wav,VTTS_b-1_3430-3530_3435.wav,3190,3111,79
15275,b-4_2000-5164_4368.wav,VTTS_b-4_2000-5164_4368.wav,3755,4017,-262
15276,b-3_501-930_502.wav,VTTS_b-3_501-930_502.wav,5140,4818,322
15277,b-3_5533-5638_5567.wav,VTTS_b-3_5533-5638_5567.wav,2730,2705,25
15278,b-2_1121-1222_1206.wav,VTTS_b-2_1121-1222_1206.wav,1850,1869,-19
15279,b-3_1-97_19.wav,VTTS_b-3_1-97_19.wav,12540,11610,930
15280,b-1_2927-3025_2954.wav,VTTS_b-1_2927-3025_2954.wav,2090,2067,23
15281,b-4_1014-1100_1074.wav,VTTS_b-4_1014-1100_1074.wav,3400,3297,103
15282,b-4_2000-5164_2736.wav,VTTS_b-4_2000-5164_2736.wav,3605,3425,180
15283,b-1_4394-4429_4419.wav,VTTS_b-1_4394-4429_4419.wav,2180,2194,-14
15284,b-2_1903-2038_1977.wav,VTTS_b-2_1903-2038_1977.wav,4870,5306,-436
15285,b-3_1862-1959_1918.wav,VTTS_b-3_1862-1959_1918.wav,8540,8789,-249
15286,b-1_4358-4393_4362.wav,VTTS_b-1_4358-4393_4362.wav,1320,1196,124
15287,b-3_5009-5427_5343.wav,VTTS_b-3_5009-5427_5343.wav,4490,4389,101
15288,b-2_611-712_671.wav,VTTS_b-2_611-712_671.wav,6980,5329,1651
15289,b-4_2000-5164_3682.wav,VTTS_b-4_2000-5164_3682.wav,4225,4702,-477
15290,b-2_1223-1324_1282.wav,VTTS_b-2_1223-1324_1282.wav,9150,10983,-1833
15291,b-2_2107-2193_2177.wav,VTTS_b-2_2107-2193_2177.wav,1400,1823,-423
15292,b-3_6116-6215_6143.wav,VTTS_b-3_6116-6215_6143.wav,2210,2090,120
15293,b-3_2855-2942_2888.wav,VTTS_b-3_2855-2942_2888.wav,3830,3878,-48
15294,b-4_2000-5164_3205.wav,VTTS_b-4_2000-5164_3205.wav,5820,5909,-89
15295,b-1_1616-1716_1673.wav,VTTS_b-1_1616-1716_1673.wav,1950,2020,-70
15296,b-3_1079-1320_1235.wav,VTTS_b-3_1079-1320_1235.wav,5620,4876,744
15297,b-4_2000-5164_2017.wav,VTTS_b-4_2000-5164_2017.wav,3315,3971,-656
15298,b-1_1818-1918_1857.wav,VTTS_b-1_1818-1918_1857.wav,4340,4888,-548
15299,b-1_2523-2623_2586.wav,VTTS_b-1_2523-2623_2586.wav,2480,4238,-1758
15300,b-1_3834-3934_3839.wav,VTTS_b-1_3834-3934_3839.wav,3950,4992,-1042
15301,b-1_74-174_155.wav,VTTS_b-1_74-174_155.wav,2740,3100,-360
15302,b-1_2321-2421_2375.wav,VTTS_b-1_2321-2421_2375.wav,1920,2032,-112
15303,b-3_3715-3802_3770.wav,VTTS_b-3_3715-3802_3770.wav,5310,5492,-182
15304,b-3_4607-5008_5005.wav,VTTS_b-3_4607-5008_5005.wav,4200,11610,-7410
15305,b-1_4106-4141_4116.wav,VTTS_b-1_4106-4141_4116.wav,5260,6293,-1033
15306,b-1_2321-2421_2336.wav,VTTS_b-1_2321-2421_2336.wav,2630,2543,87
15307,b-2_101-202_155.wav,VTTS_b-2_101-202_155.wav,1730,2368,-638
15308,b-3_6801-6900_6870.wav,VTTS_b-3_6801-6900_6870.wav,3090,3216,-126
15309,b-4_501-1014_551.wav,VTTS_b-4_501-1014_551.wav,6310,5735,575
15310,b-1_1919-2017_1962.wav,VTTS_b-1_1919-2017_1962.wav,930,813,117
15311,b-4_1101-1220_1208.wav,VTTS_b-4_1101-1220_1208.wav,7390,6525,865
15312,b-3_501-930_787.wav,VTTS_b-3_501-930_787.wav,3280,3309,-29
15313,b-4_2000-5164_3376.wav,VTTS_b-4_2000-5164_3376.wav,3813,3773,40
15314,b-4_2000-5164_4512.wav,VTTS_b-4_2000-5164_4512.wav,6974,6618,356
15315,b-3_980-1077_1065.wav,VTTS_b-3_980-1077_1065.wav,2680,2577,103
15316,b-1_3531-3631_3571.wav,VTTS_b-1_3531-3631_3571.wav,1980,2531,-551
15317,b-4_2000-5164_2123.wav,VTTS_b-4_2000-5164_2123.wav,2000,1950,50
15318,b-2_2209-2310_2281.wav,VTTS_b-2_2209-2310_2281.wav,6730,5689,1041
15319,b-3_1568-1665_1601.wav,VTTS_b-3_1568-1665_1601.wav,7600,7802,-202
15320,b-4_53-150_103.wav,VTTS_b-4_53-150_103.wav,8080,9183,-1103
15321,b-3_4207-4314_4246.wav,VTTS_b-3_4207-4314_4246.wav,6890,6304,586
15322,b-3_3538-3627_3552.wav,VTTS_b-3_3538-3627_3552.wav,2800,2752,48
15323,b-4_501-1014_566.wav,VTTS_b-4_501-1014_566.wav,10930,11494,-564
15324,b-4_1901-2000_1958.wav,VTTS_b-4_1901-2000_1958.wav,3610,3727,-117
15325,b-4_2000-5164_5155.wav,VTTS_b-4_2000-5164_5155.wav,4059,4226,-167
15326,b-4_1814-1900_1882.wav,VTTS_b-4_1814-1900_1882.wav,4760,4748,12
15327,b-3_2524-2854_2783.wav,VTTS_b-3_2524-2854_2783.wav,9350,11610,-2260
15328,b-1_1616-1716_1706.wav,VTTS_b-1_1616-1716_1706.wav,5610,4203,1407
15329,b-1_1313-1413_1359.wav,VTTS_b-1_1313-1413_1359.wav,1930,1811,119
15330,b-4_501-1014_707.wav,VTTS_b-4_501-1014_707.wav,2780,2705,75
15331,b-3_4607-5008_5003.wav,VTTS_b-3_4607-5008_5003.wav,3420,3297,123
15332,b-3_6016-6115_6102.wav,VTTS_b-3_6016-6115_6102.wav,9290,8348,942
15333,b-1_1818-1918_1848.wav,VTTS_b-1_1818-1918_1848.wav,1660,1602,58
15334,b-4_53-150_63.wav,VTTS_b-4_53-150_63.wav,7780,8545,-765
15335,b-3_3889-4000_3955.wav,VTTS_b-3_3889-4000_3955.wav,7170,6792,378
15336,b-1_2624-2724_2688.wav,VTTS_b-1_2624-2724_2688.wav,1830,2183,-353
15337,b-1_1818-1918_1913.wav,VTTS_b-1_1818-1918_1913.wav,6600,6594,6
15338,b-1_1111-1211_1129.wav,VTTS_b-1_1111-1211_1129.wav,1290,1231,59
15339,b-1_4394-4429_4425.wav,VTTS_b-1_4394-4429_4425.wav,1680,1683,-3
15340,b-3_5745-5852_5746.wav,VTTS_b-3_5745-5852_5746.wav,7790,8754,-964
15341,b-1_4466-4498_4496.wav,VTTS_b-1_4466-4498_4496.wav,3270,3297,-27
15342,b-4_2000-5164_2964.wav,VTTS_b-4_2000-5164_2964.wav,3805,3402,403
15343,b-1_2220-2320_2225.wav,VTTS_b-1_2220-2320_2225.wav,1970,1916,54
15344,b-3_1079-1320_1175.wav,VTTS_b-3_1079-1320_1175.wav,10360,10147,213
15345,b-4_2000-5164_2014.wav,VTTS_b-4_2000-5164_2014.wav,2475,2589,-114
15346,b-2_1903-2038_1936.wav,VTTS_b-2_1903-2038_1936.wav,1290,1173,117
15347,b-1_2927-3025_2974.wav,VTTS_b-1_2927-3025_2974.wav,3630,3262,368
15348,b-3_1321-1568_1425.wav,VTTS_b-3_1321-1568_1425.wav,6140,5805,335
15349,b-3_4104-4206_4178.wav,VTTS_b-3_4104-4206_4178.wav,5580,7477,-1897
15350,b-4_2000-5164_2688.wav,VTTS_b-4_2000-5164_2688.wav,1270,1219,51
15351,b-3_6217-6274_6221.wav,VTTS_b-3_6217-6274_6221.wav,7850,9636,-1786
15352,b-1_2927-3025_3020.wav,VTTS_b-1_2927-3025_3020.wav,1820,1753,67
15353,b-3_4001-4103_4058.wav,VTTS_b-3_4001-4103_4058.wav,4530,4470,60
15354,b-3_4001-4103_4095.wav,VTTS_b-3_4001-4103_4095.wav,6700,9149,-2449
15355,b-3_5009-5427_5374.wav,VTTS_b-3_5009-5427_5374.wav,6850,7024,-174
15356,b-3_2943-3024_3001.wav,VTTS_b-3_2943-3024_3001.wav,680,766,-86
15357,b-4_1601-1706_1632.wav,VTTS_b-4_1601-1706_1632.wav,3380,2821,559
15358,b-3_4315-4424_4372.wav,VTTS_b-3_4315-4424_4372.wav,4430,3762,668
15359,b-4_1-52_43.wav,VTTS_b-4_1-52_43.wav,14440,11610,2830
15360,b-3_1764-1861_1831.wav,VTTS_b-3_1764-1861_1831.wav,4110,3471,639
15361,b-3_392-500_438.wav,VTTS_b-3_392-500_438.wav,7960,7779,181
15362,b-3_6401-6500_6467.wav,VTTS_b-3_6401-6500_6467.wav,4030,3994,36
15363,b-3_4315-4424_4362.wav,VTTS_b-3_4315-4424_4362.wav,6530,7372,-842
15364,b-3_1321-1568_1574.wav,VTTS_b-3_1321-1568_1574.wav,3260,3855,-595
15365,b-3_1568-1665_1605.wav,VTTS_b-3_1568-1665_1605.wav,7700,7129,571
15366,b-3_196-293_227.wav,VTTS_b-3_196-293_227.wav,3660,3251,409
15367,b-3_196-293_249.wav,VTTS_b-3_196-293_249.wav,7880,8348,-468
15368,b-3_6701-6800_6785.wav,VTTS_b-3_6701-6800_6785.wav,4710,4226,484
15369,b-3_1321-1568_1512.wav,VTTS_b-3_1321-1568_1512.wav,2460,2740,-280
15370,b-1_4178-4213_4178.wav,VTTS_b-1_4178-4213_4178.wav,940,1045,-105
15371,b-1_794-1009_946.wav,VTTS_b-1_794-1009_946.wav,4070,4412,-342
15372,b-4_2000-5164_4241.wav,VTTS_b-4_2000-5164_4241.wav,11783,9195,2588
15373,b-3_3454-3537_3482.wav,VTTS_b-3_3454-3537_3482.wav,4400,4377,23
15374,b-1_2725-2825_2739.wav,VTTS_b-1_2725-2825_2739.wav,1790,1718,72
15375,b-2_1121-1222_1191.wav,VTTS_b-2_1121-1222_1191.wav,2000,2183,-183
15376,b-4_2000-5164_3583.wav,VTTS_b-4_2000-5164_3583.wav,3139,3727,-588
15377,b-3_5957-6015_6002.wav,VTTS_b-3_5957-6015_6002.wav,4340,4574,-234
15378,b-4_1301-1400_1352.wav,VTTS_b-4_1301-1400_1352.wav,10230,9694,536
15379,b-4_2000-5164_2647.wav,VTTS_b-4_2000-5164_2647.wav,4670,4435,235
15380,b-2_2107-2193_2144.wav,VTTS_b-2_2107-2193_2144.wav,1520,1556,-36
15381,b-3_4104-4206_4163.wav,VTTS_b-3_4104-4206_4163.wav,7200,6792,408
15382,b-1_2018-2118_2091.wav,VTTS_b-1_2018-2118_2091.wav,1290,1324,-34
15383,b-4_2000-5164_3588.wav,VTTS_b-4_2000-5164_3588.wav,8647,8800,-153
15384,b-4_2000-5164_3282.wav,VTTS_b-4_2000-5164_3282.wav,3862,3506,356
15385,b-3_4315-4424_4417.wav,VTTS_b-3_4315-4424_4417.wav,2710,2682,28
15386,b-4_1506-1600_1582.wav,VTTS_b-4_1506-1600_1582.wav,5580,4853,727
15387,b-3_6501-6600_6537.wav,VTTS_b-3_6501-6600_6537.wav,8730,9903,-1173
15388,b-3_1764-1861_1768.wav,VTTS_b-3_1764-1861_1768.wav,6790,5735,1055
15389,b-3_4607-5008_4743.wav,VTTS_b-3_4607-5008_4743.wav,3790,3460,330
15390,b-3_1862-1959_1944.wav,VTTS_b-3_1862-1959_1944.wav,3350,3170,180
15391,b-3_5009-5427_5264.wav,VTTS_b-3_5009-5427_5264.wav,1860,1997,-137
15392,b-3_6501-6600_6538.wav,VTTS_b-3_6501-6600_6538.wav,10890,9683,1207
15393,b-4_2000-5164_3256.wav,VTTS_b-4_2000-5164_3256.wav,3714,4122,-408
15394,b-3_980-1077_998.wav,VTTS_b-3_980-1077_998.wav,8460,9009,-549
15395,b-3_4607-5008_4767.wav,VTTS_b-3_4607-5008_4767.wav,3930,4667,-737
15396,b-4_2000-5164_2160.wav,VTTS_b-4_2000-5164_2160.wav,2650,2752,-102
15397,b-4_501-1014_950.wav,VTTS_b-4_501-1014_950.wav,1630,1660,-30
15398,b-4_2000-5164_2396.wav,VTTS_b-4_2000-5164_2396.wav,6790,6757,33
15399,b-4_2000-5164_3012.wav,VTTS_b-4_2000-5164_3012.wav,2189,2554,-365
15400,b-4_2000-5164_2955.wav,VTTS_b-4_2000-5164_2955.wav,7260,7546,-286
15401,b-2_1903-2038_1967.wav,VTTS_b-2_1903-2038_1967.wav,1460,1393,67
15402,b-3_6801-6900_6887.wav,VTTS_b-3_6801-6900_6887.wav,1940,1869,71
15403,b-4_1814-1900_1890.wav,VTTS_b-4_1814-1900_1890.wav,3400,3053,347
15404,b-3_3279-3363_3298.wav,VTTS_b-3_3279-3363_3298.wav,4690,4992,-302
15405,b-1_3935-4033_4009.wav,VTTS_b-1_3935-4033_4009.wav,1190,1196,-6
15406,b-1_4106-4141_4136.wav,VTTS_b-1_4106-4141_4136.wav,1390,1405,-15
15407,b-4_1814-1900_1868.wav,VTTS_b-4_1814-1900_1868.wav,2880,3030,-150
15408,b-1_1616-1716_1717.wav,VTTS_b-1_1616-1716_1717.wav,2770,3193,-423
15409,b-4_2000-5164_4740.wav,VTTS_b-4_2000-5164_4740.wav,5913,5654,259
15410,b-4_2000-5164_4266.wav,VTTS_b-4_2000-5164_4266.wav,3504,3495,9
15411,b-1_4214-4285_4272.wav,VTTS_b-1_4214-4285_4272.wav,2440,3181,-741
15412,b-1_3834-3934_3873.wav,VTTS_b-1_3834-3934_3873.wav,1940,2113,-173
15413,b-3_1321-1568_1455.wav,VTTS_b-3_1321-1568_1455.wav,4400,11610,-7210
15414,b-4_2000-5164_2365.wav,VTTS_b-4_2000-5164_2365.wav,9070,11331,-2261
15415,b-3_1862-1959_1934.wav,VTTS_b-3_1862-1959_1934.wav,5110,4598,512
15416,b-3_6701-6800_6748.wav,VTTS_b-3_6701-6800_6748.wav,4040,4249,-209
15417,b-1_2927-3025_2946.wav,VTTS_b-1_2927-3025_2946.wav,1860,1765,95
15418,b-3_4104-4206_4184.wav,VTTS_b-3_4104-4206_4184.wav,6540,7848,-1308
15419,b-3_196-293_204.wav,VTTS_b-3_196-293_204.wav,4710,5317,-607
15420,b-1_4322-4357_4328.wav,VTTS_b-1_4322-4357_4328.wav,1530,1405,125
15421,b-3_5428-5533_5464.wav,VTTS_b-3_5428-5533_5464.wav,6630,8557,-1927
15422,b-3_6116-6215_6122.wav,VTTS_b-3_6116-6215_6122.wav,5610,5840,-230
15423,b-3_3454-3537_3474.wav,VTTS_b-3_3454-3537_3474.wav,4790,4598,192
15424,b-2_713-814_771.wav,VTTS_b-2_713-814_771.wav,2520,2322,198
15425,b-2_713-814_723.wav,VTTS_b-2_713-814_723.wav,1960,2264,-304
15426,b-4_2000-5164_2161.wav,VTTS_b-4_2000-5164_2161.wav,2205,1881,324
15427,b-4_2000-5164_2779.wav,VTTS_b-4_2000-5164_2779.wav,6685,6583,102
15428,b-3_1079-1320_1315.wav,VTTS_b-3_1079-1320_1315.wav,5290,4690,600
15429,b-4_1814-1900_1856.wav,VTTS_b-4_1814-1900_1856.wav,2880,2740,140
15430,b-1_1313-1413_1316.wav,VTTS_b-1_1313-1413_1316.wav,1200,1033,167
15431,b-4_1901-2000_1989.wav,VTTS_b-4_1901-2000_1989.wav,2930,2113,817
15432,b-1_1313-1413_1336.wav,VTTS_b-1_1313-1413_1336.wav,3170,3181,-11
15433,b-3_3889-4000_3905.wav,VTTS_b-3_3889-4000_3905.wav,4910,4505,405
15434,b-1_2624-2724_2634.wav,VTTS_b-1_2624-2724_2634.wav,1290,1312,-22
15435,b-1_3228-3328_3278.wav,VTTS_b-1_3228-3328_3278.wav,2010,2299,-289
15436,b-3_1079-1320_1127.wav,VTTS_b-3_1079-1320_1127.wav,9350,9532,-182
15437,b-1_1616-1716_1696.wav,VTTS_b-1_1616-1716_1696.wav,1830,1939,-109
15438,b-4_1101-1220_1195.wav,VTTS_b-4_1101-1220_1195.wav,2220,1811,409
15439,b-4_2000-5164_3111.wav,VTTS_b-4_2000-5164_3111.wav,4815,7221,-2406
15440,b-4_2000-5164_3106.wav,VTTS_b-4_2000-5164_3106.wav,3059,2798,261
15441,b-3_2000-2088_2008.wav,VTTS_b-3_2000-2088_2008.wav,8990,9346,-356
15442,b-4_501-1014_519.wav,VTTS_b-4_501-1014_519.wav,2590,2322,268
15443,b-4_2000-5164_4549.wav,VTTS_b-4_2000-5164_4549.wav,6654,6664,-10
15444,b-4_2000-5164_5138.wav,VTTS_b-4_2000-5164_5138.wav,5834,3622,2212
15445,b-1_3531-3631_3538.wav,VTTS_b-1_3531-3631_3538.wav,2150,2752,-602
15446,b-3_5009-5427_5298.wav,VTTS_b-3_5009-5427_5298.wav,3690,4272,-582
15447,b-4_2000-5164_4268.wav,VTTS_b-4_2000-5164_4268.wav,11468,10879,589
15448,b-3_6900-7016_6922.wav,VTTS_b-3_6900-7016_6922.wav,7570,7233,337
15449,b-1_3228-3328_3280.wav,VTTS_b-1_3228-3328_3280.wav,4600,4725,-125
15450,b-4_2000-5164_2786.wav,VTTS_b-4_2000-5164_2786.wav,2555,2601,-46
15451,b-3_2943-3024_2993.wav,VTTS_b-3_2943-3024_2993.wav,3980,3924,56
15452,b-3_3279-3363_3281.wav,VTTS_b-3_3279-3363_3281.wav,3980,3309,671
15453,b-1_1212-1312_1256.wav,VTTS_b-1_1212-1312_1256.wav,1460,1985,-525
15454,b-1_1717-1817_1795.wav,VTTS_b-1_1717-1817_1795.wav,1970,1625,345
15455,b-3_5533-5638_5553.wav,VTTS_b-3_5533-5638_5553.wav,2990,2624,366
15456,b-3_4607-5008_4620.wav,VTTS_b-3_4607-5008_4620.wav,2230,2090,140
15457,b-3_5009-5427_5270.wav,VTTS_b-3_5009-5427_5270.wav,14770,11610,3160
15458,b-3_1321-1568_1365.wav,VTTS_b-3_1321-1568_1365.wav,4270,3587,683
15459,b-1_4034-4069_4061.wav,VTTS_b-1_4034-4069_4061.wav,2340,2508,-168
15460,b-2_407-508_447.wav,VTTS_b-2_407-508_447.wav,1470,1393,77
15461,b-1_2523-2623_2569.wav,VTTS_b-1_2523-2623_2569.wav,5140,6200,-1060
15462,b-3_3025-3111_3054.wav,VTTS_b-3_3025-3111_3054.wav,4660,4156,504
15463,b-2_2311-2412_2394.wav,VTTS_b-2_2311-2412_2394.wav,1560,1382,178
15464,b-3_931-979_970.wav,VTTS_b-3_931-979_970.wav,3270,2879,391
15465,b-3_2943-3024_2998.wav,VTTS_b-3_2943-3024_2998.wav,5490,6026,-536
15466,b-3_4315-4424_4353.wav,VTTS_b-3_4315-4424_4353.wav,9300,8545,755
15467,b-4_1221-1300_1266.wav,VTTS_b-4_1221-1300_1266.wav,7890,7721,169
15468,b-3_501-930_907.wav,VTTS_b-3_501-930_907.wav,3950,3622,328
15469,b-4_2000-5164_3839.wav,VTTS_b-4_2000-5164_3839.wav,7569,7941,-372
15470,b-1_3127-3227_3146.wav,VTTS_b-1_3127-3227_3146.wav,4180,3889,291
15471,b-1_2927-3025_2966.wav,VTTS_b-1_2927-3025_2966.wav,3710,5747,-2037
15472,b-4_2000-5164_4038.wav,VTTS_b-4_2000-5164_4038.wav,7814,7454,360
15473,b-2_1-100_32.wav,VTTS_b-2_1-100_32.wav,4230,5805,-1575
15474,b-3_5009-5427_5263.wav,VTTS_b-3_5009-5427_5263.wav,4480,4493,-13
15475,b-2_1427-1562_1441.wav,VTTS_b-2_1427-1562_1441.wav,4050,4598,-548
15476,b-1_1515-1615_1539.wav,VTTS_b-1_1515-1615_1539.wav,830,743,87
15477,b-2_1325-1426_1409.wav,VTTS_b-2_1325-1426_1409.wav,2660,2403,257
15478,b-3_294-391_297.wav,VTTS_b-3_294-391_297.wav,3600,3448,152
15479,b-1_2321-2421_2419.wav,VTTS_b-1_2321-2421_2419.wav,1650,1741,-91
15480,b-4_1101-1220_1200.wav,VTTS_b-4_1101-1220_1200.wav,3120,2891,229
15481,b-2_2209-2310_2291.wav,VTTS_b-2_2209-2310_2291.wav,2060,1950,110
15482,b-4_2000-5164_4856.wav,VTTS_b-4_2000-5164_4856.wav,7904,7361,543
15483,b-1_175-275_269.wav,VTTS_b-1_175-275_269.wav,3640,3437,203
15484,b-3_3715-3802_3725.wav,VTTS_b-3_3715-3802_3725.wav,6590,6502,88
15485,b-1_2523-2623_2564.wav,VTTS_b-1_2523-2623_2564.wav,3010,2868,142
15486,b-3_4104-4206_4177.wav,VTTS_b-3_4104-4206_4177.wav,3720,4307,-587
15487,b-4_2000-5164_3202.wav,VTTS_b-4_2000-5164_3202.wav,3279,3750,-471
15488,b-4_2000-5164_4976.wav,VTTS_b-4_2000-5164_4976.wav,7058,6536,522
15489,b-1_794-1009_839.wav,VTTS_b-1_794-1009_839.wav,1280,1057,223
15490,b-3_98-195_123.wav,VTTS_b-3_98-195_123.wav,3490,3796,-306
15491,b-4_1101-1220_1127.wav,VTTS_b-4_1101-1220_1127.wav,7450,7117,333
15492,b-1_2018-2118_2089.wav,VTTS_b-1_2018-2118_2089.wav,1430,1382,48
15493,b-1_1010-1110_1032.wav,VTTS_b-1_1010-1110_1032.wav,4420,3332,1088
15494,b-3_2943-3024_3015.wav,VTTS_b-3_2943-3024_3015.wav,4860,4992,-132
15495,b-2_305-406_312.wav,VTTS_b-2_305-406_312.wav,1630,1591,39
15496,b-3_5428-5533_5526.wav,VTTS_b-3_5428-5533_5526.wav,6560,7721,-1161
15497,b-4_2000-5164_4602.wav,VTTS_b-4_2000-5164_4602.wav,3442,3994,-552
15498,b-4_2000-5164_4571.wav,VTTS_b-4_2000-5164_4571.wav,4585,4354,231
15499,b-3_5957-6015_6001.wav,VTTS_b-3_5957-6015_6001.wav,2550,2403,147
15500,b-1_3430-3530_3449.wav,VTTS_b-1_3430-3530_3449.wav,2330,2264,66
15501,b-4_2000-5164_4761.wav,VTTS_b-4_2000-5164_4761.wav,2632,2276,356
15502,b-4_53-150_68.wav,VTTS_b-4_53-150_68.wav,10050,8766,1284
15503,b-3_2000-2088_2026.wav,VTTS_b-3_2000-2088_2026.wav,2840,2705,135
15504,b-2_815-916_818.wav,VTTS_b-2_815-916_818.wav,1510,1440,70
15505,b-1_2321-2421_2397.wav,VTTS_b-1_2321-2421_2397.wav,1200,1045,155
15506,b-4_2000-5164_4726.wav,VTTS_b-4_2000-5164_4726.wav,4191,4667,-476
15507,b-3_392-500_437.wav,VTTS_b-3_392-500_437.wav,2360,2218,142
15508,b-2_1223-1324_1316.wav,VTTS_b-2_1223-1324_1316.wav,2890,3831,-941
15509,b-3_3025-3111_3103.wav,VTTS_b-3_3025-3111_3103.wav,5980,6861,-881
15510,b-4_2000-5164_3789.wav,VTTS_b-4_2000-5164_3789.wav,2280,2218,62
15511,b-4_2000-5164_2657.wav,VTTS_b-4_2000-5164_2657.wav,3270,3297,-27
15512,b-4_401-500_456.wav,VTTS_b-4_401-500_456.wav,3860,5759,-1899
15513,b-4_501-1014_644.wav,VTTS_b-4_501-1014_644.wav,5490,5050,440
15514,b-2_1563-1596_1596.wav,VTTS_b-2_1563-1596_1596.wav,4030,4168,-138
15515,b-3_980-1077_1008.wav,VTTS_b-3_980-1077_1008.wav,3800,3843,-43
15516,b-3_4315-4424_4319.wav,VTTS_b-3_4315-4424_4319.wav,6580,7210,-630
15517,b-3_6701-6800_6709.wav,VTTS_b-3_6701-6800_6709.wav,6680,5364,1316
15518,b-1_1-73_15.wav,VTTS_b-1_1-73_15.wav,4600,5399,-799
15519,b-4_2000-5164_4582.wav,VTTS_b-4_2000-5164_4582.wav,8454,8324,130
15520,b-2_1597-1698_1613.wav,VTTS_b-2_1597-1698_1613.wav,3350,3088,262
15521,b-3_392-500_412.wav,VTTS_b-3_392-500_412.wav,2450,3088,-638
15522,b-3_5853-5956_5954.wav,VTTS_b-3_5853-5956_5954.wav,5230,4447,783
15523,b-4_501-1014_842.wav,VTTS_b-4_501-1014_842.wav,5720,5352,368
15524,b-2_917-1018_1002.wav,VTTS_b-2_917-1018_1002.wav,3360,3216,144
15525,b-1_1414-1514_1454.wav,VTTS_b-1_1414-1514_1454.wav,1350,1382,-32
15526,b-4_1401-1505_1480.wav,VTTS_b-4_1401-1505_1480.wav,2560,2740,-180
15527,b-3_5533-5638_5558.wav,VTTS_b-3_5533-5638_5558.wav,7100,6200,900
15528,b-1_4358-4393_4382.wav,VTTS_b-1_4358-4393_4382.wav,1660,1672,-12
15529,b-3_1079-1320_1136.wav,VTTS_b-3_1079-1320_1136.wav,9270,9033,237
15530,b-3_5009-5427_5229.wav,VTTS_b-3_5009-5427_5229.wav,1230,1126,104
15531,b-2_815-916_903.wav,VTTS_b-2_815-916_903.wav,3460,3239,221
15532,b-4_2000-5164_3979.wav,VTTS_b-4_2000-5164_3979.wav,4001,4493,-492
15533,b-1_1414-1514_1472.wav,VTTS_b-1_1414-1514_1472.wav,3220,2264,956
15534,b-4_2000-5164_3632.wav,VTTS_b-4_2000-5164_3632.wav,5009,5457,-448
15535,b-1_1717-1817_1769.wav,VTTS_b-1_1717-1817_1769.wav,1680,1625,55
15536,b-3_4607-5008_4932.wav,VTTS_b-3_4607-5008_4932.wav,4320,3913,407
15537,b-3_4315-4424_4395.wav,VTTS_b-3_4315-4424_4395.wav,4220,4145,75
15538,b-3_4104-4206_4115.wav,VTTS_b-3_4104-4206_4115.wav,5670,5631,39
15539,b-1_478-578_548.wav,VTTS_b-1_478-578_548.wav,4200,3692,508
15540,b-1_3026-3126_3078.wav,VTTS_b-1_3026-3126_3078.wav,5560,11610,-6050
15541,b-2_611-712_648.wav,VTTS_b-2_611-712_648.wav,920,1057,-137
15542,b-4_151-300_271.wav,VTTS_b-4_151-300_271.wav,8490,11610,-3120
15543,b-2_1-100_63.wav,VTTS_b-2_1-100_63.wav,1760,2519,-759
15544,b-3_1-97_51.wav,VTTS_b-3_1-97_51.wav,9080,9451,-371
15545,b-3_6601-6700_6623.wav,VTTS_b-3_6601-6700_6623.wav,3190,2694,496
15546,b-1_478-578_529.wav,VTTS_b-1_478-578_529.wav,2530,2589,-59
15547,b-3_6301-6400_6371.wav,VTTS_b-3_6301-6400_6371.wav,2600,2183,417
15548,b-3_3889-4000_3976.wav,VTTS_b-3_3889-4000_3976.wav,2670,3007,-337
15549,b-3_4315-4424_4364.wav,VTTS_b-3_4315-4424_4364.wav,8400,7732,668
15550,b-1_794-1009_859.wav,VTTS_b-1_794-1009_859.wav,2840,3390,-550
15551,b-3_6016-6115_6022.wav,VTTS_b-3_6016-6115_6022.wav,4540,3344,1196
15552,b-3_2267-2349_2293.wav,VTTS_b-3_2267-2349_2293.wav,5990,6374,-384
15553,b-1_3127-3227_3133.wav,VTTS_b-1_3127-3227_3133.wav,3030,2926,104
15554,b-4_2000-5164_3011.wav,VTTS_b-4_2000-5164_3011.wav,5972,5805,167
15555,b-3_1666-1763_1721.wav,VTTS_b-3_1666-1763_1721.wav,3140,3576,-436
15556,b-3_2943-3024_3010.wav,VTTS_b-3_2943-3024_3010.wav,6240,6467,-227
15557,b-1_3733-3833_3819.wav,VTTS_b-1_3733-3833_3819.wav,2040,1927,113
15558,b-1_2422-2522_2441.wav,VTTS_b-1_2422-2522_2441.wav,1910,1625,285
15559,b-1_2826-2926_2870.wav,VTTS_b-1_2826-2926_2870.wav,1600,1672,-72
15560,b-3_931-979_965.wav,VTTS_b-3_931-979_965.wav,4380,4238,142
15561,b-3_2350-2433_2362.wav,VTTS_b-3_2350-2433_2362.wav,4970,3657,1313
15562,b-2_815-916_871.wav,VTTS_b-2_815-916_871.wav,1170,1533,-363
15563,b-3_3198-3278_3221.wav,VTTS_b-3_3198-3278_3221.wav,2700,2554,146
15564,b-1_579-649_618.wav,VTTS_b-1_579-649_618.wav,1140,1405,-265
15565,b-3_501-930_895.wav,VTTS_b-3_501-930_895.wav,2670,2531,139
15566,b-4_2000-5164_2464.wav,VTTS_b-4_2000-5164_2464.wav,2580,3541,-961
15567,b-3_196-293_224.wav,VTTS_b-3_196-293_224.wav,2370,2229,141
15568,b-3_980-1077_1073.wav,VTTS_b-3_980-1077_1073.wav,7510,6432,1078
15569,b-3_4607-5008_4694.wav,VTTS_b-3_4607-5008_4694.wav,8030,8313,-283
15570,b-4_1-52_7.wav,VTTS_b-4_1-52_7.wav,4950,4876,74
15571,b-3_1862-1959_1869.wav,VTTS_b-3_1862-1959_1869.wav,2020,1846,174
15572,b-4_1221-1300_1254.wav,VTTS_b-4_1221-1300_1254.wav,3110,2728,382
15573,b-2_203-304_280.wav,VTTS_b-2_203-304_280.wav,1170,1091,79
15574,b-1_276-376_317.wav,VTTS_b-1_276-376_317.wav,4960,6536,-1576
15575,b-1_1313-1413_1330.wav,VTTS_b-1_1313-1413_1330.wav,4200,3855,345
15576,b-4_2000-5164_3924.wav,VTTS_b-4_2000-5164_3924.wav,5674,6269,-595
15577,b-3_3198-3278_3233.wav,VTTS_b-3_3198-3278_3233.wav,7320,6908,412
15578,b-4_2000-5164_4914.wav,VTTS_b-4_2000-5164_4914.wav,2117,1974,143
15579,b-4_1707-1813_1794.wav,VTTS_b-4_1707-1813_1794.wav,4600,4435,165
15580,b-4_2000-5164_2256.wav,VTTS_b-4_2000-5164_2256.wav,8320,7639,681
15581,b-1_1-73_18.wav,VTTS_b-1_1-73_18.wav,3090,3425,-335
15582,b-3_5009-5427_5068.wav,VTTS_b-3_5009-5427_5068.wav,1080,917,163
15583,b-3_6401-6500_6429.wav,VTTS_b-3_6401-6500_6429.wav,3280,3286,-6
15584,b-4_2000-5164_2769.wav,VTTS_b-4_2000-5164_2769.wav,3420,4923,-1503
15585,b-4_1401-1505_1458.wav,VTTS_b-4_1401-1505_1458.wav,6890,6954,-64
15586,b-2_713-814_806.wav,VTTS_b-2_713-814_806.wav,3160,3367,-207
15587,b-3_6601-6700_6610.wav,VTTS_b-3_6601-6700_6610.wav,4450,4133,317
15588,b-1_3329-3429_3371.wav,VTTS_b-1_3329-3429_3371.wav,2860,2775,85
15589,b-4_2000-5164_4696.wav,VTTS_b-4_2000-5164_4696.wav,2862,2798,64
15590,b-3_5639-5744_5711.wav,VTTS_b-3_5639-5744_5711.wav,2410,2844,-434
15591,b-4_1601-1706_1610.wav,VTTS_b-4_1601-1706_1610.wav,3980,3715,265
15592,b-4_2000-5164_4086.wav,VTTS_b-4_2000-5164_4086.wav,5480,5236,244
15593,b-1_2624-2724_2685.wav,VTTS_b-1_2624-2724_2685.wav,4650,5271,-621
15594,b-3_4001-4103_4062.wav,VTTS_b-3_4001-4103_4062.wav,12900,11610,1290
15595,b-4_2000-5164_3648.wav,VTTS_b-4_2000-5164_3648.wav,5296,5793,-497
15596,b-1_2523-2623_2612.wav,VTTS_b-1_2523-2623_2612.wav,1180,1184,-4
15597,b-3_98-195_114.wav,VTTS_b-3_98-195_114.wav,2390,2194,196
15598,b-4_2000-5164_5139.wav,VTTS_b-4_2000-5164_5139.wav,5619,6165,-546
15599,b-4_2000-5164_2304.wav,VTTS_b-4_2000-5164_2304.wav,4690,4737,-47
15600,b-2_1427-1562_1562.wav,VTTS_b-2_1427-1562_1562.wav,7610,8022,-412
15601,b-1_1-73_62.wav,VTTS_b-1_1-73_62.wav,4100,4052,48
15602,b-3_1079-1320_1198.wav,VTTS_b-3_1079-1320_1198.wav,3580,3587,-7
15603,b-2_2413-2500_2416.wav,VTTS_b-2_2413-2500_2416.wav,930,4934,-4004
15604,b-1_4214-4285_4216.wav,VTTS_b-1_4214-4285_4216.wav,2560,2856,-296
15605,b-4_501-1014_812.wav,VTTS_b-4_501-1014_812.wav,5250,5445,-195
15606,b-2_1903-2038_1926.wav,VTTS_b-2_1903-2038_1926.wav,4910,7465,-2555
15607,b-3_1079-1320_1164.wav,VTTS_b-3_1079-1320_1164.wav,3840,3669,171
15608,b-1_4358-4393_4380.wav,VTTS_b-1_4358-4393_4380.wav,2250,2322,-72
15609,b-3_2089-2176_2096.wav,VTTS_b-3_2089-2176_2096.wav,6720,7546,-826
15610,b-3_4607-5008_4723.wav,VTTS_b-3_4607-5008_4723.wav,3820,4063,-243
15611,b-3_3112-3197_3154.wav,VTTS_b-3_3112-3197_3154.wav,4350,3448,902
15612,b-3_5428-5533_5477.wav,VTTS_b-3_5428-5533_5477.wav,5100,5433,-333
15613,b-4_2000-5164_4438.wav,VTTS_b-4_2000-5164_4438.wav,1508,1416,92
15614,b-3_1960-2000_1972.wav,VTTS_b-3_1960-2000_1972.wav,1810,1707,103
15615,b-4_2000-5164_3799.wav,VTTS_b-4_2000-5164_3799.wav,2720,2612,108
15616,b-3_4315-4424_4369.wav,VTTS_b-3_4315-4424_4369.wav,5760,5596,164
15617,b-3_1321-1568_1543.wav,VTTS_b-3_1321-1568_1543.wav,8730,7755,975
15618,b-3_3279-3363_3303.wav,VTTS_b-3_3279-3363_3303.wav,5450,5085,365
15619,b-2_305-406_389.wav,VTTS_b-2_305-406_389.wav,2710,2844,-134
15620,b-2_1019-1120_1112.wav,VTTS_b-2_1019-1120_1112.wav,2130,2438,-308
15621,b-1_3228-3328_3267.wav,VTTS_b-1_3228-3328_3267.wav,6380,7105,-725
15622,b-3_5533-5638_5618.wav,VTTS_b-3_5533-5638_5618.wav,6020,5898,122
15623,b-1_686-793_791.wav,VTTS_b-1_686-793_791.wav,1180,1138,42
15624,b-2_1325-1426_1424.wav,VTTS_b-2_1325-1426_1424.wav,1690,1498,192
15625,b-4_2000-5164_3442.wav,VTTS_b-4_2000-5164_3442.wav,3355,4180,-825
15626,b-4_2000-5164_4114.wav,VTTS_b-4_2000-5164_4114.wav,6683,6966,-283
15627,b-3_1321-1568_1428.wav,VTTS_b-3_1321-1568_1428.wav,2660,2717,-57
15628,b-4_501-1014_729.wav,VTTS_b-4_501-1014_729.wav,3100,3100,0
15629,b-4_2000-5164_3055.wav,VTTS_b-4_2000-5164_3055.wav,9785,9276,509
15630,b-4_2000-5164_2346.wav,VTTS_b-4_2000-5164_2346.wav,6465,11610,-5145
15631,b-1_4358-4393_4364.wav,VTTS_b-1_4358-4393_4364.wav,2250,2879,-629
15632,b-3_2524-2854_2575.wav,VTTS_b-3_2524-2854_2575.wav,3670,3402,268
15633,b-4_2000-5164_4720.wav,VTTS_b-4_2000-5164_4720.wav,4924,4969,-45
15634,b-4_2000-5164_3694.wav,VTTS_b-4_2000-5164_3694.wav,2040,1637,403
15635,b-4_1401-1505_1438.wav,VTTS_b-4_1401-1505_1438.wav,4800,4748,52
15636,b-4_501-1014_820.wav,VTTS_b-4_501-1014_820.wav,10390,8557,1833
15637,b-3_5009-5427_5144.wav,VTTS_b-3_5009-5427_5144.wav,3480,3425,55
15638,b-1_2826-2926_2867.wav,VTTS_b-1_2826-2926_2867.wav,4780,5224,-444
15639,b-4_2000-5164_3740.wav,VTTS_b-4_2000-5164_3740.wav,9140,9497,-357
15640,b-1_3632-3732_3718.wav,VTTS_b-1_3632-3732_3718.wav,5110,5457,-347
15641,b-3_6301-6400_6329.wav,VTTS_b-3_6301-6400_6329.wav,4420,3947,473
15642,b-3_5428-5533_5498.wav,VTTS_b-3_5428-5533_5498.wav,5250,4876,374
15643,b-4_2000-5164_2892.wav,VTTS_b-4_2000-5164_2892.wav,875,906,-31
15644,b-1_1212-1312_1304.wav,VTTS_b-1_1212-1312_1304.wav,1750,2577,-827
15645,b-3_6116-6215_6198.wav,VTTS_b-3_6116-6215_6198.wav,3480,3669,-189
15646,b-1_3430-3530_3498.wav,VTTS_b-1_3430-3530_3498.wav,2010,2067,-57
15647,b-3_3112-3197_3174.wav,VTTS_b-3_3112-3197_3174.wav,3030,3204,-174
15648,b-3_3279-3363_3279.wav,VTTS_b-3_3279-3363_3279.wav,9470,8940,530
15649,b-1_1010-1110_1066.wav,VTTS_b-1_1010-1110_1066.wav,2410,2461,-51
15650,b-2_1427-1562_1431.wav,VTTS_b-2_1427-1562_1431.wav,4360,5677,-1317
15651,b-3_5533-5638_5546.wav,VTTS_b-3_5533-5638_5546.wav,2760,2566,194
15652,b-1_3430-3530_3505.wav,VTTS_b-1_3430-3530_3505.wav,1550,1509,41
15653,b-2_1903-2038_1960.wav,VTTS_b-2_1903-2038_1960.wav,3650,3065,585
15654,b-4_151-300_162.wav,VTTS_b-4_151-300_162.wav,9450,7964,1486
15655,b-3_1666-1763_1683.wav,VTTS_b-3_1666-1763_1683.wav,5300,5991,-691
15656,b-3_4315-4424_4376.wav,VTTS_b-3_4315-4424_4376.wav,2420,2519,-99
15657,b-4_1506-1600_1526.wav,VTTS_b-4_1506-1600_1526.wav,1660,1498,162
15658,b-1_377-477_381.wav,VTTS_b-1_377-477_381.wav,2800,2856,-56
15659,b-4_2000-5164_3083.wav,VTTS_b-4_2000-5164_3083.wav,7656,7674,-18
15660,b-1_4358-4393_4366.wav,VTTS_b-1_4358-4393_4366.wav,1530,1451,79
15661,b-1_4430-4465_4451.wav,VTTS_b-1_4430-4465_4451.wav,2410,2334,76
15662,b-3_4001-4103_4076.wav,VTTS_b-3_4001-4103_4076.wav,5910,5782,128
15663,b-3_2524-2854_2837.wav,VTTS_b-3_2524-2854_2837.wav,1550,1544,6
15664,b-4_2000-5164_3368.wav,VTTS_b-4_2000-5164_3368.wav,4579,5399,-820
15665,b-3_2000-2088_2045.wav,VTTS_b-3_2000-2088_2045.wav,2250,2159,91
15666,b-3_3538-3627_3567.wav,VTTS_b-3_3538-3627_3567.wav,5530,6060,-530
15667,b-3_5009-5427_5158.wav,VTTS_b-3_5009-5427_5158.wav,12330,10844,1486
15668,b-2_203-304_290.wav,VTTS_b-2_203-304_290.wav,2360,2926,-566
15669,b-1_3531-3631_3613.wav,VTTS_b-1_3531-3631_3613.wav,2860,2902,-42
15670,b-3_6401-6500_6436.wav,VTTS_b-3_6401-6500_6436.wav,4950,5283,-333
15671,b-4_1901-2000_1907.wav,VTTS_b-4_1901-2000_1907.wav,3230,3216,14
15672,b-1_1515-1615_1549.wav,VTTS_b-1_1515-1615_1549.wav,1370,1126,244
15673,b-3_6801-6900_6865.wav,VTTS_b-3_6801-6900_6865.wav,3510,3622,-112
15674,b-2_1325-1426_1392.wav,VTTS_b-2_1325-1426_1392.wav,900,964,-64
15675,b-3_1079-1320_1273.wav,VTTS_b-3_1079-1320_1273.wav,6000,6502,-502
15676,b-2_101-202_157.wav,VTTS_b-2_101-202_157.wav,4100,4249,-149
15677,b-3_294-391_354.wav,VTTS_b-3_294-391_354.wav,5990,6188,-198
15678,b-4_1901-2000_1974.wav,VTTS_b-4_1901-2000_1974.wav,4660,4412,248
15679,b-4_2000-5164_2726.wav,VTTS_b-4_2000-5164_2726.wav,4140,4214,-74
15680,b-1_3632-3732_3688.wav,VTTS_b-1_3632-3732_3688.wav,3500,3529,-29
15681,b-4_501-1014_540.wav,VTTS_b-4_501-1014_540.wav,5590,5143,447
15682,b-4_2000-5164_3428.wav,VTTS_b-4_2000-5164_3428.wav,3550,3251,299
15683,b-3_501-930_817.wav,VTTS_b-3_501-930_817.wav,7880,8684,-804
15684,b-4_2000-5164_2326.wav,VTTS_b-4_2000-5164_2326.wav,2630,2902,-272
15685,b-2_1-100_56.wav,VTTS_b-2_1-100_56.wav,4270,4354,-84
15686,b-1_2321-2421_2342.wav,VTTS_b-1_2321-2421_2342.wav,4130,4679,-549
15687,b-4_2000-5164_3917.wav,VTTS_b-4_2000-5164_3917.wav,4436,5596,-1160
15688,b-3_3198-3278_3230.wav,VTTS_b-3_3198-3278_3230.wav,3780,3564,216
15689,b-1_1515-1615_1590.wav,VTTS_b-1_1515-1615_1590.wav,1400,1567,-167
15690,b-3_2089-2176_2097.wav,VTTS_b-3_2089-2176_2097.wav,3880,3390,490
15691,b-3_1321-1568_1542.wav,VTTS_b-3_1321-1568_1542.wav,4550,4354,196
15692,b-4_2000-5164_2966.wav,VTTS_b-4_2000-5164_2966.wav,5193,5933,-740
15693,b-1_1111-1211_1173.wav,VTTS_b-1_1111-1211_1173.wav,4430,3994,436
15694,b-3_4607-5008_4751.wav,VTTS_b-3_4607-5008_4751.wav,3360,3622,-262
15695,b-4_2000-5164_3443.wav,VTTS_b-4_2000-5164_3443.wav,6050,7396,-1346
15696,b-4_2000-5164_4687.wav,VTTS_b-4_2000-5164_4687.wav,4111,4272,-161
15697,b-4_2000-5164_2610.wav,VTTS_b-4_2000-5164_2610.wav,2985,3437,-452
15698,b-4_1707-1813_1790.wav,VTTS_b-4_1707-1813_1790.wav,6410,5352,1058
15699,b-4_501-1014_701.wav,VTTS_b-4_501-1014_701.wav,5340,5074,266
15700,b-3_1321-1568_1384.wav,VTTS_b-3_1321-1568_1384.wav,5070,4795,275
15701,b-4_2000-5164_3219.wav,VTTS_b-4_2000-5164_3219.wav,4927,5271,-344
15702,b-3_501-930_779.wav,VTTS_b-3_501-930_779.wav,6530,6014,516
15703,b-4_2000-5164_3621.wav,VTTS_b-4_2000-5164_3621.wav,4368,4714,-346
15704,b-1_2523-2623_2552.wav,VTTS_b-1_2523-2623_2552.wav,2380,3483,-1103
15705,b-3_6900-7016_6971.wav,VTTS_b-3_6900-7016_6971.wav,4470,5166,-696
15706,b-3_3715-3802_3757.wav,VTTS_b-3_3715-3802_3757.wav,6670,6757,-87
15707,b-2_2209-2310_2294.wav,VTTS_b-2_2209-2310_2294.wav,2840,2868,-28
15708,b-1_2321-2421_2407.wav,VTTS_b-1_2321-2421_2407.wav,1790,1614,176
15709,b-1_1-73_68.wav,VTTS_b-1_1-73_68.wav,2980,2984,-4
15710,b-3_4425-4497_4452.wav,VTTS_b-3_4425-4497_4452.wav,6260,6490,-230
15711,b-3_501-930_743.wav,VTTS_b-3_501-930_743.wav,3110,3065,45
15712,b-3_3715-3802_3796.wav,VTTS_b-3_3715-3802_3796.wav,5350,5433,-83
15713,b-3_5639-5744_5719.wav,VTTS_b-3_5639-5744_5719.wav,3770,3750,20
15714,b-3_6116-6215_6186.wav,VTTS_b-3_6116-6215_6186.wav,9100,9381,-281
15715,b-4_2000-5164_4102.wav,VTTS_b-4_2000-5164_4102.wav,10476,10101,375
15716,b-4_2000-5164_2389.wav,VTTS_b-4_2000-5164_2389.wav,6450,6246,204
15717,b-1_1414-1514_1416.wav,VTTS_b-1_1414-1514_1416.wav,2390,3100,-710
15718,b-3_501-930_810.wav,VTTS_b-3_501-930_810.wav,5000,5410,-410
15719,b-4_401-500_458.wav,VTTS_b-4_401-500_458.wav,5100,5050,50
15720,b-4_2000-5164_3930.wav,VTTS_b-4_2000-5164_3930.wav,6433,6722,-289
15721,b-4_2000-5164_3920.wav,VTTS_b-4_2000-5164_3920.wav,4375,4272,103
15722,b-2_2107-2193_2183.wav,VTTS_b-2_2107-2193_2183.wav,1480,1382,98
15723,b-3_4498-4605_4515.wav,VTTS_b-3_4498-4605_4515.wav,6840,8255,-1415
15724,b-3_4315-4424_4373.wav,VTTS_b-3_4315-4424_4373.wav,7300,8243,-943
15725,b-3_392-500_464.wav,VTTS_b-3_392-500_464.wav,5090,5039,51
15726,b-3_1764-1861_1787.wav,VTTS_b-3_1764-1861_1787.wav,1990,1730,260
15727,b-1_74-174_147.wav,VTTS_b-1_74-174_147.wav,2920,2670,250
15728,b-3_1321-1568_1424.wav,VTTS_b-3_1321-1568_1424.wav,3140,3053,87
15729,b-4_1601-1706_1636.wav,VTTS_b-4_1601-1706_1636.wav,4250,3947,303
15730,b-1_2826-2926_2885.wav,VTTS_b-1_2826-2926_2885.wav,4950,5828,-878
15731,b-3_1862-1959_1874.wav,VTTS_b-3_1862-1959_1874.wav,1900,2125,-225
15732,b-1_3834-3934_3857.wav,VTTS_b-1_3834-3934_3857.wav,4430,5248,-818
15733,b-1_2624-2724_2632.wav,VTTS_b-1_2624-2724_2632.wav,1820,1718,102
15734,b-4_2000-5164_2055.wav,VTTS_b-4_2000-5164_2055.wav,7455,8963,-1508
15735,b-4_1101-1220_1126.wav,VTTS_b-4_1101-1220_1126.wav,12250,11610,640
15736,b-1_1919-2017_2006.wav,VTTS_b-1_1919-2017_2006.wav,1070,1010,60
15737,b-3_5009-5427_5402.wav,VTTS_b-3_5009-5427_5402.wav,3290,3773,-483
15738,b-1_1616-1716_1619.wav,VTTS_b-1_1616-1716_1619.wav,1720,1474,246
15739,b-3_4607-5008_5008.wav,VTTS_b-3_4607-5008_5008.wav,2440,2183,257
15740,b-3_501-930_889.wav,VTTS_b-3_501-930_889.wav,8590,7268,1322
15741,b-3_501-930_738.wav,VTTS_b-3_501-930_738.wav,3560,3181,379
15742,b-1_1313-1413_1382.wav,VTTS_b-1_1313-1413_1382.wav,3510,3820,-310
15743,b-3_3198-3278_3245.wav,VTTS_b-3_3198-3278_3245.wav,12340,11610,730
15744,b-3_1-97_57.wav,VTTS_b-3_1-97_57.wav,3380,3228,152
15745,b-1_3127-3227_3160.wav,VTTS_b-1_3127-3227_3160.wav,2910,2914,-4
15746,b-4_1506-1600_1549.wav,VTTS_b-4_1506-1600_1549.wav,3680,4249,-569
15747,b-3_3112-3197_3197.wav,VTTS_b-3_3112-3197_3197.wav,5510,5422,88
15748,b-3_6217-6274_6225.wav,VTTS_b-3_6217-6274_6225.wav,4040,4609,-569
15749,b-3_6801-6900_6824.wav,VTTS_b-3_6801-6900_6824.wav,1700,1602,98
15750,b-2_1325-1426_1397.wav,VTTS_b-2_1325-1426_1397.wav,6160,6571,-411
15751,b-3_5957-6015_5988.wav,VTTS_b-3_5957-6015_5988.wav,8480,7419,1061
15752,b-3_3803-3888_3861.wav,VTTS_b-3_3803-3888_3861.wav,5430,5352,78
15753,b-4_2000-5164_4552.wav,VTTS_b-4_2000-5164_4552.wav,3264,3228,36
15754,b-2_1903-2038_1930.wav,VTTS_b-2_1903-2038_1930.wav,1390,1324,66
15755,b-3_6301-6400_6327.wav,VTTS_b-3_6301-6400_6327.wav,5250,4934,316
15756,b-2_1019-1120_1022.wav,VTTS_b-2_1019-1120_1022.wav,2910,3413,-503
15757,b-4_2000-5164_4608.wav,VTTS_b-4_2000-5164_4608.wav,5114,7082,-1968
15758,b-4_1401-1505_1497.wav,VTTS_b-4_1401-1505_1497.wav,3110,3123,-13
15759,b-4_1014-1100_1093.wav,VTTS_b-4_1014-1100_1093.wav,1540,1672,-132
15760,b-1_2422-2522_2476.wav,VTTS_b-1_2422-2522_2476.wav,1050,1033,17
15761,b-1_1414-1514_1486.wav,VTTS_b-1_1414-1514_1486.wav,2800,3077,-277
15762,b-3_1764-1861_1812.wav,VTTS_b-3_1764-1861_1812.wav,4390,4621,-231
15763,b-1_1818-1918_1839.wav,VTTS_b-1_1818-1918_1839.wav,2710,2926,-216
15764,b-3_3715-3802_3761.wav,VTTS_b-3_3715-3802_3761.wav,3800,3878,-78
15765,b-4_2000-5164_4721.wav,VTTS_b-4_2000-5164_4721.wav,2339,1985,354
15766,b-1_74-174_128.wav,VTTS_b-1_74-174_128.wav,1860,2032,-172
15767,b-4_2000-5164_3805.wav,VTTS_b-4_2000-5164_3805.wav,6206,6571,-365
15768,b-3_98-195_102.wav,VTTS_b-3_98-195_102.wav,9330,11610,-2280
15769,b-3_1568-1665_1657.wav,VTTS_b-3_1568-1665_1657.wav,7680,8173,-493
15770,b-2_2209-2310_2213.wav,VTTS_b-2_2209-2310_2213.wav,1950,1997,-47
15771,b-2_1699-1800_1733.wav,VTTS_b-2_1699-1800_1733.wav,3170,2705,465
15772,b-2_2413-2500_2484.wav,VTTS_b-2_2413-2500_2484.wav,1440,2125,-685
15773,b-1_3632-3732_3679.wav,VTTS_b-1_3632-3732_3679.wav,2130,2589,-459
15774,b-3_196-293_241.wav,VTTS_b-3_196-293_241.wav,3610,3158,452
15775,b-1_794-1009_967.wav,VTTS_b-1_794-1009_967.wav,3160,3135,25
15776,b-1_4286-4321_4310.wav,VTTS_b-1_4286-4321_4310.wav,1420,1707,-287
15777,b-4_2000-5164_2271.wav,VTTS_b-4_2000-5164_2271.wav,7360,8510,-1150
15778,b-4_2000-5164_4925.wav,VTTS_b-4_2000-5164_4925.wav,4889,5224,-335
15779,b-2_1019-1120_1049.wav,VTTS_b-2_1019-1120_1049.wav,3370,3402,-32
15780,b-3_6701-6800_6781.wav,VTTS_b-3_6701-6800_6781.wav,8190,6165,2025
15781,b-3_2434-2523_2515.wav,VTTS_b-3_2434-2523_2515.wav,5120,5201,-81
15782,b-4_2000-5164_2458.wav,VTTS_b-4_2000-5164_2458.wav,3270,3193,77
15783,b-4_2000-5164_3722.wav,VTTS_b-4_2000-5164_3722.wav,7710,8046,-336
15784,b-4_2000-5164_5064.wav,VTTS_b-4_2000-5164_5064.wav,5198,5074,124
15785,b-3_3715-3802_3717.wav,VTTS_b-3_3715-3802_3717.wav,6050,5654,396
15786,b-3_2000-2088_2023.wav,VTTS_b-3_2000-2088_2023.wav,1500,1347,153
15787,b-4_501-1014_681.wav,VTTS_b-4_501-1014_681.wav,1630,1834,-204
15788,b-3_2943-3024_2980.wav,VTTS_b-3_2943-3024_2980.wav,5090,5294,-204
15789,b-3_2855-2942_2882.wav,VTTS_b-3_2855-2942_2882.wav,3100,3425,-325
15790,b-3_3715-3802_3758.wav,VTTS_b-3_3715-3802_3758.wav,9160,9160,0
15791,b-1_3632-3732_3658.wav,VTTS_b-1_3632-3732_3658.wav,2030,2043,-13
15792,b-3_2267-2349_2318.wav,VTTS_b-3_2267-2349_2318.wav,5370,5132,238
15793,b-1_3228-3328_3293.wav,VTTS_b-1_3228-3328_3293.wav,3110,2345,765
15794,b-3_4207-4314_4288.wav,VTTS_b-3_4207-4314_4288.wav,4740,4365,375
15795,b-3_3538-3627_3601.wav,VTTS_b-3_3538-3627_3601.wav,4720,4586,134
15796,b-1_2321-2421_2325.wav,VTTS_b-1_2321-2421_2325.wav,1670,1567,103
15797,b-1_3329-3429_3405.wav,VTTS_b-1_3329-3429_3405.wav,2090,2136,-46
15798,b-1_2725-2825_2731.wav,VTTS_b-1_2725-2825_2731.wav,1860,1602,258
15799,b-1_794-1009_846.wav,VTTS_b-1_794-1009_846.wav,2780,2043,737
15800,b-4_301-400_398.wav,VTTS_b-4_301-400_398.wav,5620,5364,256
15801,b-4_501-1014_962.wav,VTTS_b-4_501-1014_962.wav,1690,1614,76
15802,b-3_294-391_333.wav,VTTS_b-3_294-391_333.wav,4030,4377,-347
15803,b-3_5639-5744_5673.wav,VTTS_b-3_5639-5744_5673.wav,9770,9276,494
15804,b-3_1321-1568_1525.wav,VTTS_b-3_1321-1568_1525.wav,3540,3228,312
15805,b-1_3430-3530_3439.wav,VTTS_b-1_3430-3530_3439.wav,1850,1765,85
15806,b-3_6016-6115_6081.wav,VTTS_b-3_6016-6115_6081.wav,2710,3855,-1145
15807,b-1_3127-3227_3164.wav,VTTS_b-1_3127-3227_3164.wav,5460,5573,-113
15808,b-4_1101-1220_1148.wav,VTTS_b-4_1101-1220_1148.wav,4930,4865,65
15809,b-4_2000-5164_4230.wav,VTTS_b-4_2000-5164_4230.wav,4175,4412,-237
15810,b-3_196-293_199.wav,VTTS_b-3_196-293_199.wav,3410,3123,287
15811,b-1_3834-3934_3904.wav,VTTS_b-1_3834-3934_3904.wav,2830,3309,-479
15812,b-4_2000-5164_2642.wav,VTTS_b-4_2000-5164_2642.wav,7530,7047,483
15813,b-3_3112-3197_3140.wav,VTTS_b-3_3112-3197_3140.wav,7090,6095,995
15814,b-4_401-500_471.wav,VTTS_b-4_401-500_471.wav,9720,8603,1117
15815,b-2_509-610_556.wav,VTTS_b-2_509-610_556.wav,4360,3971,389
15816,b-1_2725-2825_2806.wav,VTTS_b-1_2725-2825_2806.wav,1790,1997,-207
15817,b-4_2000-5164_2741.wav,VTTS_b-4_2000-5164_2741.wav,3610,4528,-918
15818,b-3_6016-6115_6076.wav,VTTS_b-3_6016-6115_6076.wav,9380,8615,765
15819,b-3_4607-5008_4941.wav,VTTS_b-3_4607-5008_4941.wav,9430,9079,351
15820,b-3_5639-5744_5697.wav,VTTS_b-3_5639-5744_5697.wav,4830,6687,-1857
15821,b-3_4607-5008_4740.wav,VTTS_b-3_4607-5008_4740.wav,3360,3437,-77
15822,b-3_392-500_480.wav,VTTS_b-3_392-500_480.wav,5890,9253,-3363
15823,b-3_3279-3363_3330.wav,VTTS_b-3_3279-3363_3330.wav,4290,5573,-1283
15824,b-1_579-649_591.wav,VTTS_b-1_579-649_591.wav,1530,1451,79
15825,b-1_4034-4069_4048.wav,VTTS_b-1_4034-4069_4048.wav,1680,2926,-1246
15826,b-3_3364-3453_3432.wav,VTTS_b-3_3364-3453_3432.wav,4240,4145,95
15827,b-4_501-1014_880.wav,VTTS_b-4_501-1014_880.wav,9010,8313,697
15828,b-1_1212-1312_1237.wav,VTTS_b-1_1212-1312_1237.wav,1910,1800,110
15829,b-3_5533-5638_5555.wav,VTTS_b-3_5533-5638_5555.wav,7090,8243,-1153
15830,b-4_501-1014_838.wav,VTTS_b-4_501-1014_838.wav,7600,7175,425
15831,b-1_1717-1817_1766.wav,VTTS_b-1_1717-1817_1766.wav,1920,1916,4
15832,b-3_501-930_759.wav,VTTS_b-3_501-930_759.wav,3990,3738,252
15833,b-2_1563-1596_1576.wav,VTTS_b-2_1563-1596_1576.wav,1690,1312,378
15834,b-3_294-391_388.wav,VTTS_b-3_294-391_388.wav,2520,2577,-57
15835,b-3_4607-5008_4718.wav,VTTS_b-3_4607-5008_4718.wav,4970,5666,-696
15836,b-3_98-195_170.wav,VTTS_b-3_98-195_170.wav,2950,2995,-45
15837,b-1_1717-1817_1759.wav,VTTS_b-1_1717-1817_1759.wav,1730,1544,186
15838,b-4_1601-1706_1635.wav,VTTS_b-4_1601-1706_1635.wav,4810,4551,259
15839,b-2_1903-2038_1984.wav,VTTS_b-2_1903-2038_1984.wav,4560,2937,1623
15840,b-4_2000-5164_4031.wav,VTTS_b-4_2000-5164_4031.wav,5902,5793,109
15841,b-3_2350-2433_2390.wav,VTTS_b-3_2350-2433_2390.wav,7050,10797,-3747
15842,b-1_276-376_306.wav,VTTS_b-1_276-376_306.wav,2030,1950,80
15843,b-4_1401-1505_1482.wav,VTTS_b-4_1401-1505_1482.wav,3500,3994,-494
15844,b-3_5009-5427_5346.wav,VTTS_b-3_5009-5427_5346.wav,7280,7338,-58
15845,b-3_6501-6600_6567.wav,VTTS_b-3_6501-6600_6567.wav,1510,1300,210
15846,b-3_5533-5638_5595.wav,VTTS_b-3_5533-5638_5595.wav,2640,2717,-77
15847,b-4_501-1014_740.wav,VTTS_b-4_501-1014_740.wav,7980,7523,457
15848,b-1_175-275_181.wav,VTTS_b-1_175-275_181.wav,2300,2345,-45
15849,b-3_2267-2349_2314.wav,VTTS_b-3_2267-2349_2314.wav,5770,5654,116
15850,b-4_2000-5164_3554.wav,VTTS_b-4_2000-5164_3554.wav,3535,4110,-575
15851,b-3_2524-2854_2824.wav,VTTS_b-3_2524-2854_2824.wav,6690,5515,1175
15852,b-3_6116-6215_6197.wav,VTTS_b-3_6116-6215_6197.wav,2400,2531,-131
15853,b-1_3733-3833_3797.wav,VTTS_b-1_3733-3833_3797.wav,1660,1649,11
15854,b-3_2524-2854_2810.wav,VTTS_b-3_2524-2854_2810.wav,4460,3796,664
15855,b-1_2624-2724_2705.wav,VTTS_b-1_2624-2724_2705.wav,2100,3820,-1720
15856,b-3_1321-1568_1325.wav,VTTS_b-3_1321-1568_1325.wav,5320,5306,14
15857,b-4_2000-5164_3370.wav,VTTS_b-4_2000-5164_3370.wav,4225,5271,-1046
15858,b-4_2000-5164_3292.wav,VTTS_b-4_2000-5164_3292.wav,5800,6037,-237
15859,b-3_4498-4605_4561.wav,VTTS_b-3_4498-4605_4561.wav,6160,5805,355
15860,b-2_917-1018_922.wav,VTTS_b-2_917-1018_922.wav,4270,6850,-2580
15861,b-2_713-814_768.wav,VTTS_b-2_713-814_768.wav,2280,2101,179
15862,b-4_2000-5164_5137.wav,VTTS_b-4_2000-5164_5137.wav,4471,4122,349
15863,b-1_3935-4033_4002.wav,VTTS_b-1_3935-4033_4002.wav,3650,3773,-123
15864,b-1_4322-4357_4338.wav,VTTS_b-1_4322-4357_4338.wav,1030,975,55
15865,b-4_2000-5164_2236.wav,VTTS_b-4_2000-5164_2236.wav,7210,7941,-731
15866,b-3_1321-1568_1552.wav,VTTS_b-3_1321-1568_1552.wav,11290,11610,-320
15867,b-3_392-500_432.wav,VTTS_b-3_392-500_432.wav,4080,4156,-76
15868,b-3_3538-3627_3616.wav,VTTS_b-3_3538-3627_3616.wav,5900,5561,339
15869,b-1_1212-1312_1271.wav,VTTS_b-1_1212-1312_1271.wav,2500,2043,457
15870,b-4_2000-5164_5058.wav,VTTS_b-4_2000-5164_5058.wav,5232,5642,-410
15871,b-1_4286-4321_4291.wav,VTTS_b-1_4286-4321_4291.wav,3310,4412,-1102
15872,b-1_794-1009_810.wav,VTTS_b-1_794-1009_810.wav,4230,4029,201
15873,b-1_2725-2825_2753.wav,VTTS_b-1_2725-2825_2753.wav,1190,1300,-110
15874,b-3_3454-3537_3509.wav,VTTS_b-3_3454-3537_3509.wav,7000,7175,-175
15875,b-2_1427-1562_1522.wav,VTTS_b-2_1427-1562_1522.wav,8220,5851,2369
15876,b-4_2000-5164_3191.wav,VTTS_b-4_2000-5164_3191.wav,8170,7976,194
15877,b-4_2000-5164_3337.wav,VTTS_b-4_2000-5164_3337.wav,2786,2601,185
15878,b-3_5009-5427_5157.wav,VTTS_b-3_5009-5427_5157.wav,3390,3320,70
15879,b-4_2000-5164_4898.wav,VTTS_b-4_2000-5164_4898.wav,2500,2334,166
15880,b-3_5957-6015_6011.wav,VTTS_b-3_5957-6015_6011.wav,3540,6084,-2544
15881,b-4_2000-5164_4514.wav,VTTS_b-4_2000-5164_4514.wav,2919,2926,-7
15882,b-3_5533-5638_5581.wav,VTTS_b-3_5533-5638_5581.wav,8620,8615,5
15883,b-3_6501-6600_6575.wav,VTTS_b-3_6501-6600_6575.wav,2960,2868,92
15884,b-3_294-391_340.wav,VTTS_b-3_294-391_340.wav,2900,2856,44
15885,b-4_2000-5164_3628.wav,VTTS_b-4_2000-5164_3628.wav,3216,3030,186
15886,b-3_1079-1320_1293.wav,VTTS_b-3_1079-1320_1293.wav,3140,3379,-239
15887,b-1_794-1009_917.wav,VTTS_b-1_794-1009_917.wav,2180,1591,589
15888,b-3_392-500_409.wav,VTTS_b-3_392-500_409.wav,8990,9125,-135
15889,b-1_4034-4069_4055.wav,VTTS_b-1_4034-4069_4055.wav,1920,1765,155
15890,b-3_1079-1320_1317.wav,VTTS_b-3_1079-1320_1317.wav,5840,5422,418
15891,b-1_2321-2421_2328.wav,VTTS_b-1_2321-2421_2328.wav,1190,1161,29
15892,b-3_5009-5427_5061.wav,VTTS_b-3_5009-5427_5061.wav,5500,4772,728
15893,b-2_1699-1800_1803.wav,VTTS_b-2_1699-1800_1803.wav,1750,1683,67
15894,b-4_401-500_483.wav,VTTS_b-4_401-500_483.wav,7930,6560,1370
15895,b-3_2177-2266_2199.wav,VTTS_b-3_2177-2266_2199.wav,8140,8324,-184
15896,b-1_1111-1211_1132.wav,VTTS_b-1_1111-1211_1132.wav,1620,1115,505
15897,b-1_175-275_262.wav,VTTS_b-1_175-275_262.wav,6720,6037,683
15898,b-4_501-1014_580.wav,VTTS_b-4_501-1014_580.wav,1900,1486,414
15899,b-4_2000-5164_3365.wav,VTTS_b-4_2000-5164_3365.wav,4840,5433,-593
15900,b-4_53-150_132.wav,VTTS_b-4_53-150_132.wav,8230,9915,-1685
15901,b-3_6274-6300_6280.wav,VTTS_b-3_6274-6300_6280.wav,2490,2415,75
15902,b-2_1903-2038_1927.wav,VTTS_b-2_1903-2038_1927.wav,2480,2914,-434
15903,b-3_6301-6400_6344.wav,VTTS_b-3_6301-6400_6344.wav,4190,4261,-71
15904,b-1_1313-1413_1414.wav,VTTS_b-1_1313-1413_1414.wav,5520,5004,516
15905,b-3_6016-6115_6073.wav,VTTS_b-3_6016-6115_6073.wav,3410,3483,-73
15906,b-4_2000-5164_3787.wav,VTTS_b-4_2000-5164_3787.wav,4800,4981,-181
15907,b-3_501-930_803.wav,VTTS_b-3_501-930_803.wav,8470,6769,1701
15908,b-1_1616-1716_1646.wav,VTTS_b-1_1616-1716_1646.wav,1430,1335,95
15909,b-4_2000-5164_2145.wav,VTTS_b-4_2000-5164_2145.wav,6745,6618,127
15910,b-1_1818-1918_1824.wav,VTTS_b-1_1818-1918_1824.wav,2030,1788,242
15911,b-2_1801-1902_1829.wav,VTTS_b-2_1801-1902_1829.wav,1740,2159,-419
15912,b-4_1814-1900_1824.wav,VTTS_b-4_1814-1900_1824.wav,3750,4110,-360
15913,b-3_6801-6900_6820.wav,VTTS_b-3_6801-6900_6820.wav,3520,3715,-195
15914,b-3_1764-1861_1784.wav,VTTS_b-3_1764-1861_1784.wav,1180,1184,-4
15915,b-2_1903-2038_2017.wav,VTTS_b-2_1903-2038_2017.wav,2770,2380,390
15916,b-3_3538-3627_3596.wav,VTTS_b-3_3538-3627_3596.wav,3250,3320,-70
15917,b-3_1764-1861_1808.wav,VTTS_b-3_1764-1861_1808.wav,2750,2392,358
15918,b-3_5009-5427_5038.wav,VTTS_b-3_5009-5427_5038.wav,4790,4598,192
15919,b-1_2523-2623_2541.wav,VTTS_b-1_2523-2623_2541.wav,3180,3437,-257
15920,b-4_2000-5164_2671.wav,VTTS_b-4_2000-5164_2671.wav,1670,1393,277
15921,b-2_1223-1324_1314.wav,VTTS_b-2_1223-1324_1314.wav,4250,3959,291
15922,b-1_377-477_383.wav,VTTS_b-1_377-477_383.wav,1410,1416,-6
15923,b-4_1014-1100_1097.wav,VTTS_b-4_1014-1100_1097.wav,2290,2125,165
15924,b-4_2000-5164_3947.wav,VTTS_b-4_2000-5164_3947.wav,5278,5700,-422
15925,b-1_1717-1817_1745.wav,VTTS_b-1_1717-1817_1745.wav,5230,5979,-749
15926,b-3_4315-4424_4386.wav,VTTS_b-3_4315-4424_4386.wav,7160,7082,78
15927,b-4_1506-1600_1590.wav,VTTS_b-4_1506-1600_1590.wav,3340,3611,-271
15928,b-3_1079-1320_1129.wav,VTTS_b-3_1079-1320_1129.wav,4250,3785,465
15929,b-2_2107-2193_2124.wav,VTTS_b-2_2107-2193_2124.wav,2660,2844,-184
15930,b-3_2177-2266_2205.wav,VTTS_b-3_2177-2266_2205.wav,8720,8673,47
15931,b-4_2000-5164_5161.wav,VTTS_b-4_2000-5164_5161.wav,10736,11610,-874
15932,b-3_1321-1568_1434.wav,VTTS_b-3_1321-1568_1434.wav,5310,4841,469
15933,b-3_501-930_892.wav,VTTS_b-3_501-930_892.wav,6870,8998,-2128
15934,b-3_1666-1763_1669.wav,VTTS_b-3_1666-1763_1669.wav,8450,11610,-3160
15935,b-2_509-610_532.wav,VTTS_b-2_509-610_532.wav,2640,2438,202
15936,b-2_1427-1562_1484.wav,VTTS_b-2_1427-1562_1484.wav,4470,4145,325
15937,b-3_2943-3024_2996.wav,VTTS_b-3_2943-3024_2996.wav,5480,6327,-847
15938,b-3_5957-6015_5963.wav,VTTS_b-3_5957-6015_5963.wav,3220,2821,399
15939,b-1_478-578_484.wav,VTTS_b-1_478-578_484.wav,1520,1474,46
15940,b-3_196-293_276.wav,VTTS_b-3_196-293_276.wav,6890,6885,5
15941,b-3_6801-6900_6850.wav,VTTS_b-3_6801-6900_6850.wav,2380,2310,70
15942,b-1_1414-1514_1505.wav,VTTS_b-1_1414-1514_1505.wav,3070,3007,63
15943,b-2_1427-1562_1547.wav,VTTS_b-2_1427-1562_1547.wav,2280,3564,-1284
15944,b-2_1019-1120_1064.wav,VTTS_b-2_1019-1120_1064.wav,1580,1579,1
15945,b-1_1515-1615_1565.wav,VTTS_b-1_1515-1615_1565.wav,2320,2345,-25
15946,b-1_2624-2724_2638.wav,VTTS_b-1_2624-2724_2638.wav,1770,1811,-41
15947,b-4_2000-5164_4635.wav,VTTS_b-4_2000-5164_4635.wav,3300,3286,14
15948,b-1_794-1009_845.wav,VTTS_b-1_794-1009_845.wav,2010,1881,129
15949,b-3_3198-3278_3270.wav,VTTS_b-3_3198-3278_3270.wav,4380,3773,607
15950,b-3_6401-6500_6488.wav,VTTS_b-3_6401-6500_6488.wav,4760,4423,337
15951,b-2_713-814_762.wav,VTTS_b-2_713-814_762.wav,5370,5027,343
15952,b-1_1717-1817_1773.wav,VTTS_b-1_1717-1817_1773.wav,2320,2601,-281
15953,b-3_1-97_15.wav,VTTS_b-3_1-97_15.wav,9950,9660,290
15954,b-1_1111-1211_1171.wav,VTTS_b-1_1111-1211_1171.wav,1580,1544,36
15955,b-4_1814-1900_1848.wav,VTTS_b-4_1814-1900_1848.wav,2180,2067,113
15956,b-3_980-1077_1024.wav,VTTS_b-3_980-1077_1024.wav,1610,2032,-422
15957,b-3_6900-7016_6906.wav,VTTS_b-3_6900-7016_6906.wav,10310,9021,1289
15958,b-3_6016-6115_6023.wav,VTTS_b-3_6016-6115_6023.wav,3090,3042,48
15959,b-3_6301-6400_6320.wav,VTTS_b-3_6301-6400_6320.wav,5460,11610,-6150
15960,b-4_2000-5164_3776.wav,VTTS_b-4_2000-5164_3776.wav,11630,10623,1007
15961,b-4_2000-5164_4382.wav,VTTS_b-4_2000-5164_4382.wav,6350,6026,324
15962,b-3_1079-1320_1216.wav,VTTS_b-3_1079-1320_1216.wav,5600,5584,16
15963,b-3_3628-3714_3677.wav,VTTS_b-3_3628-3714_3677.wav,4800,4992,-192
15964,b-3_5745-5852_5818.wav,VTTS_b-3_5745-5852_5818.wav,4730,4667,63
15965,b-4_401-500_427.wav,VTTS_b-4_401-500_427.wav,1910,1846,64
15966,b-4_2000-5164_2961.wav,VTTS_b-4_2000-5164_2961.wav,1204,1091,113
15967,b-1_1616-1716_1640.wav,VTTS_b-1_1616-1716_1640.wav,1760,1660,100
15968,b-1_1818-1918_1914.wav,VTTS_b-1_1818-1918_1914.wav,1780,2194,-414
15969,b-4_2000-5164_4140.wav,VTTS_b-4_2000-5164_4140.wav,11737,11610,127
15970,b-3_6801-6900_6829.wav,VTTS_b-3_6801-6900_6829.wav,7410,7988,-578
15971,b-3_5009-5427_5220.wav,VTTS_b-3_5009-5427_5220.wav,4850,5027,-177
15972,b-3_2267-2349_2329.wav,VTTS_b-3_2267-2349_2329.wav,5100,5329,-229
15973,b-3_5639-5744_5720.wav,VTTS_b-3_5639-5744_5720.wav,2770,3506,-736
15974,b-3_1321-1568_1475.wav,VTTS_b-3_1321-1568_1475.wav,5060,6002,-942
15975,b-2_2209-2310_2261.wav,VTTS_b-2_2209-2310_2261.wav,7710,6049,1661
15976,b-1_686-793_754.wav,VTTS_b-1_686-793_754.wav,2880,2914,-34
15977,b-3_2524-2854_2811.wav,VTTS_b-3_2524-2854_2811.wav,2820,2949,-129
15978,b-3_6401-6500_6454.wav,VTTS_b-3_6401-6500_6454.wav,4660,4621,39
15979,b-3_2524-2854_2785.wav,VTTS_b-3_2524-2854_2785.wav,10070,10205,-135
15980,b-2_713-814_737.wav,VTTS_b-2_713-814_737.wav,2540,1544,996
15981,b-4_1301-1400_1342.wav,VTTS_b-4_1301-1400_1342.wav,10280,11610,-1330
15982,b-3_4425-4497_4443.wav,VTTS_b-3_4425-4497_4443.wav,8560,8452,108
15983,b-3_3279-3363_3300.wav,VTTS_b-3_3279-3363_3300.wav,3120,3181,-61
15984,b-1_3733-3833_3823.wav,VTTS_b-1_3733-3833_3823.wav,1790,2032,-242
15985,b-4_1506-1600_1551.wav,VTTS_b-4_1506-1600_1551.wav,4600,4180,420
15986,b-3_1321-1568_1529.wav,VTTS_b-3_1321-1568_1529.wav,5400,4458,942
15987,b-4_1814-1900_1893.wav,VTTS_b-4_1814-1900_1893.wav,3690,3529,161
15988,b-4_1601-1706_1681.wav,VTTS_b-4_1601-1706_1681.wav,5850,5433,417
15989,b-1_3733-3833_3801.wav,VTTS_b-1_3733-3833_3801.wav,2970,3982,-1012
15990,b-2_1563-1596_1583.wav,VTTS_b-2_1563-1596_1583.wav,5760,8046,-2286
15991,b-2_305-406_397.wav,VTTS_b-2_305-406_397.wav,1890,1625,265
15992,b-4_2000-5164_3886.wav,VTTS_b-4_2000-5164_3886.wav,1294,1173,121
15993,b-2_1801-1902_1867.wav,VTTS_b-2_1801-1902_1867.wav,1930,1858,72
15994,b-4_2000-5164_4004.wav,VTTS_b-4_2000-5164_4004.wav,2825,3111,-286
15995,b-4_301-400_366.wav,VTTS_b-4_301-400_366.wav,2320,2171,149
15996,b-4_2000-5164_2660.wav,VTTS_b-4_2000-5164_2660.wav,4225,3947,278
15997,b-1_276-376_302.wav,VTTS_b-1_276-376_302.wav,1460,1509,-49
15998,b-1_3531-3631_3577.wav,VTTS_b-1_3531-3631_3577.wav,1410,1289,121
15999,b-1_3430-3530_3460.wav,VTTS_b-1_3430-3530_3460.wav,1360,1521,-161
16000,b-3_2000-2088_2059.wav,VTTS_b-3_2000-2088_2059.wav,4480,5956,-1476
16001,b-4_2000-5164_3260.wav,VTTS_b-4_2000-5164_3260.wav,5313,5642,-329
16002,b-4_2000-5164_2305.wav,VTTS_b-4_2000-5164_2305.wav,8635,10820,-2185
16003,b-4_2000-5164_3643.wav,VTTS_b-4_2000-5164_3643.wav,5343,5074,269
16004,b-3_6217-6274_6228.wav,VTTS_b-3_6217-6274_6228.wav,4470,4458,12
16005,b-2_1427-1562_1537.wav,VTTS_b-2_1427-1562_1537.wav,2610,3228,-618
16006,b-1_4142-4177_4175.wav,VTTS_b-1_4142-4177_4175.wav,2750,2891,-141
16007,b-1_3632-3732_3696.wav,VTTS_b-1_3632-3732_3696.wav,8100,7721,379
16008,b-2_2311-2412_2339.wav,VTTS_b-2_2311-2412_2339.wav,1860,1939,-79
16009,b-1_1212-1312_1306.wav,VTTS_b-1_1212-1312_1306.wav,1810,1718,92
16010,b-3_5428-5533_5508.wav,VTTS_b-3_5428-5533_5508.wav,8550,8336,214
16011,b-4_2000-5164_4542.wav,VTTS_b-4_2000-5164_4542.wav,3633,3669,-36
16012,b-1_2220-2320_2309.wav,VTTS_b-1_2220-2320_2309.wav,1680,2554,-874
16013,b-3_3889-4000_3943.wav,VTTS_b-3_3889-4000_3943.wav,3630,3843,-213
16014,b-3_6274-6300_6293.wav,VTTS_b-3_6274-6300_6293.wav,6840,6235,605
16015,b-1_3228-3328_3290.wav,VTTS_b-1_3228-3328_3290.wav,2140,2020,120
16016,b-1_2018-2118_2067.wav,VTTS_b-1_2018-2118_2067.wav,3610,3913,-303
16017,b-3_6116-6215_6170.wav,VTTS_b-3_6116-6215_6170.wav,5900,5666,234
16018,b-1_650-685_681.wav,VTTS_b-1_650-685_681.wav,1020,1068,-48
16019,b-3_1568-1665_1606.wav,VTTS_b-3_1568-1665_1606.wav,4880,5689,-809
16020,b-1_4106-4141_4113.wav,VTTS_b-1_4106-4141_4113.wav,1620,1614,6
16021,b-3_5009-5427_5173.wav,VTTS_b-3_5009-5427_5173.wav,4520,4458,62
16022,b-3_2177-2266_2210.wav,VTTS_b-3_2177-2266_2210.wav,8000,7953,47
16023,b-4_2000-5164_3620.wav,VTTS_b-4_2000-5164_3620.wav,4995,4505,490
16024,b-1_794-1009_921.wav,VTTS_b-1_794-1009_921.wav,2570,3796,-1226
16025,b-1_276-376_314.wav,VTTS_b-1_276-376_314.wav,1730,1556,174
16026,b-1_2220-2320_2279.wav,VTTS_b-1_2220-2320_2279.wav,2180,2136,44
16027,b-2_1019-1120_1040.wav,VTTS_b-2_1019-1120_1040.wav,1420,1858,-438
16028,b-4_2000-5164_4529.wav,VTTS_b-4_2000-5164_4529.wav,5506,5689,-183
16029,b-3_5009-5427_5125.wav,VTTS_b-3_5009-5427_5125.wav,4750,11610,-6860
16030,b-2_1019-1120_1098.wav,VTTS_b-2_1019-1120_1098.wav,3340,2775,565
16031,b-3_980-1077_1079.wav,VTTS_b-3_980-1077_1079.wav,3420,2995,425
16032,b-2_1903-2038_1933.wav,VTTS_b-2_1903-2038_1933.wav,2270,3181,-911
16033,b-4_2000-5164_3006.wav,VTTS_b-4_2000-5164_3006.wav,5483,6026,-543
16034,b-3_1-97_44.wav,VTTS_b-3_1-97_44.wav,6840,6130,710
16035,b-3_3279-3363_3313.wav,VTTS_b-3_3279-3363_3313.wav,5350,5770,-420
16036,b-4_1401-1505_1408.wav,VTTS_b-4_1401-1505_1408.wav,5010,7767,-2757
16037,b-3_501-930_734.wav,VTTS_b-3_501-930_734.wav,6080,5956,124
16038,b-3_2350-2433_2417.wav,VTTS_b-3_2350-2433_2417.wav,5710,5201,509
16039,b-4_1101-1220_1132.wav,VTTS_b-4_1101-1220_1132.wav,6370,5515,855
16040,b-3_1079-1320_1091.wav,VTTS_b-3_1079-1320_1091.wav,3190,3053,137
16041,b-1_1717-1817_1722.wav,VTTS_b-1_1717-1817_1722.wav,2590,2043,547
16042,b-2_2209-2310_2287.wav,VTTS_b-2_2209-2310_2287.wav,3120,3402,-282
16043,b-4_2000-5164_4255.wav,VTTS_b-4_2000-5164_4255.wav,5770,3367,2403
16044,b-3_6501-6600_6574.wav,VTTS_b-3_6501-6600_6574.wav,3770,5492,-1722
16045,b-2_203-304_247.wav,VTTS_b-2_203-304_247.wav,2750,4284,-1534
16046,b-1_2725-2825_2734.wav,VTTS_b-1_2725-2825_2734.wav,1340,1428,-88
16047,b-1_1111-1211_1121.wav,VTTS_b-1_1111-1211_1121.wav,2440,2473,-33
16048,b-3_501-930_913.wav,VTTS_b-3_501-930_913.wav,3940,3402,538
16049,b-3_98-195_138.wav,VTTS_b-3_98-195_138.wav,4210,4458,-248
16050,b-4_2000-5164_2192.wav,VTTS_b-4_2000-5164_2192.wav,13520,11610,1910
16051,b-1_1919-2017_1960.wav,VTTS_b-1_1919-2017_1960.wav,4090,3704,386
16052,b-4_2000-5164_4211.wav,VTTS_b-4_2000-5164_4211.wav,2429,2647,-218
16053,b-3_1321-1568_1555.wav,VTTS_b-3_1321-1568_1555.wav,3540,3181,359
16054,b-3_501-930_524.wav,VTTS_b-3_501-930_524.wav,6120,6014,106
16055,b-1_1010-1110_1034.wav,VTTS_b-1_1010-1110_1034.wav,2010,1974,36
16056,b-3_1079-1320_1115.wav,VTTS_b-3_1079-1320_1115.wav,5260,6490,-1230
16057,b-3_931-979_933.wav,VTTS_b-3_931-979_933.wav,8240,10681,-2441
16058,b-3_3538-3627_3548.wav,VTTS_b-3_3538-3627_3548.wav,5930,5201,729
16059,b-2_815-916_854.wav,VTTS_b-2_815-916_854.wav,1210,1091,119
16060,b-3_2524-2854_2692.wav,VTTS_b-3_2524-2854_2692.wav,2710,2763,-53
16061,b-2_917-1018_983.wav,VTTS_b-2_917-1018_983.wav,9860,7964,1896
16062,b-1_2119-2219_2179.wav,VTTS_b-1_2119-2219_2179.wav,3220,3587,-367
16063,b-2_1019-1120_1117.wav,VTTS_b-2_1019-1120_1117.wav,2330,2264,66
16064,b-3_392-500_428.wav,VTTS_b-3_392-500_428.wav,6250,6072,178
16065,b-3_6701-6800_6706.wav,VTTS_b-3_6701-6800_6706.wav,2560,2241,319
16066,b-1_3935-4033_3979.wav,VTTS_b-1_3935-4033_3979.wav,2640,2496,144
16067,b-1_3733-3833_3737.wav,VTTS_b-1_3733-3833_3737.wav,3590,4748,-1158
16068,b-3_6274-6300_6300.wav,VTTS_b-3_6274-6300_6300.wav,4510,4110,400
16069,b-3_3538-3627_3598.wav,VTTS_b-3_3538-3627_3598.wav,3970,4261,-291
16070,b-2_509-610_550.wav,VTTS_b-2_509-610_550.wav,7000,6699,301
16071,b-4_301-400_370.wav,VTTS_b-4_301-400_370.wav,5390,5016,374
16072,b-3_501-930_545.wav,VTTS_b-3_501-930_545.wav,3750,4040,-290
16073,b-1_3430-3530_3436.wav,VTTS_b-1_3430-3530_3436.wav,5770,4656,1114
16074,b-1_3329-3429_3376.wav,VTTS_b-1_3329-3429_3376.wav,2140,2415,-275
16075,b-2_1597-1698_1601.wav,VTTS_b-2_1597-1698_1601.wav,1450,1300,150
16076,b-1_1616-1716_1670.wav,VTTS_b-1_1616-1716_1670.wav,1490,1474,16
16077,b-4_2000-5164_4205.wav,VTTS_b-4_2000-5164_4205.wav,7425,7477,-52
16078,b-4_1401-1505_1470.wav,VTTS_b-4_1401-1505_1470.wav,13580,11610,1970
16079,b-3_501-930_764.wav,VTTS_b-3_501-930_764.wav,5710,7674,-1964
16080,b-3_4607-5008_4757.wav,VTTS_b-3_4607-5008_4757.wav,6870,7024,-154
16081,b-4_2000-5164_2343.wav,VTTS_b-4_2000-5164_2343.wav,5670,5817,-147
16082,b-4_2000-5164_4851.wav,VTTS_b-4_2000-5164_4851.wav,3732,3831,-99
16083,b-1_3430-3530_3503.wav,VTTS_b-1_3430-3530_3503.wav,2760,2647,113
16084,b-1_2220-2320_2304.wav,VTTS_b-1_2220-2320_2304.wav,1690,1776,-86
16085,b-3_2177-2266_2262.wav,VTTS_b-3_2177-2266_2262.wav,8580,9648,-1068
16086,b-3_6016-6115_6112.wav,VTTS_b-3_6016-6115_6112.wav,1790,1788,2
16087,b-2_1801-1902_1804.wav,VTTS_b-2_1801-1902_1804.wav,1580,1614,-34
16088,b-3_3364-3453_3397.wav,VTTS_b-3_3364-3453_3397.wav,4400,3936,464
16089,b-1_1818-1918_1892.wav,VTTS_b-1_1818-1918_1892.wav,1870,1776,94
16090,b-2_1699-1800_1714.wav,VTTS_b-2_1699-1800_1714.wav,1260,1265,-5
16091,b-3_3198-3278_3204.wav,VTTS_b-3_3198-3278_3204.wav,9920,9358,562
16092,b-4_1101-1220_1128.wav,VTTS_b-4_1101-1220_1128.wav,5150,4586,564
16093,b-1_1919-2017_1924.wav,VTTS_b-1_1919-2017_1924.wav,1370,1451,-81
16094,b-4_2000-5164_2783.wav,VTTS_b-4_2000-5164_2783.wav,6645,6525,120
16095,b-3_4607-5008_4617.wav,VTTS_b-3_4607-5008_4617.wav,5010,5166,-156
16096,b-4_2000-5164_3440.wav,VTTS_b-4_2000-5164_3440.wav,4702,4899,-197
16097,b-3_392-500_496.wav,VTTS_b-3_392-500_496.wav,4940,5236,-296
16098,b-3_98-195_139.wav,VTTS_b-3_98-195_139.wav,5860,5654,206
16099,b-4_501-1014_988.wav,VTTS_b-4_501-1014_988.wav,2340,2218,122
16100,b-2_509-610_573.wav,VTTS_b-2_509-610_573.wav,2850,3297,-447
16101,b-4_1901-2000_1905.wav,VTTS_b-4_1901-2000_1905.wav,1800,1834,-34
16102,b-1_478-578_563.wav,VTTS_b-1_478-578_563.wav,2260,1927,333
16103,b-3_1321-1568_1545.wav,VTTS_b-3_1321-1568_1545.wav,5410,5178,232
16104,b-1_1616-1716_1676.wav,VTTS_b-1_1616-1716_1676.wav,2390,2450,-60
16105,b-1_3127-3227_3127.wav,VTTS_b-1_3127-3227_3127.wav,3720,4203,-483
16106,b-3_980-1077_1060.wav,VTTS_b-3_980-1077_1060.wav,6540,7245,-705
16107,b-3_4001-4103_4099.wav,VTTS_b-3_4001-4103_4099.wav,1800,1962,-162
16108,b-4_2000-5164_2604.wav,VTTS_b-4_2000-5164_2604.wav,3090,2798,292
16109,b-3_6016-6115_6040.wav,VTTS_b-3_6016-6115_6040.wav,6850,7012,-162
16110,b-2_815-916_906.wav,VTTS_b-2_815-916_906.wav,2310,2403,-93
16111,b-1_1515-1615_1536.wav,VTTS_b-1_1515-1615_1536.wav,3180,2496,684
16112,b-3_4104-4206_4151.wav,VTTS_b-3_4104-4206_4151.wav,3050,2740,310
16113,b-4_2000-5164_4182.wav,VTTS_b-4_2000-5164_4182.wav,6892,10136,-3244
16114,b-2_713-814_731.wav,VTTS_b-2_713-814_731.wav,2490,3820,-1330
16115,b-4_2000-5164_2797.wav,VTTS_b-4_2000-5164_2797.wav,6460,6304,156
16116,b-2_1325-1426_1379.wav,VTTS_b-2_1325-1426_1379.wav,2260,2229,31
16117,b-2_815-916_873.wav,VTTS_b-2_815-916_873.wav,2900,2694,206
16118,b-1_3026-3126_3100.wav,VTTS_b-1_3026-3126_3100.wav,3090,2902,188
16119,b-1_3632-3732_3710.wav,VTTS_b-1_3632-3732_3710.wav,1860,1869,-9
16120,b-4_1301-1400_1345.wav,VTTS_b-4_1301-1400_1345.wav,1610,1498,112
16121,b-1_1616-1716_1635.wav,VTTS_b-1_1616-1716_1635.wav,2670,2740,-70
16122,b-4_2000-5164_3876.wav,VTTS_b-4_2000-5164_3876.wav,4802,5550,-748
16123,b-2_509-610_579.wav,VTTS_b-2_509-610_579.wav,5900,6722,-822
16124,b-1_1919-2017_1961.wav,VTTS_b-1_1919-2017_1961.wav,3380,4296,-916
16125,b-1_1313-1413_1314.wav,VTTS_b-1_1313-1413_1314.wav,1740,1718,22
16126,b-4_2000-5164_4923.wav,VTTS_b-4_2000-5164_4923.wav,3005,3785,-780
16127,b-1_2321-2421_2377.wav,VTTS_b-1_2321-2421_2377.wav,3040,3111,-71
16128,b-3_3715-3802_3746.wav,VTTS_b-3_3715-3802_3746.wav,5510,6583,-1073
16129,b-1_2321-2421_2371.wav,VTTS_b-1_2321-2421_2371.wav,2270,2879,-609
16130,b-1_3834-3934_3838.wav,VTTS_b-1_3834-3934_3838.wav,5010,5480,-470
16131,b-4_2000-5164_3743.wav,VTTS_b-4_2000-5164_3743.wav,3260,3773,-513
16132,b-4_151-300_261.wav,VTTS_b-4_151-300_261.wav,5270,4923,347
16133,b-4_2000-5164_2251.wav,VTTS_b-4_2000-5164_2251.wav,1595,1358,237
16134,b-1_794-1009_879.wav,VTTS_b-1_794-1009_879.wav,3010,3738,-728
16135,b-2_1801-1902_1831.wav,VTTS_b-2_1801-1902_1831.wav,2270,2067,203
16136,b-4_2000-5164_2734.wav,VTTS_b-4_2000-5164_2734.wav,5840,5933,-93
16137,b-1_2624-2724_2697.wav,VTTS_b-1_2624-2724_2697.wav,2670,2879,-209
16138,b-2_1699-1800_1759.wav,VTTS_b-2_1699-1800_1759.wav,1130,1080,50
16139,b-3_2524-2854_2559.wav,VTTS_b-3_2524-2854_2559.wav,4630,4098,532
16140,b-1_1717-1817_1727.wav,VTTS_b-1_1717-1817_1727.wav,1570,1289,281
16141,b-2_1223-1324_1296.wav,VTTS_b-2_1223-1324_1296.wav,2470,3553,-1083
16142,b-4_501-1014_924.wav,VTTS_b-4_501-1014_924.wav,6570,6072,498
16143,b-3_6801-6900_6822.wav,VTTS_b-3_6801-6900_6822.wav,1210,1173,37
16144,b-3_4315-4424_4418.wav,VTTS_b-3_4315-4424_4418.wav,6170,5735,435
16145,b-1_3430-3530_3448.wav,VTTS_b-1_3430-3530_3448.wav,1300,1486,-186
16146,b-1_2826-2926_2906.wav,VTTS_b-1_2826-2926_2906.wav,2280,3750,-1470
16147,b-1_2321-2421_2357.wav,VTTS_b-1_2321-2421_2357.wav,1870,1823,47
16148,b-2_1699-1800_1705.wav,VTTS_b-2_1699-1800_1705.wav,1200,1196,4
16149,b-1_2321-2421_2385.wav,VTTS_b-1_2321-2421_2385.wav,2160,2113,47
16150,b-1_1515-1615_1544.wav,VTTS_b-1_1515-1615_1544.wav,1610,2519,-909
16151,b-4_2000-5164_2680.wav,VTTS_b-4_2000-5164_2680.wav,4110,3843,267
16152,b-3_2089-2176_2126.wav,VTTS_b-3_2089-2176_2126.wav,9180,9265,-85
16153,b-3_6801-6900_6860.wav,VTTS_b-3_6801-6900_6860.wav,5290,4957,333
16154,b-3_4607-5008_4848.wav,VTTS_b-3_4607-5008_4848.wav,5620,6095,-475
16155,b-1_794-1009_971.wav,VTTS_b-1_794-1009_971.wav,4440,4063,377
16156,b-3_1764-1861_1855.wav,VTTS_b-3_1764-1861_1855.wav,6790,6327,463
16157,b-3_3025-3111_3058.wav,VTTS_b-3_3025-3111_3058.wav,2760,2392,368
16158,b-4_1101-1220_1141.wav,VTTS_b-4_1101-1220_1141.wav,8560,7430,1130
16159,b-3_2943-3024_3004.wav,VTTS_b-3_2943-3024_3004.wav,5120,6745,-1625
16160,b-1_3228-3328_3299.wav,VTTS_b-1_3228-3328_3299.wav,2090,1765,325
16161,b-3_1666-1763_1725.wav,VTTS_b-3_1666-1763_1725.wav,2680,2392,288
16162,b-4_1221-1300_1242.wav,VTTS_b-4_1221-1300_1242.wav,3850,3390,460
16163,b-3_98-195_188.wav,VTTS_b-3_98-195_188.wav,5400,5085,315
16164,b-1_2523-2623_2532.wav,VTTS_b-1_2523-2623_2532.wav,5510,5248,262
16165,b-3_6217-6274_6238.wav,VTTS_b-3_6217-6274_6238.wav,2000,2067,-67
16166,b-1_2321-2421_2358.wav,VTTS_b-1_2321-2421_2358.wav,1630,1591,39
16167,b-3_2524-2854_2649.wav,VTTS_b-3_2524-2854_2649.wav,3850,3796,54
16168,b-4_2000-5164_4797.wav,VTTS_b-4_2000-5164_4797.wav,13299,11610,1689
16169,b-1_794-1009_877.wav,VTTS_b-1_794-1009_877.wav,1870,1649,221
16170,b-3_501-930_816.wav,VTTS_b-3_501-930_816.wav,5550,4899,651
16171,b-2_305-406_329.wav,VTTS_b-2_305-406_329.wav,2000,3146,-1146
16172,b-2_815-916_910.wav,VTTS_b-2_815-916_910.wav,2410,2229,181
16173,b-3_501-930_755.wav,VTTS_b-3_501-930_755.wav,6090,4969,1121
16174,b-3_3538-3627_3564.wav,VTTS_b-3_3538-3627_3564.wav,4430,5016,-586
16175,b-1_4214-4285_4249.wav,VTTS_b-1_4214-4285_4249.wav,1070,998,72
16176,b-1_3935-4033_3945.wav,VTTS_b-1_3935-4033_3945.wav,2580,2670,-90
16177,b-3_4001-4103_4022.wav,VTTS_b-3_4001-4103_4022.wav,9120,9439,-319
16178,b-3_4607-5008_4876.wav,VTTS_b-3_4607-5008_4876.wav,2770,3077,-307
16179,b-4_2000-5164_2364.wav,VTTS_b-4_2000-5164_2364.wav,7880,8069,-189
16180,b-4_2000-5164_4095.wav,VTTS_b-4_2000-5164_4095.wav,3525,4226,-701
16181,b-1_4430-4465_4441.wav,VTTS_b-1_4430-4465_4441.wav,1260,1544,-284
16182,b-1_2523-2623_2609.wav,VTTS_b-1_2523-2623_2609.wav,2610,2531,79
16183,b-3_1960-2000_1980.wav,VTTS_b-3_1960-2000_1980.wav,3860,3622,238
16184,b-4_2000-5164_4741.wav,VTTS_b-4_2000-5164_4741.wav,6649,6838,-189
16185,b-3_4315-4424_4385.wav,VTTS_b-3_4315-4424_4385.wav,9320,8673,647
16186,b-3_196-293_223.wav,VTTS_b-3_196-293_223.wav,4650,4981,-331
16187,b-4_2000-5164_4777.wav,VTTS_b-4_2000-5164_4777.wav,5987,5619,368
16188,b-1_794-1009_842.wav,VTTS_b-1_794-1009_842.wav,2640,2218,422
16189,b-2_1325-1426_1411.wav,VTTS_b-2_1325-1426_1411.wav,1990,2078,-88
16190,b-1_276-376_299.wav,VTTS_b-1_276-376_299.wav,1080,1068,12
16191,b-4_2000-5164_4019.wav,VTTS_b-4_2000-5164_4019.wav,3730,3379,351
16192,b-3_6900-7016_7004.wav,VTTS_b-3_6900-7016_7004.wav,2860,3042,-182
16193,b-1_2422-2522_2494.wav,VTTS_b-1_2422-2522_2494.wav,3450,4505,-1055
16194,b-2_2209-2310_2212.wav,VTTS_b-2_2209-2310_2212.wav,3200,2949,251
16195,b-3_3803-3888_3877.wav,VTTS_b-3_3803-3888_3877.wav,5660,5550,110
16196,b-3_98-195_100.wav,VTTS_b-3_98-195_100.wav,14030,11610,2420
16197,b-2_509-610_518.wav,VTTS_b-2_509-610_518.wav,1150,1091,59
16198,b-4_1901-2000_1937.wav,VTTS_b-4_1901-2000_1937.wav,8150,7848,302
16199,b-2_917-1018_999.wav,VTTS_b-2_917-1018_999.wav,3730,4783,-1053
16200,b-1_2422-2522_2509.wav,VTTS_b-1_2422-2522_2509.wav,2770,2601,169
16201,b-1_2624-2724_2716.wav,VTTS_b-1_2624-2724_2716.wav,2020,2450,-430
16202,b-3_4607-5008_4980.wav,VTTS_b-3_4607-5008_4980.wav,9930,11192,-1262
16203,b-4_1601-1706_1656.wav,VTTS_b-4_1601-1706_1656.wav,5080,4969,111
16204,b-3_931-979_968.wav,VTTS_b-3_931-979_968.wav,4520,5480,-960
16205,b-1_2422-2522_2508.wav,VTTS_b-1_2422-2522_2508.wav,3130,3204,-74
16206,b-3_2267-2349_2324.wav,VTTS_b-3_2267-2349_2324.wav,6410,11610,-5200
16207,b-1_3733-3833_3811.wav,VTTS_b-1_3733-3833_3811.wav,1960,2775,-815
16208,b-3_2524-2854_2734.wav,VTTS_b-3_2524-2854_2734.wav,6380,4981,1399
16209,b-1_1-73_71.wav,VTTS_b-1_1-73_71.wav,5240,5886,-646
16210,b-4_1301-1400_1378.wav,VTTS_b-4_1301-1400_1378.wav,5070,5445,-375
16211,b-3_5009-5427_5262.wav,VTTS_b-3_5009-5427_5262.wav,1970,1811,159
16212,b-4_2000-5164_4294.wav,VTTS_b-4_2000-5164_4294.wav,1712,1474,238
16213,b-3_196-293_280.wav,VTTS_b-3_196-293_280.wav,3670,3692,-22
16214,b-3_4207-4314_4210.wav,VTTS_b-3_4207-4314_4210.wav,1350,1138,212
16215,b-3_2524-2854_2805.wav,VTTS_b-3_2524-2854_2805.wav,4680,4656,24
16216,b-3_6501-6600_6581.wav,VTTS_b-3_6501-6600_6581.wav,2910,2426,484
16217,b-4_2000-5164_2863.wav,VTTS_b-4_2000-5164_2863.wav,5510,5120,390
16218,b-3_980-1077_1002.wav,VTTS_b-3_980-1077_1002.wav,4050,3541,509
16219,b-3_501-930_791.wav,VTTS_b-3_501-930_791.wav,3770,3994,-224
16220,b-3_3454-3537_3505.wav,VTTS_b-3_3454-3537_3505.wav,6150,6420,-270
16221,b-1_794-1009_951.wav,VTTS_b-1_794-1009_951.wav,2500,2357,143
16222,b-3_4607-5008_4891.wav,VTTS_b-3_4607-5008_4891.wav,7730,7628,102
16223,b-4_2000-5164_4399.wav,VTTS_b-4_2000-5164_4399.wav,3473,3379,94
16224,b-1_686-793_705.wav,VTTS_b-1_686-793_705.wav,2010,2206,-196
16225,b-3_6701-6800_6782.wav,VTTS_b-3_6701-6800_6782.wav,3260,3866,-606
16226,b-4_151-300_189.wav,VTTS_b-4_151-300_189.wav,1290,1231,59
16227,b-4_2000-5164_4152.wav,VTTS_b-4_2000-5164_4152.wav,4819,4690,129
16228,b-1_3026-3126_3066.wav,VTTS_b-1_3026-3126_3066.wav,4540,4888,-348
16229,b-3_3538-3627_3553.wav,VTTS_b-3_3538-3627_3553.wav,4020,4191,-171
16230,b-4_1814-1900_1889.wav,VTTS_b-4_1814-1900_1889.wav,4390,4238,152
16231,b-2_1427-1562_1556.wav,VTTS_b-2_1427-1562_1556.wav,1490,1614,-124
16232,b-4_2000-5164_4731.wav,VTTS_b-4_2000-5164_4731.wav,3557,3796,-239
16233,b-3_1666-1763_1705.wav,VTTS_b-3_1666-1763_1705.wav,3860,4005,-145
16234,b-3_6016-6115_6071.wav,VTTS_b-3_6016-6115_6071.wav,1900,1741,159
16235,b-1_3026-3126_3112.wav,VTTS_b-1_3026-3126_3112.wav,2080,2508,-428
16236,b-1_74-174_75.wav,VTTS_b-1_74-174_75.wav,1550,1498,52
16237,b-1_74-174_93.wav,VTTS_b-1_74-174_93.wav,5490,4377,1113
16238,b-3_5853-5956_5925.wav,VTTS_b-3_5853-5956_5925.wav,8320,9369,-1049
16239,b-4_2000-5164_5105.wav,VTTS_b-4_2000-5164_5105.wav,6081,7163,-1082
16240,b-1_3228-3328_3264.wav,VTTS_b-1_3228-3328_3264.wav,3220,3704,-484
16241,b-4_2000-5164_4980.wav,VTTS_b-4_2000-5164_4980.wav,8834,8173,661
16242,b-4_2000-5164_2370.wav,VTTS_b-4_2000-5164_2370.wav,6470,7419,-949
16243,b-2_1325-1426_1359.wav,VTTS_b-2_1325-1426_1359.wav,1900,1939,-39
16244,b-4_2000-5164_4453.wav,VTTS_b-4_2000-5164_4453.wav,4769,5085,-316
16245,b-4_401-500_461.wav,VTTS_b-4_401-500_461.wav,2470,1707,763
16246,b-3_1568-1665_1591.wav,VTTS_b-3_1568-1665_1591.wav,4520,4261,259
16247,b-3_1079-1320_1299.wav,VTTS_b-3_1079-1320_1299.wav,10000,8882,1118
16248,b-3_501-930_677.wav,VTTS_b-3_501-930_677.wav,8900,8208,692
16249,b-4_2000-5164_2284.wav,VTTS_b-4_2000-5164_2284.wav,6120,5991,129
16250,b-4_1101-1220_1159.wav,VTTS_b-4_1101-1220_1159.wav,11230,10043,1187
16251,b-3_4207-4314_4237.wav,VTTS_b-3_4207-4314_4237.wav,4650,4400,250
16252,b-1_2624-2724_2673.wav,VTTS_b-1_2624-2724_2673.wav,2430,2740,-310
16253,b-1_686-793_732.wav,VTTS_b-1_686-793_732.wav,1650,1672,-22
16254,b-4_2000-5164_2898.wav,VTTS_b-4_2000-5164_2898.wav,3880,3413,467
16255,b-3_6900-7016_6919.wav,VTTS_b-3_6900-7016_6919.wav,6020,5909,111
16256,b-3_3538-3627_3595.wav,VTTS_b-3_3538-3627_3595.wav,5900,5108,792
16257,b-2_101-202_176.wav,VTTS_b-2_101-202_176.wav,1970,1974,-4
16258,b-3_6601-6700_6631.wav,VTTS_b-3_6601-6700_6631.wav,3700,3959,-259
16259,b-3_6401-6500_6456.wav,VTTS_b-3_6401-6500_6456.wav,4010,4075,-65
16260,b-3_1079-1320_1258.wav,VTTS_b-3_1079-1320_1258.wav,5700,5399,301
16261,b-3_4315-4424_4411.wav,VTTS_b-3_4315-4424_4411.wav,2960,2752,208
16262,b-1_3228-3328_3324.wav,VTTS_b-1_3228-3328_3324.wav,1980,2136,-156
16263,b-3_6701-6800_6771.wav,VTTS_b-3_6701-6800_6771.wav,2970,3913,-943
16264,b-2_611-712_653.wav,VTTS_b-2_611-712_653.wav,2040,2287,-247
16265,b-3_5428-5533_5503.wav,VTTS_b-3_5428-5533_5503.wav,6380,5387,993
16266,b-3_2855-2942_2928.wav,VTTS_b-3_2855-2942_2928.wav,3350,3158,192
16267,b-3_4498-4605_4520.wav,VTTS_b-3_4498-4605_4520.wav,3260,3541,-281
16268,b-3_2524-2854_2728.wav,VTTS_b-3_2524-2854_2728.wav,7100,11610,-4510
16269,b-2_1-100_94.wav,VTTS_b-2_1-100_94.wav,1990,2345,-355
16270,b-3_3364-3453_3410.wav,VTTS_b-3_3364-3453_3410.wav,910,848,62
16271,b-4_151-300_279.wav,VTTS_b-4_151-300_279.wav,8940,8510,430
16272,b-2_407-508_412.wav,VTTS_b-2_407-508_412.wav,3120,2810,310
16273,b-4_2000-5164_3938.wav,VTTS_b-4_2000-5164_3938.wav,6126,6002,124
16274,b-2_917-1018_1001.wav,VTTS_b-2_917-1018_1001.wav,6670,6920,-250
16275,b-1_1515-1615_1550.wav,VTTS_b-1_1515-1615_1550.wav,1900,1533,367
16276,b-4_2000-5164_2957.wav,VTTS_b-4_2000-5164_2957.wav,3378,3239,139
16277,b-2_1699-1800_1757.wav,VTTS_b-2_1699-1800_1757.wav,1340,1231,109
16278,b-2_1801-1902_1893.wav,VTTS_b-2_1801-1902_1893.wav,1970,1858,112
16279,b-3_4498-4605_4519.wav,VTTS_b-3_4498-4605_4519.wav,4080,4110,-30
16280,b-3_4498-4605_4557.wav,VTTS_b-3_4498-4605_4557.wav,1350,1161,189
16281,b-1_1919-2017_1994.wav,VTTS_b-1_1919-2017_1994.wav,3530,3460,70
16282,b-2_2209-2310_2290.wav,VTTS_b-2_2209-2310_2290.wav,1900,1741,159
16283,b-2_917-1018_978.wav,VTTS_b-2_917-1018_978.wav,1420,1405,15
16284,b-4_2000-5164_3466.wav,VTTS_b-4_2000-5164_3466.wav,5172,5190,-18
16285,b-4_1401-1505_1476.wav,VTTS_b-4_1401-1505_1476.wav,5520,4563,957
16286,b-4_1401-1505_1494.wav,VTTS_b-4_1401-1505_1494.wav,7000,7047,-47
16287,b-3_4498-4605_4550.wav,VTTS_b-3_4498-4605_4550.wav,7060,8777,-1717
16288,b-4_151-300_222.wav,VTTS_b-4_151-300_222.wav,9140,9218,-78
16289,b-2_713-814_738.wav,VTTS_b-2_713-814_738.wav,1350,1405,-55
16290,b-2_1223-1324_1223.wav,VTTS_b-2_1223-1324_1223.wav,6310,9404,-3094
16291,b-4_2000-5164_2514.wav,VTTS_b-4_2000-5164_2514.wav,5430,5004,426
16292,b-4_1814-1900_1817.wav,VTTS_b-4_1814-1900_1817.wav,4450,4389,61
16293,b-4_401-500_491.wav,VTTS_b-4_401-500_491.wav,2220,2322,-102
16294,b-1_3935-4033_3953.wav,VTTS_b-1_3935-4033_3953.wav,1950,1997,-47
16295,b-1_3834-3934_3834.wav,VTTS_b-1_3834-3934_3834.wav,1520,1393,127
16296,b-2_203-304_267.wav,VTTS_b-2_203-304_267.wav,3540,3889,-349
16297,b-1_2523-2623_2596.wav,VTTS_b-1_2523-2623_2596.wav,2280,2159,121
16298,b-3_3454-3537_3461.wav,VTTS_b-3_3454-3537_3461.wav,9720,9497,223
16299,b-2_1699-1800_1777.wav,VTTS_b-2_1699-1800_1777.wav,1210,1115,95
16300,b-4_151-300_192.wav,VTTS_b-4_151-300_192.wav,4490,3785,705
16301,b-3_3112-3197_3170.wav,VTTS_b-3_3112-3197_3170.wav,880,917,-37
16302,b-4_1901-2000_1924.wav,VTTS_b-4_1901-2000_1924.wav,6410,5166,1244
16303,b-1_4106-4141_4119.wav,VTTS_b-1_4106-4141_4119.wav,3510,3367,143
16304,b-4_2000-5164_3958.wav,VTTS_b-4_2000-5164_3958.wav,4921,5190,-269
16305,b-3_501-930_777.wav,VTTS_b-3_501-930_777.wav,4510,4110,400
16306,b-1_1717-1817_1789.wav,VTTS_b-1_1717-1817_1789.wav,1380,1416,-36
16307,b-1_478-578_538.wav,VTTS_b-1_478-578_538.wav,1160,1126,34
16308,b-1_175-275_238.wav,VTTS_b-1_175-275_238.wav,2190,2496,-306
16309,b-3_1079-1320_1312.wav,VTTS_b-3_1079-1320_1312.wav,5090,5004,86
16310,b-4_2000-5164_4189.wav,VTTS_b-4_2000-5164_4189.wav,2065,2438,-373
16311,b-4_2000-5164_3173.wav,VTTS_b-4_2000-5164_3173.wav,4681,4516,165
16312,b-1_794-1009_864.wav,VTTS_b-1_794-1009_864.wav,1710,1521,189
16313,b-3_1862-1959_1954.wav,VTTS_b-3_1862-1959_1954.wav,7130,6316,814
16314,b-2_509-610_525.wav,VTTS_b-2_509-610_525.wav,1450,1463,-13
16315,b-4_1601-1706_1624.wav,VTTS_b-4_1601-1706_1624.wav,2100,1753,347
16316,b-4_1014-1100_1049.wav,VTTS_b-4_1014-1100_1049.wav,2900,2775,125
16317,b-2_1019-1120_1101.wav,VTTS_b-2_1019-1120_1101.wav,1310,1428,-118
16318,b-3_1321-1568_1412.wav,VTTS_b-3_1321-1568_1412.wav,8760,8406,354
16319,b-3_501-930_914.wav,VTTS_b-3_501-930_914.wav,6480,5991,489
16320,b-1_175-275_240.wav,VTTS_b-1_175-275_240.wav,1460,1265,195
16321,b-4_2000-5164_4625.wav,VTTS_b-4_2000-5164_4625.wav,3675,3878,-203
16322,b-1_1414-1514_1441.wav,VTTS_b-1_1414-1514_1441.wav,1330,1405,-75
16323,b-3_6501-6600_6557.wav,VTTS_b-3_6501-6600_6557.wav,2850,2148,702
16324,b-4_1401-1505_1402.wav,VTTS_b-4_1401-1505_1402.wav,4580,4830,-250
16325,b-2_1563-1596_1593.wav,VTTS_b-2_1563-1596_1593.wav,3560,3692,-132
16326,b-1_2119-2219_2178.wav,VTTS_b-1_2119-2219_2178.wav,980,952,28
16327,b-3_6601-6700_6633.wav,VTTS_b-3_6601-6700_6633.wav,14870,11610,3260
16328,b-3_196-293_282.wav,VTTS_b-3_196-293_282.wav,2510,2612,-102
16329,b-1_2422-2522_2440.wav,VTTS_b-1_2422-2522_2440.wav,2070,1823,247
16330,b-2_1325-1426_1344.wav,VTTS_b-2_1325-1426_1344.wav,5520,6978,-1458
16331,b-1_276-376_368.wav,VTTS_b-1_276-376_368.wav,1570,1660,-90
16332,b-1_74-174_80.wav,VTTS_b-1_74-174_80.wav,1170,987,183
16333,b-3_98-195_173.wav,VTTS_b-3_98-195_173.wav,2110,1892,218
16334,b-1_1212-1312_1300.wav,VTTS_b-1_1212-1312_1300.wav,1880,1776,104
16335,b-1_2826-2926_2914.wav,VTTS_b-1_2826-2926_2914.wav,2200,1823,377
16336,b-2_1-100_88.wav,VTTS_b-2_1-100_88.wav,1760,2136,-376
16337,b-4_1506-1600_1571.wav,VTTS_b-4_1506-1600_1571.wav,3210,2624,586
16338,b-3_501-930_704.wav,VTTS_b-3_501-930_704.wav,5520,8510,-2990
16339,b-2_203-304_303.wav,VTTS_b-2_203-304_303.wav,2470,2856,-386
16340,b-3_5009-5427_5299.wav,VTTS_b-3_5009-5427_5299.wav,5050,6444,-1394
16341,b-3_3803-3888_3866.wav,VTTS_b-3_3803-3888_3866.wav,3840,3727,113
16342,b-1_1818-1918_1885.wav,VTTS_b-1_1818-1918_1885.wav,1560,1405,155
16343,b-1_1111-1211_1168.wav,VTTS_b-1_1111-1211_1168.wav,2000,1939,61
16344,b-4_1901-2000_1938.wav,VTTS_b-4_1901-2000_1938.wav,3230,3088,142
16345,b-3_5853-5956_5861.wav,VTTS_b-3_5853-5956_5861.wav,8850,8069,781
16346,b-4_501-1014_993.wav,VTTS_b-4_501-1014_993.wav,4240,3437,803
16347,b-3_1079-1320_1256.wav,VTTS_b-3_1079-1320_1256.wav,3370,3367,3
16348,b-4_2000-5164_4995.wav,VTTS_b-4_2000-5164_4995.wav,3354,3262,92
16349,b-4_2000-5164_3972.wav,VTTS_b-4_2000-5164_3972.wav,2129,2299,-170
16350,b-3_6401-6500_6427.wav,VTTS_b-3_6401-6500_6427.wav,2980,3181,-201
16351,b-4_2000-5164_4765.wav,VTTS_b-4_2000-5164_4765.wav,11057,11610,-553
16352,b-4_2000-5164_3183.wav,VTTS_b-4_2000-5164_3183.wav,4510,4563,-53
16353,b-3_4425-4497_4451.wav,VTTS_b-3_4425-4497_4451.wav,5280,4725,555
16354,b-2_815-916_895.wav,VTTS_b-2_815-916_895.wav,3850,3367,483
16355,b-3_2350-2433_2363.wav,VTTS_b-3_2350-2433_2363.wav,4710,4319,391
16356,b-4_501-1014_831.wav,VTTS_b-4_501-1014_831.wav,2830,3576,-746
16357,b-4_2000-5164_3518.wav,VTTS_b-4_2000-5164_3518.wav,2388,2241,147
16358,b-4_2000-5164_3179.wav,VTTS_b-4_2000-5164_3179.wav,3956,4110,-154
16359,b-3_2267-2349_2285.wav,VTTS_b-3_2267-2349_2285.wav,5750,5793,-43
16360,b-3_1321-1568_1346.wav,VTTS_b-3_1321-1568_1346.wav,6740,6467,273
16361,b-4_2000-5164_3023.wav,VTTS_b-4_2000-5164_3023.wav,5400,7036,-1636
16362,b-1_1919-2017_1938.wav,VTTS_b-1_1919-2017_1938.wav,4960,5352,-392
16363,b-4_2000-5164_3512.wav,VTTS_b-4_2000-5164_3512.wav,5067,5201,-134
16364,b-4_1814-1900_1884.wav,VTTS_b-4_1814-1900_1884.wav,3450,3320,130
16365,b-4_2000-5164_2377.wav,VTTS_b-4_2000-5164_2377.wav,4840,4969,-129
16366,b-4_151-300_293.wav,VTTS_b-4_151-300_293.wav,960,801,159
16367,b-4_1401-1505_1490.wav,VTTS_b-4_1401-1505_1490.wav,7270,7117,153
16368,b-4_2000-5164_4518.wav,VTTS_b-4_2000-5164_4518.wav,6739,7140,-401
16369,b-3_3454-3537_3533.wav,VTTS_b-3_3454-3537_3533.wav,2540,2624,-84
16370,b-2_305-406_382.wav,VTTS_b-2_305-406_382.wav,1830,1707,123
16371,b-3_5009-5427_5407.wav,VTTS_b-3_5009-5427_5407.wav,5570,5213,357
16372,b-3_3025-3111_3026.wav,VTTS_b-3_3025-3111_3026.wav,4280,4331,-51
16373,b-2_713-814_813.wav,VTTS_b-2_713-814_813.wav,5870,7268,-1398
16374,b-4_501-1014_955.wav,VTTS_b-4_501-1014_955.wav,1570,1416,154
16375,b-3_6401-6500_6449.wav,VTTS_b-3_6401-6500_6449.wav,3010,2902,108
16376,b-4_2000-5164_5005.wav,VTTS_b-4_2000-5164_5005.wav,3501,3123,378
16377,b-1_3026-3126_3075.wav,VTTS_b-1_3026-3126_3075.wav,3480,2949,531
16378,b-1_377-477_380.wav,VTTS_b-1_377-477_380.wav,2900,4226,-1326
16379,b-4_2000-5164_2653.wav,VTTS_b-4_2000-5164_2653.wav,1300,1161,139
16380,b-2_1223-1324_1306.wav,VTTS_b-2_1223-1324_1306.wav,4060,5248,-1188
16381,b-3_6116-6215_6153.wav,VTTS_b-3_6116-6215_6153.wav,3030,2961,69
16382,b-1_4430-4465_4457.wav,VTTS_b-1_4430-4465_4457.wav,2730,2775,-45
16383,b-3_5745-5852_5816.wav,VTTS_b-3_5745-5852_5816.wav,5530,5503,27
16384,b-1_2220-2320_2233.wav,VTTS_b-1_2220-2320_2233.wav,1870,1358,512
16385,b-1_579-649_634.wav,VTTS_b-1_579-649_634.wav,1680,1800,-120
16386,b-1_2422-2522_2434.wav,VTTS_b-1_2422-2522_2434.wav,4260,4412,-152
16387,b-4_2000-5164_4016.wav,VTTS_b-4_2000-5164_4016.wav,2413,2078,335
16388,b-3_2177-2266_2235.wav,VTTS_b-3_2177-2266_2235.wav,3560,3541,19
16389,b-3_4425-4497_4437.wav,VTTS_b-3_4425-4497_4437.wav,6660,6130,530
16390,b-4_301-400_365.wav,VTTS_b-4_301-400_365.wav,5230,5039,191
16391,b-4_2000-5164_2219.wav,VTTS_b-4_2000-5164_2219.wav,3800,3541,259
16392,b-3_4207-4314_4226.wav,VTTS_b-3_4207-4314_4226.wav,10190,10472,-282
16393,b-1_794-1009_809.wav,VTTS_b-1_794-1009_809.wav,1800,1753,47
16394,b-3_6701-6800_6784.wav,VTTS_b-3_6701-6800_6784.wav,3180,2984,196
16395,b-2_917-1018_953.wav,VTTS_b-2_917-1018_953.wav,3790,5166,-1376
16396,b-3_5639-5744_5694.wav,VTTS_b-3_5639-5744_5694.wav,5680,5631,49
16397,b-1_175-275_242.wav,VTTS_b-1_175-275_242.wav,1880,1672,208
16398,b-4_2000-5164_3465.wav,VTTS_b-4_2000-5164_3465.wav,5468,5155,313
16399,b-2_1223-1324_1240.wav,VTTS_b-2_1223-1324_1240.wav,4490,5236,-746
16400,b-2_713-814_758.wav,VTTS_b-2_713-814_758.wav,1420,1451,-31
16401,b-1_4214-4285_4284.wav,VTTS_b-1_4214-4285_4284.wav,1490,1602,-112
16402,b-2_1801-1902_1820.wav,VTTS_b-2_1801-1902_1820.wav,2810,2276,534
16403,b-3_6401-6500_6402.wav,VTTS_b-3_6401-6500_6402.wav,6030,5283,747
16404,b-3_6501-6600_6582.wav,VTTS_b-3_6501-6600_6582.wav,3330,3460,-130
16405,b-3_4607-5008_4794.wav,VTTS_b-3_4607-5008_4794.wav,4170,4690,-520
16406,b-3_5009-5427_5247.wav,VTTS_b-3_5009-5427_5247.wav,6060,5759,301
16407,b-3_4498-4605_4563.wav,VTTS_b-3_4498-4605_4563.wav,5990,5956,34
16408,b-4_151-300_223.wav,VTTS_b-4_151-300_223.wav,4820,4934,-114
16409,b-3_5009-5427_5276.wav,VTTS_b-3_5009-5427_5276.wav,4410,4377,33
16410,b-3_1666-1763_1673.wav,VTTS_b-3_1666-1763_1673.wav,4580,5956,-1376
16411,b-2_1121-1222_1164.wav,VTTS_b-2_1121-1222_1164.wav,4530,5642,-1112
16412,b-2_203-304_277.wav,VTTS_b-2_203-304_277.wav,2650,2415,235
16413,b-2_1121-1222_1152.wav,VTTS_b-2_1121-1222_1152.wav,830,1254,-424
16414,b-4_1301-1400_1393.wav,VTTS_b-4_1301-1400_1393.wav,6000,6037,-37
16415,b-3_3889-4000_3915.wav,VTTS_b-3_3889-4000_3915.wav,3080,2868,212
16416,b-4_2000-5164_5162.wav,VTTS_b-4_2000-5164_5162.wav,6331,6200,131
16417,b-2_407-508_448.wav,VTTS_b-2_407-508_448.wav,2550,1974,576
16418,b-3_4607-5008_4612.wav,VTTS_b-3_4607-5008_4612.wav,1330,1358,-28
16419,b-4_2000-5164_3303.wav,VTTS_b-4_2000-5164_3303.wav,7011,6815,196
16420,b-1_3228-3328_3305.wav,VTTS_b-1_3228-3328_3305.wav,1330,1509,-179
16421,b-1_1515-1615_1555.wav,VTTS_b-1_1515-1615_1555.wav,1440,1254,186
16422,b-1_1919-2017_1972.wav,VTTS_b-1_1919-2017_1972.wav,2940,2508,432
16423,b-2_2073-2106_2082.wav,VTTS_b-2_2073-2106_2082.wav,2530,2287,243
16424,b-4_2000-5164_2110.wav,VTTS_b-4_2000-5164_2110.wav,6280,6142,138
16425,b-3_1321-1568_1479.wav,VTTS_b-3_1321-1568_1479.wav,4430,4052,378
16426,b-2_1019-1120_1042.wav,VTTS_b-2_1019-1120_1042.wav,3570,3460,110
16427,b-2_1801-1902_1877.wav,VTTS_b-2_1801-1902_1877.wav,2600,2403,197
16428,b-1_794-1009_813.wav,VTTS_b-1_794-1009_813.wav,6020,6026,-6
16429,b-3_4607-5008_4908.wav,VTTS_b-3_4607-5008_4908.wav,3090,3158,-68
16430,b-4_501-1014_863.wav,VTTS_b-4_501-1014_863.wav,3390,3088,302
16431,b-1_175-275_257.wav,VTTS_b-1_175-275_257.wav,4960,5016,-56
16432,b-1_2119-2219_2175.wav,VTTS_b-1_2119-2219_2175.wav,1680,1509,171
16433,b-3_3112-3197_3186.wav,VTTS_b-3_3112-3197_3186.wav,7400,7187,213
16434,b-2_305-406_326.wav,VTTS_b-2_305-406_326.wav,2240,2310,-70
16435,b-3_4001-4103_4100.wav,VTTS_b-3_4001-4103_4100.wav,4560,4493,67
16436,b-3_501-930_790.wav,VTTS_b-3_501-930_790.wav,5900,5817,83
16437,b-4_2000-5164_4577.wav,VTTS_b-4_2000-5164_4577.wav,4251,6502,-2251
16438,b-3_3364-3453_3403.wav,VTTS_b-3_3364-3453_3403.wav,8530,7419,1111
16439,b-4_2000-5164_5007.wav,VTTS_b-4_2000-5164_5007.wav,5463,5213,250
16440,b-3_5639-5744_5730.wav,VTTS_b-3_5639-5744_5730.wav,3100,3332,-232
16441,b-4_1707-1813_1797.wav,VTTS_b-4_1707-1813_1797.wav,2940,2426,514
16442,b-3_2524-2854_2687.wav,VTTS_b-3_2524-2854_2687.wav,3430,3158,272
16443,b-3_501-930_561.wav,VTTS_b-3_501-930_561.wav,10770,10333,437
16444,b-4_2000-5164_4565.wav,VTTS_b-4_2000-5164_4565.wav,1770,3030,-1260
16445,b-3_1079-1320_1264.wav,VTTS_b-3_1079-1320_1264.wav,12870,11610,1260
16446,b-3_294-391_361.wav,VTTS_b-3_294-391_361.wav,8040,8069,-29
16447,b-1_1212-1312_1282.wav,VTTS_b-1_1212-1312_1282.wav,3360,2879,481
16448,b-3_6217-6274_6234.wav,VTTS_b-3_6217-6274_6234.wav,4120,4400,-280
16449,b-3_5009-5427_5026.wav,VTTS_b-3_5009-5427_5026.wav,6300,6200,100
16450,b-3_501-930_842.wav,VTTS_b-3_501-930_842.wav,8580,7558,1022
16451,b-4_2000-5164_3509.wav,VTTS_b-4_2000-5164_3509.wav,5003,6571,-1568
16452,b-1_4394-4429_4394.wav,VTTS_b-1_4394-4429_4394.wav,2830,2856,-26
16453,b-3_5639-5744_5726.wav,VTTS_b-3_5639-5744_5726.wav,11680,10344,1336
16454,b-2_815-916_851.wav,VTTS_b-2_815-916_851.wav,1550,1776,-226
16455,b-2_1427-1562_1506.wav,VTTS_b-2_1427-1562_1506.wav,5020,9172,-4152
16456,b-3_6401-6500_6468.wav,VTTS_b-3_6401-6500_6468.wav,3130,2740,390
16457,b-3_6501-6600_6562.wav,VTTS_b-3_6501-6600_6562.wav,5630,5004,626
16458,b-2_1427-1562_1495.wav,VTTS_b-2_1427-1562_1495.wav,1160,1730,-570
16459,b-3_4607-5008_4937.wav,VTTS_b-3_4607-5008_4937.wav,2250,2229,21
16460,b-3_931-979_971.wav,VTTS_b-3_931-979_971.wav,2210,2264,-54
16461,b-4_2000-5164_2057.wav,VTTS_b-4_2000-5164_2057.wav,6100,6478,-378
16462,b-4_2000-5164_4510.wav,VTTS_b-4_2000-5164_4510.wav,4283,4969,-686
16463,b-1_1414-1514_1435.wav,VTTS_b-1_1414-1514_1435.wav,1610,1347,263
16464,b-3_98-195_183.wav,VTTS_b-3_98-195_183.wav,9250,9485,-235
16465,b-3_1862-1959_1930.wav,VTTS_b-3_1862-1959_1930.wav,9430,11064,-1634
16466,b-3_392-500_430.wav,VTTS_b-3_392-500_430.wav,7510,8057,-547
16467,b-4_2000-5164_3190.wav,VTTS_b-4_2000-5164_3190.wav,1660,1579,81
16468,b-1_2624-2724_2691.wav,VTTS_b-1_2624-2724_2691.wav,1850,2009,-159
16469,b-4_1901-2000_1935.wav,VTTS_b-4_1901-2000_1935.wav,7700,10751,-3051
16470,b-2_2107-2193_2151.wav,VTTS_b-2_2107-2193_2151.wav,2330,2287,43
16471,b-1_2321-2421_2333.wav,VTTS_b-1_2321-2421_2333.wav,1570,1567,3
16472,b-3_1079-1320_1088.wav,VTTS_b-3_1079-1320_1088.wav,6100,5248,852
16473,b-4_1101-1220_1206.wav,VTTS_b-4_1101-1220_1206.wav,7800,7837,-37
16474,b-4_501-1014_782.wav,VTTS_b-4_501-1014_782.wav,6900,6362,538
16475,b-3_3628-3714_3704.wav,VTTS_b-3_3628-3714_3704.wav,4040,3715,325
16476,b-1_74-174_122.wav,VTTS_b-1_74-174_122.wav,3490,3634,-144
16477,b-4_2000-5164_3561.wav,VTTS_b-4_2000-5164_3561.wav,3872,3541,331
16478,b-3_294-391_299.wav,VTTS_b-3_294-391_299.wav,4840,5213,-373
16479,b-4_2000-5164_3054.wav,VTTS_b-4_2000-5164_3054.wav,2096,2310,-214
16480,b-4_2000-5164_4468.wav,VTTS_b-4_2000-5164_4468.wav,4954,4737,217
16481,b-1_2018-2118_2049.wav,VTTS_b-1_2018-2118_2049.wav,1390,1567,-177
16482,b-3_2350-2433_2401.wav,VTTS_b-3_2350-2433_2401.wav,2410,2322,88
16483,b-3_5639-5744_5656.wav,VTTS_b-3_5639-5744_5656.wav,4360,4145,215
16484,b-4_151-300_297.wav,VTTS_b-4_151-300_297.wav,1660,1625,35
16485,b-1_478-578_531.wav,VTTS_b-1_478-578_531.wav,1120,871,249
16486,b-1_3733-3833_3810.wav,VTTS_b-1_3733-3833_3810.wav,4160,4331,-171
16487,b-4_1101-1220_1161.wav,VTTS_b-4_1101-1220_1161.wav,12480,11610,870
16488,b-4_1814-1900_1899.wav,VTTS_b-4_1814-1900_1899.wav,9000,8800,200
16489,b-1_1919-2017_1977.wav,VTTS_b-1_1919-2017_1977.wav,2710,2368,342
16490,b-4_2000-5164_2714.wav,VTTS_b-4_2000-5164_2714.wav,3150,3100,50
16491,b-3_2434-2523_2522.wav,VTTS_b-3_2434-2523_2522.wav,7100,6687,413
16492,b-3_2350-2433_2427.wav,VTTS_b-3_2350-2433_2427.wav,3150,3576,-426
16493,b-3_3025-3111_3080.wav,VTTS_b-3_3025-3111_3080.wav,3630,3727,-97
16494,b-3_3803-3888_3872.wav,VTTS_b-3_3803-3888_3872.wav,1850,1881,-31
16495,b-3_6016-6115_6034.wav,VTTS_b-3_6016-6115_6034.wav,3530,3181,349
16496,b-3_3715-3802_3792.wav,VTTS_b-3_3715-3802_3792.wav,8030,8406,-376
16497,b-3_5009-5427_5370.wav,VTTS_b-3_5009-5427_5370.wav,5300,4551,749
16498,b-3_2855-2942_2889.wav,VTTS_b-3_2855-2942_2889.wav,3550,3634,-84
16499,b-3_3198-3278_3252.wav,VTTS_b-3_3198-3278_3252.wav,5070,4598,472
16500,b-3_2524-2854_2654.wav,VTTS_b-3_2524-2854_2654.wav,2680,2508,172
16501,b-3_6701-6800_6777.wav,VTTS_b-3_6701-6800_6777.wav,3640,3669,-29
16502,b-3_4607-5008_5001.wav,VTTS_b-3_4607-5008_5001.wav,3300,3251,49
16503,b-3_3025-3111_3052.wav,VTTS_b-3_3025-3111_3052.wav,4270,4261,9
16504,b-1_2119-2219_2120.wav,VTTS_b-1_2119-2219_2120.wav,950,998,-48
16505,b-1_3026-3126_3057.wav,VTTS_b-1_3026-3126_3057.wav,2860,2659,201
16506,b-2_1121-1222_1172.wav,VTTS_b-2_1121-1222_1172.wav,3260,3611,-351
16507,b-3_6116-6215_6118.wav,VTTS_b-3_6116-6215_6118.wav,6530,8336,-1806
16508,b-2_815-916_827.wav,VTTS_b-2_815-916_827.wav,1810,2055,-245
16509,b-1_175-275_182.wav,VTTS_b-1_175-275_182.wav,3010,3471,-461
16510,b-4_1014-1100_1041.wav,VTTS_b-4_1014-1100_1041.wav,1230,1254,-24
16511,b-1_1010-1110_1082.wav,VTTS_b-1_1010-1110_1082.wav,3660,3320,340
16512,b-1_794-1009_927.wav,VTTS_b-1_794-1009_927.wav,3330,3158,172
16513,b-4_2000-5164_4807.wav,VTTS_b-4_2000-5164_4807.wav,2255,2113,142
16514,b-4_2000-5164_4812.wav,VTTS_b-4_2000-5164_4812.wav,5551,5317,234
16515,b-3_1666-1763_1672.wav,VTTS_b-3_1666-1763_1672.wav,2470,2252,218
16516,b-2_2107-2193_2161.wav,VTTS_b-2_2107-2193_2161.wav,4660,4946,-286
16517,b-3_3538-3627_3593.wav,VTTS_b-3_3538-3627_3593.wav,1650,1591,59
16518,b-1_2119-2219_2130.wav,VTTS_b-1_2119-2219_2130.wav,1160,1022,138
16519,b-4_2000-5164_2881.wav,VTTS_b-4_2000-5164_2881.wav,4300,4133,167
16520,b-3_2524-2854_2652.wav,VTTS_b-3_2524-2854_2652.wav,2010,2090,-80
16521,b-1_794-1009_901.wav,VTTS_b-1_794-1009_901.wav,1830,1660,170
16522,b-4_501-1014_767.wav,VTTS_b-4_501-1014_767.wav,9340,8766,574
16523,b-1_3430-3530_3526.wav,VTTS_b-1_3430-3530_3526.wav,2470,2380,90
16524,b-1_3733-3833_3786.wav,VTTS_b-1_3733-3833_3786.wav,5160,6293,-1133
16525,b-1_2321-2421_2373.wav,VTTS_b-1_2321-2421_2373.wav,1860,1904,-44
16526,b-2_1427-1562_1499.wav,VTTS_b-2_1427-1562_1499.wav,1190,1219,-29
16527,b-4_2000-5164_2974.wav,VTTS_b-4_2000-5164_2974.wav,2673,2624,49
16528,b-3_1079-1320_1223.wav,VTTS_b-3_1079-1320_1223.wav,5240,5166,74
16529,b-4_1301-1400_1385.wav,VTTS_b-4_1301-1400_1385.wav,5030,4737,293
16530,b-3_4207-4314_4241.wav,VTTS_b-3_4207-4314_4241.wav,3510,3088,422
16531,b-2_2413-2500_2413.wav,VTTS_b-2_2413-2500_2413.wav,1230,1149,81
16532,b-1_4322-4357_4327.wav,VTTS_b-1_4322-4357_4327.wav,1980,1544,436
16533,b-1_3329-3429_3403.wav,VTTS_b-1_3329-3429_3403.wav,3170,3878,-708
16534,b-4_2000-5164_2569.wav,VTTS_b-4_2000-5164_2569.wav,7295,7187,108
16535,b-3_5009-5427_5314.wav,VTTS_b-3_5009-5427_5314.wav,6550,7279,-729
16536,b-3_3112-3197_3142.wav,VTTS_b-3_3112-3197_3142.wav,3040,2728,312
16537,b-1_3329-3429_3398.wav,VTTS_b-1_3329-3429_3398.wav,1670,2276,-606
16538,b-1_3632-3732_3675.wav,VTTS_b-1_3632-3732_3675.wav,4540,6432,-1892
16539,b-3_5533-5638_5633.wav,VTTS_b-3_5533-5638_5633.wav,8900,8998,-98
16540,b-4_1814-1900_1855.wav,VTTS_b-4_1814-1900_1855.wav,5530,5074,456
16541,b-4_2000-5164_3220.wav,VTTS_b-4_2000-5164_3220.wav,5983,7477,-1494
16542,b-1_1616-1716_1645.wav,VTTS_b-1_1616-1716_1645.wav,2440,2194,246
16543,b-4_2000-5164_3193.wav,VTTS_b-4_2000-5164_3193.wav,6542,6711,-169
16544,b-2_1563-1596_1584.wav,VTTS_b-2_1563-1596_1584.wav,1900,1916,-16
16545,b-3_1321-1568_1499.wav,VTTS_b-3_1321-1568_1499.wav,5400,5329,71
16546,b-4_1901-2000_1941.wav,VTTS_b-4_1901-2000_1941.wav,3970,3808,162
16547,b-4_501-1014_875.wav,VTTS_b-4_501-1014_875.wav,2280,2020,260
16548,b-2_1-100_18.wav,VTTS_b-2_1-100_18.wav,4180,4853,-673
16549,b-1_686-793_760.wav,VTTS_b-1_686-793_760.wav,1810,1718,92
16550,b-4_2000-5164_3378.wav,VTTS_b-4_2000-5164_3378.wav,12665,11610,1055
16551,b-3_1862-1959_1942.wav,VTTS_b-3_1862-1959_1942.wav,2010,2287,-277
16552,b-3_5639-5744_5701.wav,VTTS_b-3_5639-5744_5701.wav,4500,3622,878
16553,b-1_2624-2724_2723.wav,VTTS_b-1_2624-2724_2723.wav,1900,1869,31
16554,b-3_294-391_359.wav,VTTS_b-3_294-391_359.wav,5060,4853,207
16555,b-1_686-793_724.wav,VTTS_b-1_686-793_724.wav,1950,1927,23
16556,b-3_4607-5008_4856.wav,VTTS_b-3_4607-5008_4856.wav,2890,2670,220
16557,b-2_305-406_362.wav,VTTS_b-2_305-406_362.wav,1380,1382,-2
16558,b-4_1-52_29.wav,VTTS_b-4_1-52_29.wav,6660,5944,716
16559,b-3_4607-5008_4653.wav,VTTS_b-3_4607-5008_4653.wav,4070,3843,227
16560,b-3_501-930_641.wav,VTTS_b-3_501-930_641.wav,5670,5410,260
16561,b-1_3430-3530_3472.wav,VTTS_b-1_3430-3530_3472.wav,2360,2461,-101
16562,b-3_5533-5638_5569.wav,VTTS_b-3_5533-5638_5569.wav,3290,3262,28
16563,b-4_2000-5164_4441.wav,VTTS_b-4_2000-5164_4441.wav,1785,1707,78
16564,b-4_2000-5164_2349.wav,VTTS_b-4_2000-5164_2349.wav,6020,5956,64
16565,b-1_175-275_270.wav,VTTS_b-1_175-275_270.wav,1860,1800,60
16566,b-2_1325-1426_1395.wav,VTTS_b-2_1325-1426_1395.wav,2100,2473,-373
16567,b-3_5009-5427_5417.wav,VTTS_b-3_5009-5427_5417.wav,3990,4029,-39
16568,b-1_3632-3732_3704.wav,VTTS_b-1_3632-3732_3704.wav,2270,2508,-238
16569,b-1_3430-3530_3511.wav,VTTS_b-1_3430-3530_3511.wav,2590,2659,-69
16570,b-1_686-793_779.wav,VTTS_b-1_686-793_779.wav,1790,1625,165
16571,b-2_917-1018_1013.wav,VTTS_b-2_917-1018_1013.wav,1750,1858,-108
16572,b-2_1325-1426_1405.wav,VTTS_b-2_1325-1426_1405.wav,5180,4087,1093
16573,b-2_1801-1902_1814.wav,VTTS_b-2_1801-1902_1814.wav,1610,1486,124
16574,b-1_276-376_337.wav,VTTS_b-1_276-376_337.wav,1140,1219,-79
16575,b-1_2523-2623_2595.wav,VTTS_b-1_2523-2623_2595.wav,1810,1950,-140
16576,b-3_6401-6500_6409.wav,VTTS_b-3_6401-6500_6409.wav,960,929,31
16577,b-1_686-793_783.wav,VTTS_b-1_686-793_783.wav,2130,2055,75
16578,b-4_2000-5164_2700.wav,VTTS_b-4_2000-5164_2700.wav,1620,1207,413
16579,b-2_1427-1562_1481.wav,VTTS_b-2_1427-1562_1481.wav,1650,1614,36
16580,b-3_3364-3453_3368.wav,VTTS_b-3_3364-3453_3368.wav,3350,3286,64
16581,b-4_501-1014_631.wav,VTTS_b-4_501-1014_631.wav,1950,1741,209
16582,b-2_815-916_885.wav,VTTS_b-2_815-916_885.wav,2180,2067,113
16583,b-3_3715-3802_3775.wav,VTTS_b-3_3715-3802_3775.wav,4410,4679,-269
16584,b-3_1862-1959_1892.wav,VTTS_b-3_1862-1959_1892.wav,6310,5991,319
16585,b-1_2119-2219_2186.wav,VTTS_b-1_2119-2219_2186.wav,1550,1672,-122
16586,b-3_2855-2942_2896.wav,VTTS_b-3_2855-2942_2896.wav,6590,6571,19
16587,b-3_5009-5427_5367.wav,VTTS_b-3_5009-5427_5367.wav,7650,8173,-523
16588,b-4_2000-5164_4333.wav,VTTS_b-4_2000-5164_4333.wav,2264,2194,70
16589,b-1_686-793_726.wav,VTTS_b-1_686-793_726.wav,1160,1393,-233
16590,b-2_101-202_112.wav,VTTS_b-2_101-202_112.wav,3160,3390,-230
16591,b-3_501-930_706.wav,VTTS_b-3_501-930_706.wav,5540,5468,72
16592,b-2_2040-2072_2062.wav,VTTS_b-2_2040-2072_2062.wav,1990,1683,307
16593,b-2_1121-1222_1123.wav,VTTS_b-2_1121-1222_1123.wav,3270,3042,228
16594,b-1_1414-1514_1428.wav,VTTS_b-1_1414-1514_1428.wav,1480,1393,87
16595,b-1_377-477_436.wav,VTTS_b-1_377-477_436.wav,1400,1683,-283
16596,b-1_276-376_353.wav,VTTS_b-1_276-376_353.wav,1870,1695,175
16597,b-2_713-814_811.wav,VTTS_b-2_713-814_811.wav,2300,2206,94
16598,b-1_2826-2926_2910.wav,VTTS_b-1_2826-2926_2910.wav,3780,4307,-527
16599,b-3_2267-2349_2337.wav,VTTS_b-3_2267-2349_2337.wav,7670,6490,1180
16600,b-3_4104-4206_4127.wav,VTTS_b-3_4104-4206_4127.wav,3850,3669,181
16601,b-4_2000-5164_4616.wav,VTTS_b-4_2000-5164_4616.wav,3050,2821,229
16602,b-2_305-406_390.wav,VTTS_b-2_305-406_390.wav,1360,1358,2
16603,b-4_2000-5164_3829.wav,VTTS_b-4_2000-5164_3829.wav,6805,7047,-242
16604,b-3_4207-4314_4270.wav,VTTS_b-3_4207-4314_4270.wav,7730,7059,671
16605,b-3_6900-7016_6939.wav,VTTS_b-3_6900-7016_6939.wav,3510,3170,340
16606,b-1_1010-1110_1040.wav,VTTS_b-1_1010-1110_1040.wav,5030,4992,38
16607,b-3_2524-2854_2555.wav,VTTS_b-3_2524-2854_2555.wav,9410,10855,-1445
16608,b-3_196-293_268.wav,VTTS_b-3_196-293_268.wav,3750,3622,128
16609,b-4_2000-5164_2354.wav,VTTS_b-4_2000-5164_2354.wav,3720,3785,-65
16610,b-3_3715-3802_3716.wav,VTTS_b-3_3715-3802_3716.wav,5790,4447,1343
16611,b-2_2413-2500_2447.wav,VTTS_b-2_2413-2500_2447.wav,1280,1347,-67
16612,b-4_2000-5164_4522.wav,VTTS_b-4_2000-5164_4522.wav,2020,2020,0
16613,b-3_1568-1665_1626.wav,VTTS_b-3_1568-1665_1626.wav,3340,3437,-97
16614,b-2_101-202_160.wav,VTTS_b-2_101-202_160.wav,1360,1567,-207
16615,b-4_2000-5164_3471.wav,VTTS_b-4_2000-5164_3471.wav,4664,4876,-212
16616,b-2_1699-1800_1701.wav,VTTS_b-2_1699-1800_1701.wav,1330,1196,134
16617,b-2_2209-2310_2260.wav,VTTS_b-2_2209-2310_2260.wav,1590,1533,57
16618,b-3_4607-5008_4866.wav,VTTS_b-3_4607-5008_4866.wav,4510,4714,-204
16619,b-3_4207-4314_4236.wav,VTTS_b-3_4207-4314_4236.wav,6420,5944,476
16620,b-2_917-1018_920.wav,VTTS_b-2_917-1018_920.wav,1180,1184,-4
16621,b-2_1019-1120_1104.wav,VTTS_b-2_1019-1120_1104.wav,4040,3506,534
16622,b-4_2000-5164_4432.wav,VTTS_b-4_2000-5164_4432.wav,10010,11610,-1600
16623,b-3_4607-5008_4776.wav,VTTS_b-3_4607-5008_4776.wav,3580,3704,-124
16624,b-1_1111-1211_1205.wav,VTTS_b-1_1111-1211_1205.wav,5970,4876,1094
16625,b-2_611-712_667.wav,VTTS_b-2_611-712_667.wav,1770,1277,493
16626,b-3_3803-3888_3875.wav,VTTS_b-3_3803-3888_3875.wav,6780,6769,11
16627,b-1_3632-3732_3651.wav,VTTS_b-1_3632-3732_3651.wav,4600,6571,-1971
16628,b-1_2826-2926_2921.wav,VTTS_b-1_2826-2926_2921.wav,2520,2450,70
16629,b-3_5009-5427_5232.wav,VTTS_b-3_5009-5427_5232.wav,3010,3181,-171
16630,b-2_101-202_105.wav,VTTS_b-2_101-202_105.wav,1920,2426,-506
16631,b-4_2000-5164_4808.wav,VTTS_b-4_2000-5164_4808.wav,3684,3727,-43
16632,b-4_2000-5164_3772.wav,VTTS_b-4_2000-5164_3772.wav,8790,10286,-1496
16633,b-4_53-150_96.wav,VTTS_b-4_53-150_96.wav,7370,6780,590
16634,b-4_1506-1600_1543.wav,VTTS_b-4_1506-1600_1543.wav,4690,5259,-569
16635,b-4_2000-5164_4062.wav,VTTS_b-4_2000-5164_4062.wav,3393,2856,537
16636,b-3_5853-5956_5855.wav,VTTS_b-3_5853-5956_5855.wav,5650,5352,298
16637,b-4_2000-5164_3652.wav,VTTS_b-4_2000-5164_3652.wav,5419,5062,357
16638,b-1_3127-3227_3203.wav,VTTS_b-1_3127-3227_3203.wav,3320,3297,23
16639,b-1_2624-2724_2676.wav,VTTS_b-1_2624-2724_2676.wav,1900,2345,-445
16640,b-2_2209-2310_2277.wav,VTTS_b-2_2209-2310_2277.wav,1520,1335,185
16641,b-3_6116-6215_6206.wav,VTTS_b-3_6116-6215_6206.wav,1440,1347,93
16642,b-4_2000-5164_3896.wav,VTTS_b-4_2000-5164_3896.wav,5694,5677,17
16643,b-3_6274-6300_6281.wav,VTTS_b-3_6274-6300_6281.wav,5430,5759,-329
16644,b-2_1325-1426_1389.wav,VTTS_b-2_1325-1426_1389.wav,2480,2717,-237
16645,b-3_5853-5956_5854.wav,VTTS_b-3_5853-5956_5854.wav,5880,5341,539
16646,b-3_3198-3278_3247.wav,VTTS_b-3_3198-3278_3247.wav,10340,9253,1087
16647,b-3_5745-5852_5768.wav,VTTS_b-3_5745-5852_5768.wav,4880,4644,236
16648,b-1_2927-3025_2943.wav,VTTS_b-1_2927-3025_2943.wav,1870,1974,-104
16649,b-4_2000-5164_4944.wav,VTTS_b-4_2000-5164_4944.wav,4813,4934,-121
16650,b-3_5009-5427_5221.wav,VTTS_b-3_5009-5427_5221.wav,6160,6432,-272
16651,b-1_1616-1716_1628.wav,VTTS_b-1_1616-1716_1628.wav,3470,5271,-1801
16652,b-4_2000-5164_4183.wav,VTTS_b-4_2000-5164_4183.wav,6884,8046,-1162
16653,b-4_1221-1300_1233.wav,VTTS_b-4_1221-1300_1233.wav,2520,2450,70
16654,b-4_2000-5164_3678.wav,VTTS_b-4_2000-5164_3678.wav,6089,6594,-505
16655,b-4_2000-5164_3661.wav,VTTS_b-4_2000-5164_3661.wav,5247,5294,-47
16656,b-4_2000-5164_3614.wav,VTTS_b-4_2000-5164_3614.wav,5116,4760,356
16657,b-4_2000-5164_4363.wav,VTTS_b-4_2000-5164_4363.wav,5366,5933,-567
16658,b-4_1901-2000_1975.wav,VTTS_b-4_1901-2000_1975.wav,8860,8707,153
16659,b-3_501-930_624.wav,VTTS_b-3_501-930_624.wav,5750,5097,653
16660,b-2_2209-2310_2299.wav,VTTS_b-2_2209-2310_2299.wav,1970,2043,-73
16661,b-3_501-930_648.wav,VTTS_b-3_501-930_648.wav,5680,5166,514
16662,b-3_4104-4206_4124.wav,VTTS_b-3_4104-4206_4124.wav,9450,8591,859
16663,b-3_1-97_7.wav,VTTS_b-3_1-97_7.wav,8620,7814,806
16664,b-2_2209-2310_2227.wav,VTTS_b-2_2209-2310_2227.wav,1550,1184,366
16665,b-2_1563-1596_1577.wav,VTTS_b-2_1563-1596_1577.wav,1330,1521,-191
16666,b-3_2350-2433_2350.wav,VTTS_b-3_2350-2433_2350.wav,6440,8719,-2279
16667,b-4_501-1014_918.wav,VTTS_b-4_501-1014_918.wav,5480,6792,-1312
16668,b-4_1221-1300_1287.wav,VTTS_b-4_1221-1300_1287.wav,4670,4725,-55
16669,b-4_1014-1100_1099.wav,VTTS_b-4_1014-1100_1099.wav,2300,2067,233
16670,b-2_407-508_508.wav,VTTS_b-2_407-508_508.wav,4370,4946,-576
16671,b-4_2000-5164_2106.wav,VTTS_b-4_2000-5164_2106.wav,5050,4644,406
16672,b-3_1568-1665_1572.wav,VTTS_b-3_1568-1665_1572.wav,5350,5132,218
16673,b-1_4034-4069_4063.wav,VTTS_b-1_4034-4069_4063.wav,1650,1533,117
16674,b-4_2000-5164_2581.wav,VTTS_b-4_2000-5164_2581.wav,3800,3924,-124
16675,b-3_5428-5533_5486.wav,VTTS_b-3_5428-5533_5486.wav,2690,2868,-178
16676,b-4_1101-1220_1129.wav,VTTS_b-4_1101-1220_1129.wav,10710,9996,714
16677,b-1_686-793_706.wav,VTTS_b-1_686-793_706.wav,1610,1509,101
16678,b-3_98-195_164.wav,VTTS_b-3_98-195_164.wav,1630,1382,248
16679,b-3_6217-6274_6241.wav,VTTS_b-3_6217-6274_6241.wav,2220,2345,-125
16680,b-4_2000-5164_4699.wav,VTTS_b-4_2000-5164_4699.wav,4458,11610,-7152
16681,b-1_1818-1918_1880.wav,VTTS_b-1_1818-1918_1880.wav,2320,2067,253
16682,b-3_4498-4605_4531.wav,VTTS_b-3_4498-4605_4531.wav,4030,3913,117
16683,b-1_1818-1918_1916.wav,VTTS_b-1_1818-1918_1916.wav,1710,1649,61
16684,b-2_2209-2310_2214.wav,VTTS_b-2_2209-2310_2214.wav,1170,1219,-49
16685,b-4_301-400_391.wav,VTTS_b-4_301-400_391.wav,6980,11610,-4630
16686,b-4_2000-5164_3037.wav,VTTS_b-4_2000-5164_3037.wav,2961,2728,233
16687,b-3_1079-1320_1319.wav,VTTS_b-3_1079-1320_1319.wav,6420,6211,209
16688,b-4_2000-5164_3361.wav,VTTS_b-4_2000-5164_3361.wav,3825,4481,-656
16689,b-3_3628-3714_3707.wav,VTTS_b-3_3628-3714_3707.wav,5790,4458,1332
16690,b-1_1111-1211_1182.wav,VTTS_b-1_1111-1211_1182.wav,5300,4272,1028
16691,b-4_2000-5164_4871.wav,VTTS_b-4_2000-5164_4871.wav,4959,4238,721
16692,b-3_4607-5008_4703.wav,VTTS_b-3_4607-5008_4703.wav,6200,5828,372
16693,b-1_4070-4105_4106.wav,VTTS_b-1_4070-4105_4106.wav,2620,2577,43
16694,b-2_1-100_26.wav,VTTS_b-2_1-100_26.wav,2440,5004,-2564
16695,b-4_401-500_466.wav,VTTS_b-4_401-500_466.wav,6150,11610,-5460
16696,b-3_4498-4605_4498.wav,VTTS_b-3_4498-4605_4498.wav,4160,3831,329
16697,b-3_501-930_657.wav,VTTS_b-3_501-930_657.wav,8130,11610,-3480
16698,b-3_1079-1320_1272.wav,VTTS_b-3_1079-1320_1272.wav,6160,5631,529
16699,b-3_6401-6500_6420.wav,VTTS_b-3_6401-6500_6420.wav,3260,4389,-1129
16700,b-1_4178-4213_4179.wav,VTTS_b-1_4178-4213_4179.wav,2120,2322,-202
16701,b-1_3329-3429_3392.wav,VTTS_b-1_3329-3429_3392.wav,2890,3146,-256
16702,b-1_3430-3530_3499.wav,VTTS_b-1_3430-3530_3499.wav,1270,1405,-135
16703,b-2_509-610_543.wav,VTTS_b-2_509-610_543.wav,4480,4574,-94
16704,b-2_407-508_446.wav,VTTS_b-2_407-508_446.wav,2720,2508,212
16705,b-4_1401-1505_1459.wav,VTTS_b-4_1401-1505_1459.wav,1050,987,63
16706,b-3_1764-1861_1818.wav,VTTS_b-3_1764-1861_1818.wav,8840,9230,-390
16707,b-2_2107-2193_2110.wav,VTTS_b-2_2107-2193_2110.wav,1930,1974,-44
16708,b-3_4607-5008_5002.wav,VTTS_b-3_4607-5008_5002.wav,2490,2624,-134
16709,b-4_2000-5164_3254.wav,VTTS_b-4_2000-5164_3254.wav,4758,4586,172
16710,b-1_1616-1716_1632.wav,VTTS_b-1_1616-1716_1632.wav,2780,2705,75
16711,b-3_3454-3537_3501.wav,VTTS_b-3_3454-3537_3501.wav,11720,11610,110
16712,b-4_501-1014_783.wav,VTTS_b-4_501-1014_783.wav,3120,2879,241
16713,b-1_3834-3934_3929.wav,VTTS_b-1_3834-3934_3929.wav,1580,1544,36
16714,b-4_2000-5164_5030.wav,VTTS_b-4_2000-5164_5030.wav,4395,4203,192
16715,b-2_1325-1426_1423.wav,VTTS_b-2_1325-1426_1423.wav,6330,11610,-5280
16716,b-4_1401-1505_1478.wav,VTTS_b-4_1401-1505_1478.wav,2000,1846,154
16717,b-3_6116-6215_6173.wav,VTTS_b-3_6116-6215_6173.wav,2380,2624,-244
16718,b-3_3454-3537_3478.wav,VTTS_b-3_3454-3537_3478.wav,8350,7802,548
16719,b-2_2107-2193_2138.wav,VTTS_b-2_2107-2193_2138.wav,3690,3495,195
16720,b-1_4322-4357_4330.wav,VTTS_b-1_4322-4357_4330.wav,1690,1672,18
16721,b-1_3935-4033_3986.wav,VTTS_b-1_3935-4033_3986.wav,2510,2786,-276
16722,b-3_501-930_923.wav,VTTS_b-3_501-930_923.wav,4530,5097,-567
16723,b-3_5009-5427_5174.wav,VTTS_b-3_5009-5427_5174.wav,10030,8789,1241
16724,b-3_2524-2854_2700.wav,VTTS_b-3_2524-2854_2700.wav,8590,7419,1171
16725,b-3_5009-5427_5113.wav,VTTS_b-3_5009-5427_5113.wav,4160,4923,-763
16726,b-3_1079-1320_1090.wav,VTTS_b-3_1079-1320_1090.wav,4160,4191,-31
16727,b-3_2000-2088_2082.wav,VTTS_b-3_2000-2088_2082.wav,4750,4621,129
16728,b-1_794-1009_997.wav,VTTS_b-1_794-1009_997.wav,3720,3773,-53
16729,b-3_3112-3197_3153.wav,VTTS_b-3_3112-3197_3153.wav,7710,7848,-138
16730,b-1_3127-3227_3196.wav,VTTS_b-1_3127-3227_3196.wav,1390,1324,66
16731,b-3_392-500_397.wav,VTTS_b-3_392-500_397.wav,5790,5851,-61
16732,b-3_2089-2176_2159.wav,VTTS_b-3_2089-2176_2159.wav,3500,3309,191
16733,b-3_1764-1861_1790.wav,VTTS_b-3_1764-1861_1790.wav,1010,1115,-105
16734,b-4_1101-1220_1188.wav,VTTS_b-4_1101-1220_1188.wav,2870,3053,-183
16735,b-4_2000-5164_3322.wav,VTTS_b-4_2000-5164_3322.wav,5287,5248,39
16736,b-2_713-814_757.wav,VTTS_b-2_713-814_757.wav,3550,3274,276
16737,b-4_2000-5164_3624.wav,VTTS_b-4_2000-5164_3624.wav,4826,4772,54
16738,b-1_579-649_607.wav,VTTS_b-1_579-649_607.wav,3030,2752,278
16739,b-3_6016-6115_6099.wav,VTTS_b-3_6016-6115_6099.wav,3870,3657,213
16740,b-3_2267-2349_2315.wav,VTTS_b-3_2267-2349_2315.wav,3830,3680,150
16741,b-3_1862-1959_1938.wav,VTTS_b-3_1862-1959_1938.wav,11430,11343,87
16742,b-4_2000-5164_2196.wav,VTTS_b-4_2000-5164_2196.wav,8940,10960,-2020
16743,b-4_2000-5164_4648.wav,VTTS_b-4_2000-5164_4648.wav,3814,4284,-470
16744,b-2_917-1018_982.wav,VTTS_b-2_917-1018_982.wav,3510,4423,-913
16745,b-3_3279-3363_3315.wav,VTTS_b-3_3279-3363_3315.wav,7100,7059,41
16746,b-4_1707-1813_1735.wav,VTTS_b-4_1707-1813_1735.wav,3350,3262,88
16747,b-3_5009-5427_5394.wav,VTTS_b-3_5009-5427_5394.wav,3310,3390,-80
16748,b-1_3935-4033_4022.wav,VTTS_b-1_3935-4033_4022.wav,5090,7117,-2027
16749,b-1_2826-2926_2894.wav,VTTS_b-1_2826-2926_2894.wav,4680,4528,152
16750,b-1_1717-1817_1771.wav,VTTS_b-1_1717-1817_1771.wav,2870,2821,49
16751,b-1_1515-1615_1568.wav,VTTS_b-1_1515-1615_1568.wav,6160,6200,-40
16752,b-1_650-685_677.wav,VTTS_b-1_650-685_677.wav,1290,1509,-219
16753,b-4_2000-5164_4198.wav,VTTS_b-4_2000-5164_4198.wav,2491,2426,65
16754,b-2_1801-1902_1872.wav,VTTS_b-2_1801-1902_1872.wav,2190,2113,77
16755,b-4_2000-5164_4207.wav,VTTS_b-4_2000-5164_4207.wav,8130,8870,-740
16756,b-4_2000-5164_2929.wav,VTTS_b-4_2000-5164_2929.wav,3234,4795,-1561
16757,b-3_1764-1861_1828.wav,VTTS_b-3_1764-1861_1828.wav,2080,3437,-1357
16758,b-4_2000-5164_3210.wav,VTTS_b-4_2000-5164_3210.wav,2576,2357,219
16759,b-3_2524-2854_2527.wav,VTTS_b-3_2524-2854_2527.wav,3640,3622,18
16760,b-1_794-1009_1002.wav,VTTS_b-1_794-1009_1002.wav,4360,4087,273
16761,b-2_611-712_632.wav,VTTS_b-2_611-712_632.wav,1490,1440,50
16762,b-1_1010-1110_1085.wav,VTTS_b-1_1010-1110_1085.wav,3650,3111,539
16763,b-2_1-100_92.wav,VTTS_b-2_1-100_92.wav,1230,11610,-10380
16764,b-4_2000-5164_3091.wav,VTTS_b-4_2000-5164_3091.wav,11059,10321,738
16765,b-3_6601-6700_6604.wav,VTTS_b-3_6601-6700_6604.wav,6500,7256,-756
16766,b-4_501-1014_737.wav,VTTS_b-4_501-1014_737.wav,2070,1974,96
16767,b-1_4322-4357_4333.wav,VTTS_b-1_4322-4357_4333.wav,1590,1788,-198
16768,b-3_5853-5956_5858.wav,VTTS_b-3_5853-5956_5858.wav,3550,3367,183
16769,b-4_1506-1600_1583.wav,VTTS_b-4_1506-1600_1583.wav,5320,5492,-172
16770,b-2_713-814_804.wav,VTTS_b-2_713-814_804.wav,2950,4389,-1439
16771,b-3_4607-5008_4823.wav,VTTS_b-3_4607-5008_4823.wav,2450,2218,232
16772,b-3_4104-4206_4137.wav,VTTS_b-3_4104-4206_4137.wav,6640,6444,196
16773,b-4_301-400_388.wav,VTTS_b-4_301-400_388.wav,3380,3262,118
16774,b-4_501-1014_791.wav,VTTS_b-4_501-1014_791.wav,6210,11610,-5400
16775,b-2_2040-2072_2069.wav,VTTS_b-2_2040-2072_2069.wav,1520,1660,-140
16776,b-3_1079-1320_1193.wav,VTTS_b-3_1079-1320_1193.wav,7160,7419,-259
16777,b-1_74-174_96.wav,VTTS_b-1_74-174_96.wav,3920,2926,994
16778,b-1_3733-3833_3793.wav,VTTS_b-1_3733-3833_3793.wav,2260,2078,182
16779,b-3_501-930_637.wav,VTTS_b-3_501-930_637.wav,2690,2659,31
16780,b-1_1919-2017_1980.wav,VTTS_b-1_1919-2017_1980.wav,1150,1068,82
16781,b-4_1901-2000_1979.wav,VTTS_b-4_1901-2000_1979.wav,7890,8591,-701
16782,b-3_5009-5427_5268.wav,VTTS_b-3_5009-5427_5268.wav,1260,1289,-29
16783,b-1_4178-4213_4185.wav,VTTS_b-1_4178-4213_4185.wav,2500,3286,-786
16784,b-1_3228-3328_3238.wav,VTTS_b-1_3228-3328_3238.wav,1550,1765,-215
16785,b-3_4425-4497_4489.wav,VTTS_b-3_4425-4497_4489.wav,4500,5387,-887
16786,b-3_2524-2854_2628.wav,VTTS_b-3_2524-2854_2628.wav,8570,8092,478
16787,b-2_1427-1562_1440.wav,VTTS_b-2_1427-1562_1440.wav,2200,2368,-168
16788,b-1_4466-4498_4467.wav,VTTS_b-1_4466-4498_4467.wav,1960,3204,-1244
16789,b-2_1903-2038_1942.wav,VTTS_b-2_1903-2038_1942.wav,4090,4040,50
16790,b-1_1010-1110_1058.wav,VTTS_b-1_1010-1110_1058.wav,4940,4272,668
16791,b-1_4466-4498_4474.wav,VTTS_b-1_4466-4498_4474.wav,2120,2310,-190
16792,b-3_2000-2088_2033.wav,VTTS_b-3_2000-2088_2033.wav,6750,5968,782
16793,b-3_294-391_357.wav,VTTS_b-3_294-391_357.wav,7310,7651,-341
16794,b-1_478-578_528.wav,VTTS_b-1_478-578_528.wav,2560,4412,-1852
16795,b-4_2000-5164_3688.wav,VTTS_b-4_2000-5164_3688.wav,9067,8417,650
16796,b-2_2040-2072_2057.wav,VTTS_b-2_2040-2072_2057.wav,1040,1010,30
16797,b-1_1111-1211_1192.wav,VTTS_b-1_1111-1211_1192.wav,2860,1916,944
16798,b-2_509-610_516.wav,VTTS_b-2_509-610_516.wav,1590,1498,92
16799,b-3_931-979_955.wav,VTTS_b-3_931-979_955.wav,13300,11610,1690
16800,b-3_2855-2942_2897.wav,VTTS_b-3_2855-2942_2897.wav,2260,2786,-526
16801,b-3_2855-2942_2893.wav,VTTS_b-3_2855-2942_2893.wav,2720,2589,131
16802,b-4_2000-5164_2793.wav,VTTS_b-4_2000-5164_2793.wav,4810,4690,120
16803,b-2_917-1018_1005.wav,VTTS_b-2_917-1018_1005.wav,2120,2601,-481
16804,b-3_4001-4103_4103.wav,VTTS_b-3_4001-4103_4103.wav,1510,1463,47
16805,b-2_509-610_533.wav,VTTS_b-2_509-610_533.wav,2480,2902,-422
16806,b-1_686-793_689.wav,VTTS_b-1_686-793_689.wav,1540,1625,-85
16807,b-1_1717-1817_1741.wav,VTTS_b-1_1717-1817_1741.wav,3430,2194,1236
16808,b-3_6401-6500_6412.wav,VTTS_b-3_6401-6500_6412.wav,6540,5909,631
16809,b-3_3889-4000_3939.wav,VTTS_b-3_3889-4000_3939.wav,4190,3855,335
16810,b-4_151-300_244.wav,VTTS_b-4_151-300_244.wav,5080,4830,250
16811,b-4_2000-5164_3768.wav,VTTS_b-4_2000-5164_3768.wav,6580,6769,-189
16812,b-4_2000-5164_4301.wav,VTTS_b-4_2000-5164_4301.wav,6126,6072,54
16813,b-1_1313-1413_1416.wav,VTTS_b-1_1313-1413_1416.wav,2920,2984,-64
16814,b-3_3454-3537_3508.wav,VTTS_b-3_3454-3537_3508.wav,8600,8499,101
16815,b-3_2855-2942_2895.wav,VTTS_b-3_2855-2942_2895.wav,2870,3704,-834
16816,b-2_1121-1222_1121.wav,VTTS_b-2_1121-1222_1121.wav,2940,2624,316
16817,b-2_1019-1120_1059.wav,VTTS_b-2_1019-1120_1059.wav,2560,2508,52
16818,b-3_5009-5427_5114.wav,VTTS_b-3_5009-5427_5114.wav,4760,4447,313
16819,b-4_2000-5164_2622.wav,VTTS_b-4_2000-5164_2622.wav,2500,2647,-147
16820,b-4_2000-5164_3028.wav,VTTS_b-4_2000-5164_3028.wav,6182,8022,-1840
16821,b-4_2000-5164_2559.wav,VTTS_b-4_2000-5164_2559.wav,6205,5631,574
16822,b-2_203-304_207.wav,VTTS_b-2_203-304_207.wav,2010,2206,-196
16823,b-4_2000-5164_3228.wav,VTTS_b-4_2000-5164_3228.wav,4114,3750,364
16824,b-1_1414-1514_1425.wav,VTTS_b-1_1414-1514_1425.wav,4420,4540,-120
16825,b-4_1-52_33.wav,VTTS_b-4_1-52_33.wav,6470,6676,-206
16826,b-1_2826-2926_2843.wav,VTTS_b-1_2826-2926_2843.wav,2070,1869,201
16827,b-3_3454-3537_3492.wav,VTTS_b-3_3454-3537_3492.wav,1960,1846,114
16828,b-2_1325-1426_1353.wav,VTTS_b-2_1325-1426_1353.wav,3110,2949,161
16829,b-4_53-150_119.wav,VTTS_b-4_53-150_119.wav,9490,9323,167
16830,b-2_1903-2038_1996.wav,VTTS_b-2_1903-2038_1996.wav,1500,1776,-276
16831,b-4_2000-5164_2573.wav,VTTS_b-4_2000-5164_2573.wav,2805,2589,216
16832,b-3_5428-5533_5437.wav,VTTS_b-3_5428-5533_5437.wav,7740,6989,751
16833,b-1_175-275_260.wav,VTTS_b-1_175-275_260.wav,4050,3971,79
16834,b-2_1121-1222_1215.wav,VTTS_b-2_1121-1222_1215.wav,5370,4621,749
16835,b-3_1321-1568_1370.wav,VTTS_b-3_1321-1568_1370.wav,5150,4783,367
16836,b-1_2119-2219_2141.wav,VTTS_b-1_2119-2219_2141.wav,3080,4400,-1320
16837,b-1_478-578_485.wav,VTTS_b-1_478-578_485.wav,3290,4470,-1180
16838,b-4_2000-5164_3937.wav,VTTS_b-4_2000-5164_3937.wav,4924,7256,-2332
16839,b-3_5009-5427_5161.wav,VTTS_b-3_5009-5427_5161.wav,2930,2821,109
16840,b-3_980-1077_1038.wav,VTTS_b-3_980-1077_1038.wav,4960,4748,212
16841,b-3_5533-5638_5599.wav,VTTS_b-3_5533-5638_5599.wav,6280,5457,823
16842,b-3_4207-4314_4272.wav,VTTS_b-3_4207-4314_4272.wav,5980,6722,-742
16843,b-3_1321-1568_1562.wav,VTTS_b-3_1321-1568_1562.wav,4060,3889,171
16844,b-4_2000-5164_2333.wav,VTTS_b-4_2000-5164_2333.wav,4300,4458,-158
16845,b-4_1901-2000_1923.wav,VTTS_b-4_1901-2000_1923.wav,8340,11610,-3270
16846,b-3_980-1077_987.wav,VTTS_b-3_980-1077_987.wav,3150,2717,433
16847,b-3_2177-2266_2206.wav,VTTS_b-3_2177-2266_2206.wav,6260,6583,-323
16848,b-2_1121-1222_1161.wav,VTTS_b-2_1121-1222_1161.wav,8020,10275,-2255
16849,b-1_1313-1413_1326.wav,VTTS_b-1_1313-1413_1326.wav,2010,2183,-173
16850,b-1_3329-3429_3399.wav,VTTS_b-1_3329-3429_3399.wav,1710,1660,50
16851,b-3_3279-3363_3328.wav,VTTS_b-3_3279-3363_3328.wav,2390,2380,10
16852,b-3_2855-2942_2876.wav,VTTS_b-3_2855-2942_2876.wav,5910,6327,-417
16853,b-1_3329-3429_3343.wav,VTTS_b-1_3329-3429_3343.wav,2950,3564,-614
16854,b-2_1563-1596_1595.wav,VTTS_b-2_1563-1596_1595.wav,5900,5747,153
16855,b-4_2000-5164_4278.wav,VTTS_b-4_2000-5164_4278.wav,6693,6943,-250
16856,b-4_2000-5164_4436.wav,VTTS_b-4_2000-5164_4436.wav,1134,1010,124
16857,b-4_2000-5164_3392.wav,VTTS_b-4_2000-5164_3392.wav,1004,952,52
16858,b-2_1903-2038_1951.wav,VTTS_b-2_1903-2038_1951.wav,3130,3019,111
16859,b-4_401-500_455.wav,VTTS_b-4_401-500_455.wav,5600,5004,596
16860,b-2_407-508_474.wav,VTTS_b-2_407-508_474.wav,3530,4725,-1195
16861,b-4_1301-1400_1392.wav,VTTS_b-4_1301-1400_1392.wav,4820,4899,-79
16862,b-3_3454-3537_3472.wav,VTTS_b-3_3454-3537_3472.wav,2900,2763,137
16863,b-1_276-376_358.wav,VTTS_b-1_276-376_358.wav,2090,2148,-58
16864,b-3_5009-5427_5219.wav,VTTS_b-3_5009-5427_5219.wav,3910,3646,264
16865,b-4_401-500_429.wav,VTTS_b-4_401-500_429.wav,4260,5166,-906
16866,b-4_53-150_61.wav,VTTS_b-4_53-150_61.wav,10120,10403,-283
16867,b-1_4142-4177_4174.wav,VTTS_b-1_4142-4177_4174.wav,1100,1138,-38
16868,b-3_5745-5852_5850.wav,VTTS_b-3_5745-5852_5850.wav,6820,6943,-123
16869,b-3_1321-1568_1508.wav,VTTS_b-3_1321-1568_1508.wav,7840,7674,166
16870,b-4_501-1014_627.wav,VTTS_b-4_501-1014_627.wav,880,952,-72
16871,b-1_794-1009_833.wav,VTTS_b-1_794-1009_833.wav,2260,1892,368
16872,b-1_1919-2017_1929.wav,VTTS_b-1_1919-2017_1929.wav,1850,1800,50
16873,b-3_6116-6215_6144.wav,VTTS_b-3_6116-6215_6144.wav,2390,2844,-454
16874,b-1_1818-1918_1821.wav,VTTS_b-1_1818-1918_1821.wav,2880,2577,303
16875,b-3_4498-4605_4547.wav,VTTS_b-3_4498-4605_4547.wav,2520,2670,-150
16876,b-3_4001-4103_4009.wav,VTTS_b-3_4001-4103_4009.wav,6870,6490,380
16877,b-2_1-100_48.wav,VTTS_b-2_1-100_48.wav,3110,3425,-315
16878,b-1_1717-1817_1790.wav,VTTS_b-1_1717-1817_1790.wav,11420,9160,2260
16879,b-1_794-1009_941.wav,VTTS_b-1_794-1009_941.wav,3070,2879,191
16880,b-1_2119-2219_2196.wav,VTTS_b-1_2119-2219_2196.wav,2120,2426,-306
16881,b-4_2000-5164_3737.wav,VTTS_b-4_2000-5164_3737.wav,5200,4853,347
16882,b-2_713-814_734.wav,VTTS_b-2_713-814_734.wav,1650,1602,48
16883,b-1_3834-3934_3885.wav,VTTS_b-1_3834-3934_3885.wav,2700,2833,-133
16884,b-3_6274-6300_6275.wav,VTTS_b-3_6274-6300_6275.wav,5030,5120,-90
16885,b-4_2000-5164_2727.wav,VTTS_b-4_2000-5164_2727.wav,8335,7790,545
16886,b-1_579-649_642.wav,VTTS_b-1_579-649_642.wav,2490,2241,249
16887,b-3_4315-4424_4367.wav,VTTS_b-3_4315-4424_4367.wav,5070,4598,472
16888,b-3_2524-2854_2554.wav,VTTS_b-3_2524-2854_2554.wav,4740,5004,-264
16889,b-2_203-304_213.wav,VTTS_b-2_203-304_213.wav,1730,1974,-244
16890,b-4_2000-5164_3139.wav,VTTS_b-4_2000-5164_3139.wav,6449,8742,-2293
16891,b-4_2000-5164_3927.wav,VTTS_b-4_2000-5164_3927.wav,3456,3379,77
16892,b-2_509-610_603.wav,VTTS_b-2_509-610_603.wav,4970,4621,349
16893,b-3_6301-6400_6305.wav,VTTS_b-3_6301-6400_6305.wav,3960,3448,512
16894,b-3_501-930_569.wav,VTTS_b-3_501-930_569.wav,6340,5921,419
16895,b-2_815-916_865.wav,VTTS_b-2_815-916_865.wav,1220,975,245
16896,b-1_1313-1413_1388.wav,VTTS_b-1_1313-1413_1388.wav,3030,3019,11
16897,b-3_5853-5956_5857.wav,VTTS_b-3_5853-5956_5857.wav,4780,5294,-514
16898,b-4_2000-5164_3585.wav,VTTS_b-4_2000-5164_3585.wav,4657,4551,106
16899,b-1_1919-2017_1976.wav,VTTS_b-1_1919-2017_1976.wav,4590,5387,-797
16900,b-1_2422-2522_2436.wav,VTTS_b-1_2422-2522_2436.wav,3730,3936,-206
16901,b-3_6301-6400_6366.wav,VTTS_b-3_6301-6400_6366.wav,2400,2032,368
16902,b-2_917-1018_933.wav,VTTS_b-2_917-1018_933.wav,1680,1776,-96
16903,b-3_4607-5008_4949.wav,VTTS_b-3_4607-5008_4949.wav,4660,4516,144
16904,b-3_5639-5744_5647.wav,VTTS_b-3_5639-5744_5647.wav,4110,4052,58
16905,b-2_917-1018_934.wav,VTTS_b-2_917-1018_934.wav,3490,3646,-156
16906,b-4_501-1014_619.wav,VTTS_b-4_501-1014_619.wav,2590,2403,187
16907,b-3_4425-4497_4439.wav,VTTS_b-3_4425-4497_4439.wav,3010,2798,212
16908,b-1_686-793_767.wav,VTTS_b-1_686-793_767.wav,5840,5584,256
16909,b-2_1223-1324_1322.wav,VTTS_b-2_1223-1324_1322.wav,5100,5631,-531
16910,b-4_2000-5164_3135.wav,VTTS_b-4_2000-5164_3135.wav,3230,2798,432
16911,b-4_301-400_397.wav,VTTS_b-4_301-400_397.wav,8960,11610,-2650
16912,b-3_5428-5533_5450.wav,VTTS_b-3_5428-5533_5450.wav,6990,7245,-255
16913,b-2_305-406_328.wav,VTTS_b-2_305-406_328.wav,4590,5108,-518
16914,b-1_2220-2320_2296.wav,VTTS_b-1_2220-2320_2296.wav,3450,4365,-915
16915,b-4_501-1014_509.wav,VTTS_b-4_501-1014_509.wav,5270,5120,150
16916,b-4_2000-5164_2707.wav,VTTS_b-4_2000-5164_2707.wav,10410,11610,-1200
16917,b-1_3632-3732_3697.wav,VTTS_b-1_3632-3732_3697.wav,2700,4180,-1480
16918,b-2_1801-1902_1812.wav,VTTS_b-2_1801-1902_1812.wav,2760,2496,264
16919,b-1_1616-1716_1691.wav,VTTS_b-1_1616-1716_1691.wav,1890,1358,532
16920,b-1_4214-4285_4253.wav,VTTS_b-1_4214-4285_4253.wav,3790,11610,-7820
16921,b-1_2220-2320_2277.wav,VTTS_b-1_2220-2320_2277.wav,2070,1834,236
16922,b-3_1862-1959_1884.wav,VTTS_b-3_1862-1959_1884.wav,2650,2577,73
16923,b-3_2267-2349_2339.wav,VTTS_b-3_2267-2349_2339.wav,5080,4946,134
16924,b-4_2000-5164_2848.wav,VTTS_b-4_2000-5164_2848.wav,8835,8998,-163
16925,b-2_2073-2106_2096.wav,VTTS_b-2_2073-2106_2096.wav,1000,882,118
16926,b-4_1014-1100_1054.wav,VTTS_b-4_1014-1100_1054.wav,3380,2972,408
16927,b-2_1699-1800_1721.wav,VTTS_b-2_1699-1800_1721.wav,2770,2345,425
16928,b-4_2000-5164_3339.wav,VTTS_b-4_2000-5164_3339.wav,4623,3971,652
16929,b-3_4607-5008_4744.wav,VTTS_b-3_4607-5008_4744.wav,5410,5213,197
16930,b-3_6116-6215_6132.wav,VTTS_b-3_6116-6215_6132.wav,2570,2821,-251
16931,b-1_4322-4357_4325.wav,VTTS_b-1_4322-4357_4325.wav,4050,3913,137
16932,b-4_2000-5164_2170.wav,VTTS_b-4_2000-5164_2170.wav,4055,4063,-8
16933,b-4_2000-5164_3277.wav,VTTS_b-4_2000-5164_3277.wav,3900,3506,394
16934,b-4_2000-5164_2215.wav,VTTS_b-4_2000-5164_2215.wav,5130,4923,207
16935,b-4_501-1014_630.wav,VTTS_b-4_501-1014_630.wav,2620,3820,-1200
16936,b-1_1414-1514_1414.wav,VTTS_b-1_1414-1514_1414.wav,4640,5550,-910
16937,b-1_2725-2825_2802.wav,VTTS_b-1_2725-2825_2802.wav,3090,2914,176
16938,b-1_4214-4285_4215.wav,VTTS_b-1_4214-4285_4215.wav,1450,1533,-83
16939,b-3_4607-5008_4715.wav,VTTS_b-3_4607-5008_4715.wav,4120,4122,-2
16940,b-1_1717-1817_1797.wav,VTTS_b-1_1717-1817_1797.wav,2910,2682,228
16941,b-4_2000-5164_4657.wav,VTTS_b-4_2000-5164_4657.wav,2512,2763,-251
16942,b-3_6016-6115_6025.wav,VTTS_b-3_6016-6115_6025.wav,4790,4052,738
16943,b-4_1814-1900_1836.wav,VTTS_b-4_1814-1900_1836.wav,3780,3553,227
16944,b-3_3628-3714_3658.wav,VTTS_b-3_3628-3714_3658.wav,9670,9648,22
16945,b-1_2220-2320_2248.wav,VTTS_b-1_2220-2320_2248.wav,1560,1428,132
16946,b-3_3025-3111_3068.wav,VTTS_b-3_3025-3111_3068.wav,4120,4180,-60
16947,b-4_2000-5164_2715.wav,VTTS_b-4_2000-5164_2715.wav,2815,2717,98
16948,b-4_2000-5164_3591.wav,VTTS_b-4_2000-5164_3591.wav,5335,6153,-818
16949,b-4_2000-5164_2117.wav,VTTS_b-4_2000-5164_2117.wav,3440,3495,-55
16950,b-4_53-150_67.wav,VTTS_b-4_53-150_67.wav,9790,9195,595
16951,b-3_6501-6600_6523.wav,VTTS_b-3_6501-6600_6523.wav,4810,4423,387
16952,b-4_2000-5164_2134.wav,VTTS_b-4_2000-5164_2134.wav,3850,4272,-422
16953,b-3_6701-6800_6775.wav,VTTS_b-3_6701-6800_6775.wav,5480,6629,-1149
16954,b-1_794-1009_894.wav,VTTS_b-1_794-1009_894.wav,3680,5944,-2264
16955,b-4_2000-5164_3705.wav,VTTS_b-4_2000-5164_3705.wav,3310,3111,199
16956,b-1_3531-3631_3606.wav,VTTS_b-1_3531-3631_3606.wav,1480,1498,-18
16957,b-1_2927-3025_2992.wav,VTTS_b-1_2927-3025_2992.wav,1040,1103,-63
16958,b-3_2350-2433_2387.wav,VTTS_b-3_2350-2433_2387.wav,4000,3030,970
16959,b-1_2826-2926_2871.wav,VTTS_b-1_2826-2926_2871.wav,2090,1567,523
16960,b-3_3279-3363_3282.wav,VTTS_b-3_3279-3363_3282.wav,5770,6629,-859
16961,b-4_2000-5164_2992.wav,VTTS_b-4_2000-5164_2992.wav,5106,5050,56
16962,b-1_3228-3328_3245.wav,VTTS_b-1_3228-3328_3245.wav,1990,2009,-19
16963,b-4_2000-5164_4287.wav,VTTS_b-4_2000-5164_4287.wav,5479,6327,-848
16964,b-1_3733-3833_3768.wav,VTTS_b-1_3733-3833_3768.wav,1400,1521,-121
16965,b-3_6701-6800_6722.wav,VTTS_b-3_6701-6800_6722.wav,5610,5445,165
16966,b-4_2000-5164_4996.wav,VTTS_b-4_2000-5164_4996.wav,5398,5178,220
16967,b-3_2000-2088_2056.wav,VTTS_b-3_2000-2088_2056.wav,3340,4145,-805
16968,b-3_3364-3453_3436.wav,VTTS_b-3_3364-3453_3436.wav,4410,4957,-547
16969,b-3_501-930_517.wav,VTTS_b-3_501-930_517.wav,4720,4609,111
16970,b-1_3127-3227_3191.wav,VTTS_b-1_3127-3227_3191.wav,890,859,31
16971,b-3_6601-6700_6653.wav,VTTS_b-3_6601-6700_6653.wav,4790,4261,529
16972,b-3_6801-6900_6886.wav,VTTS_b-3_6801-6900_6886.wav,1470,1486,-16
16973,b-1_1616-1716_1694.wav,VTTS_b-1_1616-1716_1694.wav,2600,2368,232
16974,b-3_2943-3024_3022.wav,VTTS_b-3_2943-3024_3022.wav,2510,2345,165
16975,b-1_2927-3025_2950.wav,VTTS_b-1_2927-3025_2950.wav,1710,1637,73
16976,b-1_1717-1817_1814.wav,VTTS_b-1_1717-1817_1814.wav,1890,1567,323
16977,b-4_2000-5164_2043.wav,VTTS_b-4_2000-5164_2043.wav,2720,2763,-43
16978,b-2_2311-2412_2323.wav,VTTS_b-2_2311-2412_2323.wav,930,778,152
16979,b-1_175-275_215.wav,VTTS_b-1_175-275_215.wav,1120,1103,17
16980,b-4_2000-5164_3036.wav,VTTS_b-4_2000-5164_3036.wav,3350,3309,41
16981,b-1_1818-1918_1877.wav,VTTS_b-1_1818-1918_1877.wav,1650,1416,234
16982,b-3_2177-2266_2225.wav,VTTS_b-3_2177-2266_2225.wav,6450,6385,65
16983,b-3_3803-3888_3822.wav,VTTS_b-3_3803-3888_3822.wav,11400,11610,-210
16984,b-3_501-930_807.wav,VTTS_b-3_501-930_807.wav,3890,3913,-23
16985,b-4_2000-5164_4209.wav,VTTS_b-4_2000-5164_4209.wav,5424,5677,-253
16986,b-4_2000-5164_2371.wav,VTTS_b-4_2000-5164_2371.wav,2510,2519,-9
16987,b-3_3025-3111_3053.wav,VTTS_b-3_3025-3111_3053.wav,790,859,-69
16988,b-2_2107-2193_2111.wav,VTTS_b-2_2107-2193_2111.wav,1730,2206,-476
16989,b-1_1212-1312_1250.wav,VTTS_b-1_1212-1312_1250.wav,3270,2508,762
16990,b-3_4498-4605_4564.wav,VTTS_b-3_4498-4605_4564.wav,7330,7860,-530
16991,b-1_2422-2522_2461.wav,VTTS_b-1_2422-2522_2461.wav,4240,4180,60
16992,b-4_1101-1220_1138.wav,VTTS_b-4_1101-1220_1138.wav,6740,9404,-2664
16993,b-4_2000-5164_4500.wav,VTTS_b-4_2000-5164_4500.wav,5197,5271,-74
16994,b-3_1862-1959_1941.wav,VTTS_b-3_1862-1959_1941.wav,3940,3866,74
16995,b-2_1-100_47.wav,VTTS_b-2_1-100_47.wav,1480,1834,-354
16996,b-4_2000-5164_4649.wav,VTTS_b-4_2000-5164_4649.wav,3492,3367,125
16997,b-3_6601-6700_6626.wav,VTTS_b-3_6601-6700_6626.wav,3850,3228,622
16998,b-3_1666-1763_1675.wav,VTTS_b-3_1666-1763_1675.wav,5380,5573,-193
16999,b-2_101-202_182.wav,VTTS_b-2_101-202_182.wav,1290,1207,83
17000,b-3_5009-5427_5042.wav,VTTS_b-3_5009-5427_5042.wav,8370,8115,255
17001,b-4_2000-5164_3821.wav,VTTS_b-4_2000-5164_3821.wav,2188,2461,-273
17002,b-3_6016-6115_6039.wav,VTTS_b-3_6016-6115_6039.wav,5020,4830,190
17003,b-3_3715-3802_3759.wav,VTTS_b-3_3715-3802_3759.wav,4150,4214,-64
17004,b-3_1079-1320_1296.wav,VTTS_b-3_1079-1320_1296.wav,7650,7210,440
17005,b-3_1079-1320_1306.wav,VTTS_b-3_1079-1320_1306.wav,2710,3878,-1168
17006,b-4_2000-5164_2870.wav,VTTS_b-4_2000-5164_2870.wav,3690,4447,-757
17007,b-3_4425-4497_4453.wav,VTTS_b-3_4425-4497_4453.wav,7390,7767,-377
17008,b-4_2000-5164_2544.wav,VTTS_b-4_2000-5164_2544.wav,7700,7663,37
17009,b-3_5009-5427_5055.wav,VTTS_b-3_5009-5427_5055.wav,4760,4830,-70
17010,b-1_2018-2118_2024.wav,VTTS_b-1_2018-2118_2024.wav,2920,3437,-517
17011,b-1_1717-1817_1810.wav,VTTS_b-1_1717-1817_1810.wav,2230,2345,-115
17012,b-4_2000-5164_3009.wav,VTTS_b-4_2000-5164_3009.wav,3867,3947,-80
17013,b-4_2000-5164_4578.wav,VTTS_b-4_2000-5164_4578.wav,6022,7628,-1606
17014,b-3_2524-2854_2631.wav,VTTS_b-3_2524-2854_2631.wav,5340,5584,-244
17015,b-3_294-391_355.wav,VTTS_b-3_294-391_355.wav,8210,8626,-416
17016,b-2_917-1018_986.wav,VTTS_b-2_917-1018_986.wav,5280,6722,-1442
17017,b-2_1903-2038_1925.wav,VTTS_b-2_1903-2038_1925.wav,1330,1091,239
17018,b-3_3364-3453_3386.wav,VTTS_b-3_3364-3453_3386.wav,7060,6293,767
17019,b-3_2089-2176_2148.wav,VTTS_b-3_2089-2176_2148.wav,3890,4261,-371
17020,b-2_101-202_195.wav,VTTS_b-2_101-202_195.wav,1490,1405,85
17021,b-3_6301-6400_6387.wav,VTTS_b-3_6301-6400_6387.wav,4860,4946,-86
17022,b-4_501-1014_949.wav,VTTS_b-4_501-1014_949.wav,5080,4772,308
17023,b-4_1101-1220_1198.wav,VTTS_b-4_1101-1220_1198.wav,1630,1207,423
17024,b-4_2000-5164_4249.wav,VTTS_b-4_2000-5164_4249.wav,6025,7430,-1405
17025,b-4_2000-5164_4547.wav,VTTS_b-4_2000-5164_4547.wav,4905,7454,-2549
17026,b-4_501-1014_615.wav,VTTS_b-4_501-1014_615.wav,1450,1486,-36
17027,b-2_713-814_722.wav,VTTS_b-2_713-814_722.wav,850,894,-44
17028,b-3_3715-3802_3769.wav,VTTS_b-3_3715-3802_3769.wav,6150,5979,171
17029,b-4_2000-5164_3077.wav,VTTS_b-4_2000-5164_3077.wav,5232,5097,135
17030,b-3_3364-3453_3381.wav,VTTS_b-3_3364-3453_3381.wav,5290,6107,-817
17031,b-1_3632-3732_3727.wav,VTTS_b-1_3632-3732_3727.wav,1650,1753,-103
17032,b-3_4315-4424_4390.wav,VTTS_b-3_4315-4424_4390.wav,5950,5724,226
17033,b-4_1014-1100_1045.wav,VTTS_b-4_1014-1100_1045.wav,2590,2508,82
17034,b-4_2000-5164_4463.wav,VTTS_b-4_2000-5164_4463.wav,3198,3750,-552
17035,b-4_2000-5164_2355.wav,VTTS_b-4_2000-5164_2355.wav,1880,1858,22
17036,b-1_2826-2926_2852.wav,VTTS_b-1_2826-2926_2852.wav,5370,6107,-737
17037,b-3_501-930_823.wav,VTTS_b-3_501-930_823.wav,8890,11610,-2720
17038,b-3_6501-6600_6508.wav,VTTS_b-3_6501-6600_6508.wav,3070,3274,-204
17039,b-3_6501-6600_6533.wav,VTTS_b-3_6501-6600_6533.wav,1980,1950,30
17040,b-4_2000-5164_2605.wav,VTTS_b-4_2000-5164_2605.wav,3910,4226,-316
17041,b-3_6601-6700_6621.wav,VTTS_b-3_6601-6700_6621.wav,2490,2183,307
17042,b-4_1401-1505_1444.wav,VTTS_b-4_1401-1505_1444.wav,1680,1463,217
17043,b-3_2267-2349_2345.wav,VTTS_b-3_2267-2349_2345.wav,5730,11610,-5880
17044,b-1_1313-1413_1399.wav,VTTS_b-1_1313-1413_1399.wav,3010,2705,305
17045,b-4_2000-5164_2357.wav,VTTS_b-4_2000-5164_2357.wav,1320,1080,240
17046,b-4_2000-5164_4314.wav,VTTS_b-4_2000-5164_4314.wav,2264,2113,151
17047,b-1_3531-3631_3589.wav,VTTS_b-1_3531-3631_3589.wav,1980,3030,-1050
17048,b-2_1903-2038_1998.wav,VTTS_b-2_1903-2038_1998.wav,5620,4830,790
17049,b-4_2000-5164_4931.wav,VTTS_b-4_2000-5164_4931.wav,6901,6920,-19
17050,b-3_4425-4497_4449.wav,VTTS_b-3_4425-4497_4449.wav,8220,11610,-3390
17051,b-3_6401-6500_6477.wav,VTTS_b-3_6401-6500_6477.wav,8550,7628,922
17052,b-3_6274-6300_6274.wav,VTTS_b-3_6274-6300_6274.wav,11160,11610,-450
17053,b-1_1717-1817_1804.wav,VTTS_b-1_1717-1817_1804.wav,1310,1196,114
17054,b-4_2000-5164_4184.wav,VTTS_b-4_2000-5164_4184.wav,4576,4377,199
17055,b-4_2000-5164_4156.wav,VTTS_b-4_2000-5164_4156.wav,4808,5259,-451
17056,b-1_4178-4213_4193.wav,VTTS_b-1_4178-4213_4193.wav,4630,6385,-1755
17057,b-2_1019-1120_1031.wav,VTTS_b-2_1019-1120_1031.wav,1250,1927,-677
17058,b-4_1101-1220_1156.wav,VTTS_b-4_1101-1220_1156.wav,1590,1324,266
17059,b-1_1313-1413_1381.wav,VTTS_b-1_1313-1413_1381.wav,4240,4470,-230
17060,b-4_2000-5164_2075.wav,VTTS_b-4_2000-5164_2075.wav,1640,1393,247
17061,b-3_1321-1568_1445.wav,VTTS_b-3_1321-1568_1445.wav,9410,8464,946
17062,b-3_501-930_543.wav,VTTS_b-3_501-930_543.wav,5120,4540,580
17063,b-3_3112-3197_3181.wav,VTTS_b-3_3112-3197_3181.wav,4580,3785,795
17064,b-3_5957-6015_6009.wav,VTTS_b-3_5957-6015_6009.wav,3530,3297,233
17065,b-4_401-500_479.wav,VTTS_b-4_401-500_479.wav,5740,5283,457
17066,b-4_2000-5164_4712.wav,VTTS_b-4_2000-5164_4712.wav,3128,3274,-146
17067,b-4_2000-5164_4107.wav,VTTS_b-4_2000-5164_4107.wav,4108,3773,335
17068,b-1_276-376_284.wav,VTTS_b-1_276-376_284.wav,1850,1683,167
17069,b-4_2000-5164_3080.wav,VTTS_b-4_2000-5164_3080.wav,2802,2531,271
17070,b-3_6016-6115_6074.wav,VTTS_b-3_6016-6115_6074.wav,4800,5457,-657
17071,b-4_2000-5164_4046.wav,VTTS_b-4_2000-5164_4046.wav,3814,3889,-75
17072,b-1_3935-4033_3956.wav,VTTS_b-1_3935-4033_3956.wav,3180,3181,-1
17073,b-1_2018-2118_2117.wav,VTTS_b-1_2018-2118_2117.wav,2920,2218,702
17074,b-4_2000-5164_2440.wav,VTTS_b-4_2000-5164_2440.wav,4030,4540,-510
17075,b-1_1919-2017_1996.wav,VTTS_b-1_1919-2017_1996.wav,2000,2264,-264
17076,b-3_4607-5008_4861.wav,VTTS_b-3_4607-5008_4861.wav,4400,5433,-1033
17077,b-2_305-406_339.wav,VTTS_b-2_305-406_339.wav,1280,1254,26
17078,b-4_2000-5164_3229.wav,VTTS_b-4_2000-5164_3229.wav,2957,2798,159
17079,b-2_713-814_784.wav,VTTS_b-2_713-814_784.wav,6400,6362,38
17080,b-4_2000-5164_2388.wav,VTTS_b-4_2000-5164_2388.wav,5320,5596,-276
17081,b-3_5009-5427_5069.wav,VTTS_b-3_5009-5427_5069.wav,3290,2798,492
17082,b-2_1427-1562_1531.wav,VTTS_b-2_1427-1562_1531.wav,2330,1892,438
17083,b-1_1010-1110_1089.wav,VTTS_b-1_1010-1110_1089.wav,4250,3901,349
17084,b-4_2000-5164_4795.wav,VTTS_b-4_2000-5164_4795.wav,2404,3228,-824
17085,b-4_2000-5164_2873.wav,VTTS_b-4_2000-5164_2873.wav,8750,8139,611
17086,b-2_815-916_870.wav,VTTS_b-2_815-916_870.wav,1170,1010,160
17087,b-3_1321-1568_1401.wav,VTTS_b-3_1321-1568_1401.wav,11250,11180,70
17088,b-1_1515-1615_1534.wav,VTTS_b-1_1515-1615_1534.wav,3570,3204,366
17089,b-1_1313-1413_1350.wav,VTTS_b-1_1313-1413_1350.wav,1110,1103,7
17090,b-3_2855-2942_2938.wav,VTTS_b-3_2855-2942_2938.wav,4110,3924,186
17091,b-4_501-1014_617.wav,VTTS_b-4_501-1014_617.wav,1740,1660,80
17092,b-4_151-300_259.wav,VTTS_b-4_151-300_259.wav,4330,4249,81
17093,b-4_2000-5164_2358.wav,VTTS_b-4_2000-5164_2358.wav,3680,3738,-58
17094,b-1_3632-3732_3686.wav,VTTS_b-1_3632-3732_3686.wav,2410,3100,-690
17095,b-3_2524-2854_2819.wav,VTTS_b-3_2524-2854_2819.wav,5590,5271,319
17096,b-1_4430-4465_4450.wav,VTTS_b-1_4430-4465_4450.wav,1810,1718,92
17097,b-1_3127-3227_3188.wav,VTTS_b-1_3127-3227_3188.wav,3240,3146,94
17098,b-3_1079-1320_1206.wav,VTTS_b-3_1079-1320_1206.wav,7330,7407,-77
17099,b-4_1506-1600_1548.wav,VTTS_b-4_1506-1600_1548.wav,4430,4191,239
17100,b-4_301-400_319.wav,VTTS_b-4_301-400_319.wav,6720,7755,-1035
17101,b-2_305-406_351.wav,VTTS_b-2_305-406_351.wav,1890,1858,32
17102,b-1_1-73_1.wav,VTTS_b-1_1-73_1.wav,1020,1126,-106
17103,b-2_815-916_894.wav,VTTS_b-2_815-916_894.wav,1550,1823,-273
17104,b-3_1321-1568_1557.wav,VTTS_b-3_1321-1568_1557.wav,5840,5201,639
17105,b-3_6501-6600_6584.wav,VTTS_b-3_6501-6600_6584.wav,4120,3367,753
17106,b-3_6016-6115_6077.wav,VTTS_b-3_6016-6115_6077.wav,5000,4551,449
17107,b-3_4104-4206_4149.wav,VTTS_b-3_4104-4206_4149.wav,6590,6316,274
17108,b-3_5533-5638_5571.wav,VTTS_b-3_5533-5638_5571.wav,5280,5132,148
17109,b-4_2000-5164_4849.wav,VTTS_b-4_2000-5164_4849.wav,3626,3390,236
17110,b-4_2000-5164_5050.wav,VTTS_b-4_2000-5164_5050.wav,3846,3680,166
17111,b-1_3026-3126_3116.wav,VTTS_b-1_3026-3126_3116.wav,2620,2624,-4
17112,b-4_2000-5164_4400.wav,VTTS_b-4_2000-5164_4400.wav,4989,4725,264
17113,b-2_713-814_779.wav,VTTS_b-2_713-814_779.wav,5190,3402,1788
17114,b-1_1111-1211_1115.wav,VTTS_b-1_1111-1211_1115.wav,1620,1463,157
17115,b-4_151-300_252.wav,VTTS_b-4_151-300_252.wav,7970,8104,-134
17116,b-2_1597-1698_1658.wav,VTTS_b-2_1597-1698_1658.wav,1570,1591,-21
17117,b-2_509-610_535.wav,VTTS_b-2_509-610_535.wav,1350,1289,61
17118,b-1_1313-1413_1345.wav,VTTS_b-1_1313-1413_1345.wav,1220,1173,47
17119,b-3_4104-4206_4134.wav,VTTS_b-3_4104-4206_4134.wav,7430,7639,-209
17120,b-4_1301-1400_1309.wav,VTTS_b-4_1301-1400_1309.wav,8150,7628,522
17121,b-1_2220-2320_2274.wav,VTTS_b-1_2220-2320_2274.wav,2690,2682,8
17122,b-1_1919-2017_2004.wav,VTTS_b-1_1919-2017_2004.wav,2070,2101,-31
17123,b-1_1-73_49.wav,VTTS_b-1_1-73_49.wav,1340,1405,-65
17124,b-4_2000-5164_3610.wav,VTTS_b-4_2000-5164_3610.wav,3148,2995,153
17125,b-3_4315-4424_4332.wav,VTTS_b-3_4315-4424_4332.wav,3370,3796,-426
17126,b-4_2000-5164_2529.wav,VTTS_b-4_2000-5164_2529.wav,6200,8301,-2101
17127,b-3_2524-2854_2653.wav,VTTS_b-3_2524-2854_2653.wav,1370,1370,0
17128,b-1_2422-2522_2518.wav,VTTS_b-1_2422-2522_2518.wav,3590,2670,920
17129,b-1_175-275_211.wav,VTTS_b-1_175-275_211.wav,1280,1556,-276
17130,b-4_2000-5164_3576.wav,VTTS_b-4_2000-5164_3576.wav,3961,3680,281
17131,b-3_2177-2266_2259.wav,VTTS_b-3_2177-2266_2259.wav,5720,7465,-1745
17132,b-1_579-649_619.wav,VTTS_b-1_579-649_619.wav,3190,2868,322
17133,b-4_501-1014_640.wav,VTTS_b-4_501-1014_640.wav,6480,7175,-695
17134,b-4_1401-1505_1500.wav,VTTS_b-4_1401-1505_1500.wav,2220,2090,130
17135,b-3_5745-5852_5801.wav,VTTS_b-3_5745-5852_5801.wav,5270,5457,-187
17136,b-3_1079-1320_1108.wav,VTTS_b-3_1079-1320_1108.wav,1910,1834,76
17137,b-3_2089-2176_2165.wav,VTTS_b-3_2089-2176_2165.wav,3400,3111,289
17138,b-1_3127-3227_3194.wav,VTTS_b-1_3127-3227_3194.wav,4330,4957,-627
17139,b-2_2107-2193_2122.wav,VTTS_b-2_2107-2193_2122.wav,2220,2717,-497
17140,b-4_1401-1505_1479.wav,VTTS_b-4_1401-1505_1479.wav,4990,4702,288
17141,b-2_1563-1596_1568.wav,VTTS_b-2_1563-1596_1568.wav,1270,2101,-831
17142,b-3_931-979_947.wav,VTTS_b-3_931-979_947.wav,4550,4191,359
17143,b-2_1019-1120_1079.wav,VTTS_b-2_1019-1120_1079.wav,2200,4923,-2723
17144,b-3_1764-1861_1793.wav,VTTS_b-3_1764-1861_1793.wav,6070,7117,-1047
17145,b-3_5957-6015_5998.wav,VTTS_b-3_5957-6015_5998.wav,4890,4377,513
17146,b-1_686-793_758.wav,VTTS_b-1_686-793_758.wav,4500,4899,-399
17147,b-1_1616-1716_1627.wav,VTTS_b-1_1616-1716_1627.wav,1390,1173,217
17148,b-3_1321-1568_1554.wav,VTTS_b-3_1321-1568_1554.wav,4860,4238,622
17149,b-1_1414-1514_1443.wav,VTTS_b-1_1414-1514_1443.wav,1700,1869,-169
17150,b-3_2855-2942_2913.wav,VTTS_b-3_2855-2942_2913.wav,4360,4609,-249
17151,b-3_1079-1320_1172.wav,VTTS_b-3_1079-1320_1172.wav,5420,5027,393
17152,b-3_5853-5956_5937.wav,VTTS_b-3_5853-5956_5937.wav,4240,3936,304
17153,b-3_1321-1568_1357.wav,VTTS_b-3_1321-1568_1357.wav,7670,8092,-422
17154,b-1_1010-1110_1055.wav,VTTS_b-1_1010-1110_1055.wav,1950,1881,69
17155,b-4_1014-1100_1021.wav,VTTS_b-4_1014-1100_1021.wav,7690,8022,-332
17156,b-4_2000-5164_5160.wav,VTTS_b-4_2000-5164_5160.wav,4914,4841,73
17157,b-1_2422-2522_2453.wav,VTTS_b-1_2422-2522_2453.wav,2800,2705,95
17158,b-3_1321-1568_1503.wav,VTTS_b-3_1321-1568_1503.wav,6580,5608,972
17159,b-3_6217-6274_6263.wav,VTTS_b-3_6217-6274_6263.wav,8050,8231,-181
17160,b-2_1-100_74.wav,VTTS_b-2_1-100_74.wav,1350,1324,26
17161,b-3_2000-2088_2074.wav,VTTS_b-3_2000-2088_2074.wav,6350,5956,394
17162,b-4_1814-1900_1827.wav,VTTS_b-4_1814-1900_1827.wav,6190,5828,362
17163,b-3_5957-6015_5982.wav,VTTS_b-3_5957-6015_5982.wav,3920,3506,414
17164,b-2_1-100_11.wav,VTTS_b-2_1-100_11.wav,1450,1556,-106
17165,b-2_917-1018_1007.wav,VTTS_b-2_917-1018_1007.wav,3160,2635,525
17166,b-4_2000-5164_4532.wav,VTTS_b-4_2000-5164_4532.wav,7856,8348,-492
17167,b-3_3279-3363_3339.wav,VTTS_b-3_3279-3363_3339.wav,4490,4505,-15
17168,b-4_2000-5164_2571.wav,VTTS_b-4_2000-5164_2571.wav,9660,10124,-464
17169,b-1_3632-3732_3694.wav,VTTS_b-1_3632-3732_3694.wav,5420,4284,1136
17170,b-2_1563-1596_1564.wav,VTTS_b-2_1563-1596_1564.wav,2240,1846,394
17171,b-1_1010-1110_1068.wav,VTTS_b-1_1010-1110_1068.wav,1550,1533,17
17172,b-1_3733-3833_3795.wav,VTTS_b-1_3733-3833_3795.wav,2680,2810,-130
17173,b-4_401-500_435.wav,VTTS_b-4_401-500_435.wav,7220,7012,208
17174,b-3_2943-3024_2994.wav,VTTS_b-3_2943-3024_2994.wav,8180,8951,-771
17175,b-1_794-1009_994.wav,VTTS_b-1_794-1009_994.wav,3560,4447,-887
17176,b-1_3935-4033_4028.wav,VTTS_b-1_3935-4033_4028.wav,1960,2450,-490
17177,b-4_301-400_304.wav,VTTS_b-4_301-400_304.wav,7880,8510,-630
17178,b-1_2119-2219_2146.wav,VTTS_b-1_2119-2219_2146.wav,2310,1950,360
17179,b-3_4607-5008_4628.wav,VTTS_b-3_4607-5008_4628.wav,8120,7848,272
17180,b-3_2855-2942_2904.wav,VTTS_b-3_2855-2942_2904.wav,1910,2125,-215
17181,b-3_2267-2349_2275.wav,VTTS_b-3_2267-2349_2275.wav,8920,8661,259
17182,b-4_2000-5164_4117.wav,VTTS_b-4_2000-5164_4117.wav,6027,6293,-266
17183,b-1_2523-2623_2605.wav,VTTS_b-1_2523-2623_2605.wav,2010,2125,-115
17184,b-4_501-1014_966.wav,VTTS_b-4_501-1014_966.wav,8590,8278,312
17185,b-2_1223-1324_1231.wav,VTTS_b-2_1223-1324_1231.wav,1830,1765,65
17186,b-1_74-174_124.wav,VTTS_b-1_74-174_124.wav,1800,1556,244
17187,b-2_611-712_690.wav,VTTS_b-2_611-712_690.wav,2840,1892,948
17188,b-4_401-500_412.wav,VTTS_b-4_401-500_412.wav,9140,8557,583
17189,b-2_203-304_238.wav,VTTS_b-2_203-304_238.wav,2930,3019,-89
17190,b-2_1-100_79.wav,VTTS_b-2_1-100_79.wav,1740,2241,-501
17191,b-3_6701-6800_6779.wav,VTTS_b-3_6701-6800_6779.wav,6160,5759,401
17192,b-4_2000-5164_4498.wav,VTTS_b-4_2000-5164_4498.wav,4837,5410,-573
17193,b-3_2434-2523_2516.wav,VTTS_b-3_2434-2523_2516.wav,4950,4934,16
17194,b-1_1010-1110_1099.wav,VTTS_b-1_1010-1110_1099.wav,1720,1509,211
17195,b-4_2000-5164_4827.wav,VTTS_b-4_2000-5164_4827.wav,5405,4365,1040
17196,b-3_5957-6015_6015.wav,VTTS_b-3_5957-6015_6015.wav,2410,2844,-434
17197,b-2_1903-2038_1946.wav,VTTS_b-2_1903-2038_1946.wav,2630,3007,-377
17198,b-1_74-174_110.wav,VTTS_b-1_74-174_110.wav,3510,3727,-217
17199,b-3_2177-2266_2182.wav,VTTS_b-3_2177-2266_2182.wav,4330,4621,-291
17200,b-1_4034-4069_4058.wav,VTTS_b-1_4034-4069_4058.wav,5840,6769,-929
17201,b-1_377-477_428.wav,VTTS_b-1_377-477_428.wav,1240,1277,-37
17202,b-2_2413-2500_2448.wav,VTTS_b-2_2413-2500_2448.wav,2590,2310,280
17203,b-3_501-930_761.wav,VTTS_b-3_501-930_761.wav,5440,4934,506
17204,b-4_1707-1813_1722.wav,VTTS_b-4_1707-1813_1722.wav,3750,3448,302
17205,b-4_2000-5164_2273.wav,VTTS_b-4_2000-5164_2273.wav,2620,2345,275
17206,b-4_1401-1505_1450.wav,VTTS_b-4_1401-1505_1450.wav,3650,3146,504
17207,b-3_6401-6500_6435.wav,VTTS_b-3_6401-6500_6435.wav,4160,4331,-171
17208,b-3_2943-3024_2972.wav,VTTS_b-3_2943-3024_2972.wav,9170,9334,-164
17209,b-2_101-202_163.wav,VTTS_b-2_101-202_163.wav,1810,3216,-1406
17210,b-3_3889-4000_3956.wav,VTTS_b-3_3889-4000_3956.wav,3870,3390,480
17211,b-4_2000-5164_5066.wav,VTTS_b-4_2000-5164_5066.wav,4333,3402,931
17212,b-1_3935-4033_3998.wav,VTTS_b-1_3935-4033_3998.wav,3960,4040,-80
17213,b-2_1801-1902_1871.wav,VTTS_b-2_1801-1902_1871.wav,4650,5213,-563
17214,b-3_98-195_101.wav,VTTS_b-3_98-195_101.wav,7830,10310,-2480
17215,b-3_1321-1568_1444.wav,VTTS_b-3_1321-1568_1444.wav,3820,3471,349
17216,b-1_686-793_775.wav,VTTS_b-1_686-793_775.wav,1440,1463,-23
17217,b-3_6900-7016_6927.wav,VTTS_b-3_6900-7016_6927.wav,1240,1091,149
17218,b-3_501-930_658.wav,VTTS_b-3_501-930_658.wav,5960,6072,-112
17219,b-4_1101-1220_1168.wav,VTTS_b-4_1101-1220_1168.wav,2260,2090,170
17220,b-1_1515-1615_1520.wav,VTTS_b-1_1515-1615_1520.wav,1360,1091,269
17221,b-3_5639-5744_5660.wav,VTTS_b-3_5639-5744_5660.wav,5490,5700,-210
17222,b-3_5745-5852_5787.wav,VTTS_b-3_5745-5852_5787.wav,7390,6908,482
17223,b-3_6601-6700_6601.wav,VTTS_b-3_6601-6700_6601.wav,4220,3924,296
17224,b-3_3025-3111_3088.wav,VTTS_b-3_3025-3111_3088.wav,3550,3146,404
17225,b-3_1079-1320_1313.wav,VTTS_b-3_1079-1320_1313.wav,4670,6571,-1901
17226,b-1_276-376_298.wav,VTTS_b-1_276-376_298.wav,1650,1405,245
17227,b-3_3198-3278_3239.wav,VTTS_b-3_3198-3278_3239.wav,2290,2125,165
17228,b-4_2000-5164_4122.wav,VTTS_b-4_2000-5164_4122.wav,2192,2113,79
17229,b-1_794-1009_808.wav,VTTS_b-1_794-1009_808.wav,2950,2438,512
17230,b-3_3025-3111_3104.wav,VTTS_b-3_3025-3111_3104.wav,5820,5689,131
17231,b-4_2000-5164_3546.wav,VTTS_b-4_2000-5164_3546.wav,4170,5108,-938
17232,b-3_4207-4314_4299.wav,VTTS_b-3_4207-4314_4299.wav,3650,3019,631
17233,b-3_294-391_349.wav,VTTS_b-3_294-391_349.wav,7670,7059,611
17234,b-1_3632-3732_3700.wav,VTTS_b-1_3632-3732_3700.wav,2130,2566,-436
17235,b-4_2000-5164_3874.wav,VTTS_b-4_2000-5164_3874.wav,7443,8220,-777
17236,b-4_2000-5164_5132.wav,VTTS_b-4_2000-5164_5132.wav,2410,1347,1063
17237,b-3_4315-4424_4416.wav,VTTS_b-3_4315-4424_4416.wav,4200,3483,717
17238,b-3_1764-1861_1835.wav,VTTS_b-3_1764-1861_1835.wav,2980,2775,205
17239,b-4_2000-5164_4979.wav,VTTS_b-4_2000-5164_4979.wav,950,1080,-130
17240,b-3_931-979_967.wav,VTTS_b-3_931-979_967.wav,5390,4876,514
17241,b-3_5957-6015_5961.wav,VTTS_b-3_5957-6015_5961.wav,5230,4737,493
17242,b-3_5957-6015_5960.wav,VTTS_b-3_5957-6015_5960.wav,5670,5364,306
17243,b-4_2000-5164_2034.wav,VTTS_b-4_2000-5164_2034.wav,3545,3425,120
17244,b-1_276-376_351.wav,VTTS_b-1_276-376_351.wav,2880,11610,-8730
17245,b-3_3025-3111_3101.wav,VTTS_b-3_3025-3111_3101.wav,4280,4377,-97
17246,b-3_2089-2176_2094.wav,VTTS_b-3_2089-2176_2094.wav,7230,7187,43
17247,b-2_1-100_44.wav,VTTS_b-2_1-100_44.wav,1750,1765,-15
17248,b-3_2434-2523_2487.wav,VTTS_b-3_2434-2523_2487.wav,5540,5909,-369
17249,b-3_2089-2176_2172.wav,VTTS_b-3_2089-2176_2172.wav,2420,2043,377
17250,b-1_2624-2724_2651.wav,VTTS_b-1_2624-2724_2651.wav,1760,1265,495
17251,b-4_1707-1813_1774.wav,VTTS_b-4_1707-1813_1774.wav,5360,4818,542
17252,b-1_3026-3126_3029.wav,VTTS_b-1_3026-3126_3029.wav,1460,1335,125
17253,b-1_1010-1110_1096.wav,VTTS_b-1_1010-1110_1096.wav,1490,6676,-5186
17254,b-1_175-275_243.wav,VTTS_b-1_175-275_243.wav,1720,1463,257
17255,b-3_1764-1861_1764.wav,VTTS_b-3_1764-1861_1764.wav,7770,7256,514
17256,b-2_917-1018_930.wav,VTTS_b-2_917-1018_930.wav,1520,1718,-198
17257,b-4_1601-1706_1703.wav,VTTS_b-4_1601-1706_1703.wav,10220,10681,-461
17258,b-4_2000-5164_4702.wav,VTTS_b-4_2000-5164_4702.wav,12185,11610,575
17259,b-1_2321-2421_2331.wav,VTTS_b-1_2321-2421_2331.wav,1620,1289,331
17260,b-4_2000-5164_2128.wav,VTTS_b-4_2000-5164_2128.wav,8020,8313,-293
17261,b-4_2000-5164_2157.wav,VTTS_b-4_2000-5164_2157.wav,8065,8557,-492
17262,b-2_1-100_13.wav,VTTS_b-2_1-100_13.wav,1310,1115,195
17263,b-4_2000-5164_3456.wav,VTTS_b-4_2000-5164_3456.wav,3851,4307,-456
17264,b-1_4070-4105_4088.wav,VTTS_b-1_4070-4105_4088.wav,1230,1741,-511
17265,b-3_4207-4314_4217.wav,VTTS_b-3_4207-4314_4217.wav,3260,3599,-339
17266,b-3_1-97_71.wav,VTTS_b-3_1-97_71.wav,3550,3692,-142
17267,b-4_1401-1505_1427.wav,VTTS_b-4_1401-1505_1427.wav,6740,6687,53
17268,b-3_2177-2266_2213.wav,VTTS_b-3_2177-2266_2213.wav,8760,9009,-249
17269,b-1_2826-2926_2827.wav,VTTS_b-1_2826-2926_2827.wav,3720,4098,-378
17270,b-4_2000-5164_2626.wav,VTTS_b-4_2000-5164_2626.wav,3565,3692,-127
17271,b-1_1111-1211_1167.wav,VTTS_b-1_1111-1211_1167.wav,1910,1776,134
17272,b-4_2000-5164_4864.wav,VTTS_b-4_2000-5164_4864.wav,5495,5770,-275
17273,b-1_1818-1918_1895.wav,VTTS_b-1_1818-1918_1895.wav,1270,1254,16
17274,b-2_407-508_413.wav,VTTS_b-2_407-508_413.wav,1420,1347,73
17275,b-1_1616-1716_1621.wav,VTTS_b-1_1616-1716_1621.wav,1730,1625,105
17276,b-2_203-304_205.wav,VTTS_b-2_203-304_205.wav,1370,1637,-267
17277,b-1_1010-1110_1046.wav,VTTS_b-1_1010-1110_1046.wav,3110,2786,324
17278,b-1_4322-4357_4334.wav,VTTS_b-1_4322-4357_4334.wav,3640,4203,-563
17279,b-4_2000-5164_4452.wav,VTTS_b-4_2000-5164_4452.wav,7508,8092,-584
17280,b-1_1-73_70.wav,VTTS_b-1_1-73_70.wav,2840,3471,-631
17281,b-3_3279-3363_3342.wav,VTTS_b-3_3279-3363_3342.wav,3380,3111,269
17282,b-1_1818-1918_1833.wav,VTTS_b-1_1818-1918_1833.wav,2510,2403,107
17283,b-3_2267-2349_2328.wav,VTTS_b-3_2267-2349_2328.wav,3470,3320,150
17284,b-4_501-1014_606.wav,VTTS_b-4_501-1014_606.wav,3790,3541,249
17285,b-3_1-97_22.wav,VTTS_b-3_1-97_22.wav,4850,4690,160
17286,b-3_6401-6500_6500.wav,VTTS_b-3_6401-6500_6500.wav,2700,2299,401
17287,b-1_2422-2522_2477.wav,VTTS_b-1_2422-2522_2477.wav,1540,1498,42
17288,b-1_3228-3328_3314.wav,VTTS_b-1_3228-3328_3314.wav,2470,2554,-84
17289,b-3_3198-3278_3241.wav,VTTS_b-3_3198-3278_3241.wav,5820,6432,-612
17290,b-1_4466-4498_4494.wav,VTTS_b-1_4466-4498_4494.wav,3750,4981,-1231
17291,b-1_377-477_384.wav,VTTS_b-1_377-477_384.wav,1940,1846,94
17292,b-1_1010-1110_1074.wav,VTTS_b-1_1010-1110_1074.wav,2140,1997,143
17293,b-4_2000-5164_4224.wav,VTTS_b-4_2000-5164_4224.wav,5233,8487,-3254
17294,b-4_1601-1706_1677.wav,VTTS_b-4_1601-1706_1677.wav,5030,4261,769
17295,b-2_611-712_679.wav,VTTS_b-2_611-712_679.wav,2090,1974,116
17296,b-4_501-1014_567.wav,VTTS_b-4_501-1014_567.wav,6370,6293,77
17297,b-3_501-930_562.wav,VTTS_b-3_501-930_562.wav,3390,2810,580
17298,b-4_2000-5164_3092.wav,VTTS_b-4_2000-5164_3092.wav,5446,5004,442
17299,b-4_2000-5164_4181.wav,VTTS_b-4_2000-5164_4181.wav,9117,10670,-1553
17300,b-2_2209-2310_2296.wav,VTTS_b-2_2209-2310_2296.wav,1230,1149,81
17301,b-1_1414-1514_1473.wav,VTTS_b-1_1414-1514_1473.wav,2040,1637,403
17302,b-1_2018-2118_2105.wav,VTTS_b-1_2018-2118_2105.wav,2240,2229,11
17303,b-4_2000-5164_2864.wav,VTTS_b-4_2000-5164_2864.wav,6480,7210,-730
17304,b-4_2000-5164_2539.wav,VTTS_b-4_2000-5164_2539.wav,6320,5944,376
17305,b-2_2107-2193_2116.wav,VTTS_b-2_2107-2193_2116.wav,1080,1091,-11
17306,b-3_3454-3537_3467.wav,VTTS_b-3_3454-3537_3467.wav,10120,9323,797
17307,b-1_3026-3126_3072.wav,VTTS_b-1_3026-3126_3072.wav,3100,3518,-418
17308,b-1_2422-2522_2521.wav,VTTS_b-1_2422-2522_2521.wav,3060,2694,366
17309,b-3_501-930_840.wav,VTTS_b-3_501-930_840.wav,3510,3100,410
17310,b-2_305-406_320.wav,VTTS_b-2_305-406_320.wav,1770,1718,52
17311,b-3_5009-5427_5127.wav,VTTS_b-3_5009-5427_5127.wav,3440,3587,-147
17312,b-4_2000-5164_4378.wav,VTTS_b-4_2000-5164_4378.wav,1850,2206,-356
17313,b-4_2000-5164_3287.wav,VTTS_b-4_2000-5164_3287.wav,7586,7117,469
17314,b-3_3279-3363_3350.wav,VTTS_b-3_3279-3363_3350.wav,3860,3413,447
17315,b-4_2000-5164_4950.wav,VTTS_b-4_2000-5164_4950.wav,3306,4214,-908
17316,b-2_2311-2412_2371.wav,VTTS_b-2_2311-2412_2371.wav,2510,2368,142
17317,b-2_2311-2412_2387.wav,VTTS_b-2_2311-2412_2387.wav,2740,2798,-58
17318,b-3_3198-3278_3212.wav,VTTS_b-3_3198-3278_3212.wav,6710,6920,-210
17319,b-1_1212-1312_1261.wav,VTTS_b-1_1212-1312_1261.wav,1640,1591,49
17320,b-4_2000-5164_3194.wav,VTTS_b-4_2000-5164_3194.wav,2299,2322,-23
17321,b-1_74-174_138.wav,VTTS_b-1_74-174_138.wav,5510,3773,1737
17322,b-3_3198-3278_3213.wav,VTTS_b-3_3198-3278_3213.wav,6140,5457,683
17323,b-3_98-195_115.wav,VTTS_b-3_98-195_115.wav,2420,2612,-192
17324,b-3_3628-3714_3694.wav,VTTS_b-3_3628-3714_3694.wav,5380,5294,86
17325,b-3_3715-3802_3774.wav,VTTS_b-3_3715-3802_3774.wav,5570,5480,90
17326,b-3_1321-1568_1422.wav,VTTS_b-3_1321-1568_1422.wav,1810,1788,22
17327,b-3_3803-3888_3848.wav,VTTS_b-3_3803-3888_3848.wav,4110,3669,441
17328,b-3_4607-5008_4835.wav,VTTS_b-3_4607-5008_4835.wav,6470,7918,-1448
17329,b-3_4104-4206_4202.wav,VTTS_b-3_4104-4206_4202.wav,8160,7848,312
17330,b-3_4001-4103_4055.wav,VTTS_b-3_4001-4103_4055.wav,5940,6165,-225
17331,b-2_1427-1562_1435.wav,VTTS_b-2_1427-1562_1435.wav,4360,3379,981
17332,b-4_2000-5164_4907.wav,VTTS_b-4_2000-5164_4907.wav,9124,11610,-2486
17333,b-3_196-293_286.wav,VTTS_b-3_196-293_286.wav,3650,3564,86
17334,b-1_3834-3934_3861.wav,VTTS_b-1_3834-3934_3861.wav,1240,1347,-107
17335,b-3_931-979_939.wav,VTTS_b-3_931-979_939.wav,6240,5364,876
17336,b-2_2413-2500_2426.wav,VTTS_b-2_2413-2500_2426.wav,5310,5190,120
17337,b-3_392-500_405.wav,VTTS_b-3_392-500_405.wav,10100,8313,1787
17338,b-3_5009-5427_5288.wav,VTTS_b-3_5009-5427_5288.wav,3360,3402,-42
17339,b-1_1515-1615_1575.wav,VTTS_b-1_1515-1615_1575.wav,4860,4516,344
17340,b-4_2000-5164_2455.wav,VTTS_b-4_2000-5164_2455.wav,4040,4354,-314
17341,b-1_478-578_478.wav,VTTS_b-1_478-578_478.wav,3790,4470,-680
17342,b-3_501-930_631.wav,VTTS_b-3_501-930_631.wav,2630,2543,87
17343,b-3_4498-4605_4509.wav,VTTS_b-3_4498-4605_4509.wav,7670,6931,739
17344,b-3_2524-2854_2843.wav,VTTS_b-3_2524-2854_2843.wav,3280,3309,-29
17345,b-2_917-1018_940.wav,VTTS_b-2_917-1018_940.wav,2570,3332,-762
17346,b-4_2000-5164_2705.wav,VTTS_b-4_2000-5164_2705.wav,3690,4040,-350
17347,b-4_2000-5164_3763.wav,VTTS_b-4_2000-5164_3763.wav,4610,4865,-255
17348,b-1_2927-3025_3006.wav,VTTS_b-1_2927-3025_3006.wav,3520,4748,-1228
17349,b-1_794-1009_802.wav,VTTS_b-1_794-1009_802.wav,2270,2392,-122
17350,b-3_3715-3802_3718.wav,VTTS_b-3_3715-3802_3718.wav,2760,3820,-1060
17351,b-3_6701-6800_6719.wav,VTTS_b-3_6701-6800_6719.wav,4010,4365,-355
17352,b-3_2524-2854_2561.wav,VTTS_b-3_2524-2854_2561.wav,4070,5132,-1062
17353,b-3_1666-1763_1720.wav,VTTS_b-3_1666-1763_1720.wav,3250,3889,-639
17354,b-1_3632-3732_3652.wav,VTTS_b-1_3632-3732_3652.wav,1540,1521,19
17355,b-3_1-97_98.wav,VTTS_b-3_1-97_98.wav,11160,9950,1210
17356,b-1_377-477_410.wav,VTTS_b-1_377-477_410.wav,3790,3541,249
17357,b-3_5745-5852_5795.wav,VTTS_b-3_5745-5852_5795.wav,4120,5619,-1499
17358,b-3_6016-6115_6114.wav,VTTS_b-3_6016-6115_6114.wav,2750,2798,-48
17359,b-3_5533-5638_5594.wav,VTTS_b-3_5533-5638_5594.wav,5570,5155,415
17360,b-1_4106-4141_4112.wav,VTTS_b-1_4106-4141_4112.wav,1850,1997,-147
17361,b-3_6900-7016_6946.wav,VTTS_b-3_6900-7016_6946.wav,2120,2218,-98
17362,b-3_5009-5427_5164.wav,VTTS_b-3_5009-5427_5164.wav,1970,1869,101
17363,b-3_294-391_295.wav,VTTS_b-3_294-391_295.wav,5510,5097,413
17364,b-2_1325-1426_1414.wav,VTTS_b-2_1325-1426_1414.wav,7110,10008,-2898
17365,b-2_509-610_591.wav,VTTS_b-2_509-610_591.wav,2930,3390,-460
17366,b-3_5533-5638_5582.wav,VTTS_b-3_5533-5638_5582.wav,6790,9300,-2510
17367,b-3_6016-6115_6037.wav,VTTS_b-3_6016-6115_6037.wav,6490,6699,-209
17368,b-1_1010-1110_1057.wav,VTTS_b-1_1010-1110_1057.wav,4200,4493,-293
17369,b-2_917-1018_991.wav,VTTS_b-2_917-1018_991.wav,2160,2368,-208
17370,b-3_5639-5744_5737.wav,VTTS_b-3_5639-5744_5737.wav,4280,4574,-294
17371,b-1_2826-2926_2884.wav,VTTS_b-1_2826-2926_2884.wav,3900,3866,34
17372,b-3_4207-4314_4209.wav,VTTS_b-3_4207-4314_4209.wav,4680,4226,454
17373,b-3_6900-7016_6912.wav,VTTS_b-3_6900-7016_6912.wav,3400,3901,-501
17374,b-2_305-406_321.wav,VTTS_b-2_305-406_321.wav,4740,4934,-194
17375,b-1_2422-2522_2459.wav,VTTS_b-1_2422-2522_2459.wav,3420,3564,-144
17376,b-3_98-195_163.wav,VTTS_b-3_98-195_163.wav,3280,3413,-133
17377,b-3_3889-4000_3901.wav,VTTS_b-3_3889-4000_3901.wav,10640,10077,563
17378,b-1_2119-2219_2200.wav,VTTS_b-1_2119-2219_2200.wav,2910,2694,216
17379,b-3_501-930_553.wav,VTTS_b-3_501-930_553.wav,6690,6792,-102
17380,b-3_2524-2854_2648.wav,VTTS_b-3_2524-2854_2648.wav,4990,5294,-304
17381,b-4_2000-5164_4397.wav,VTTS_b-4_2000-5164_4397.wav,2614,5921,-3307
17382,b-1_74-174_167.wav,VTTS_b-1_74-174_167.wav,2180,2252,-72
17383,b-4_2000-5164_3948.wav,VTTS_b-4_2000-5164_3948.wav,5125,4505,620
17384,b-4_2000-5164_4203.wav,VTTS_b-4_2000-5164_4203.wav,4867,4656,211
17385,b-3_6501-6600_6534.wav,VTTS_b-3_6501-6600_6534.wav,6860,6339,521
17386,b-4_2000-5164_2066.wav,VTTS_b-4_2000-5164_2066.wav,5585,6177,-592
17387,b-3_1568-1665_1658.wav,VTTS_b-3_1568-1665_1658.wav,5250,11610,-6360
17388,b-2_509-610_590.wav,VTTS_b-2_509-610_590.wav,1740,1788,-48
17389,b-1_2725-2825_2815.wav,VTTS_b-1_2725-2825_2815.wav,2390,2125,265
17390,b-4_1901-2000_1948.wav,VTTS_b-4_1901-2000_1948.wav,4290,4005,285
17391,b-2_1801-1902_1887.wav,VTTS_b-2_1801-1902_1887.wav,5220,5654,-434
17392,b-2_2040-2072_2048.wav,VTTS_b-2_2040-2072_2048.wav,1860,1451,409
17393,b-1_2220-2320_2238.wav,VTTS_b-1_2220-2320_2238.wav,1890,2067,-177
17394,b-4_2000-5164_3068.wav,VTTS_b-4_2000-5164_3068.wav,6383,7396,-1013
17395,b-4_2000-5164_4481.wav,VTTS_b-4_2000-5164_4481.wav,3127,3460,-333
17396,b-3_4607-5008_4755.wav,VTTS_b-3_4607-5008_4755.wav,6150,6548,-398
17397,b-3_2434-2523_2496.wav,VTTS_b-3_2434-2523_2496.wav,7560,6745,815
17398,b-3_4425-4497_4492.wav,VTTS_b-3_4425-4497_4492.wav,8500,11610,-3110
17399,b-3_6801-6900_6875.wav,VTTS_b-3_6801-6900_6875.wav,5760,5422,338
17400,b-1_2119-2219_2142.wav,VTTS_b-1_2119-2219_2142.wav,1660,1451,209
17401,b-1_276-376_311.wav,VTTS_b-1_276-376_311.wav,3140,3599,-459
17402,b-2_815-916_898.wav,VTTS_b-2_815-916_898.wav,2050,2287,-237
17403,b-2_2040-2072_2050.wav,VTTS_b-2_2040-2072_2050.wav,1690,1753,-63
17404,b-2_1121-1222_1165.wav,VTTS_b-2_1121-1222_1165.wav,3770,2670,1100
17405,b-3_5009-5427_5019.wav,VTTS_b-3_5009-5427_5019.wav,7200,7245,-45
17406,b-1_1616-1716_1665.wav,VTTS_b-1_1616-1716_1665.wav,5010,4772,238
17407,b-4_501-1014_547.wav,VTTS_b-4_501-1014_547.wav,7230,7454,-224
17408,b-3_5009-5427_5092.wav,VTTS_b-3_5009-5427_5092.wav,5840,5410,430
17409,b-4_2000-5164_4492.wav,VTTS_b-4_2000-5164_4492.wav,5797,7326,-1529
17410,b-4_2000-5164_4628.wav,VTTS_b-4_2000-5164_4628.wav,2868,2856,12
17411,b-4_2000-5164_3434.wav,VTTS_b-4_2000-5164_3434.wav,5024,4899,125
17412,b-4_501-1014_914.wav,VTTS_b-4_501-1014_914.wav,1350,1300,50
17413,b-1_3430-3530_3454.wav,VTTS_b-1_3430-3530_3454.wav,1380,1463,-83
17414,b-3_4607-5008_4990.wav,VTTS_b-3_4607-5008_4990.wav,5350,5375,-25
17415,b-4_2000-5164_3831.wav,VTTS_b-4_2000-5164_3831.wav,5894,6130,-236
17416,b-4_2000-5164_5057.wav,VTTS_b-4_2000-5164_5057.wav,5187,5399,-212
17417,b-3_3112-3197_3126.wav,VTTS_b-3_3112-3197_3126.wav,4470,4354,116
17418,b-3_6801-6900_6809.wav,VTTS_b-3_6801-6900_6809.wav,3680,3297,383
17419,b-3_5639-5744_5745.wav,VTTS_b-3_5639-5744_5745.wav,5910,5457,453
17420,b-3_5009-5427_5054.wav,VTTS_b-3_5009-5427_5054.wav,4910,5027,-117
17421,b-3_3112-3197_3117.wav,VTTS_b-3_3112-3197_3117.wav,8300,8406,-106
17422,b-1_74-174_125.wav,VTTS_b-1_74-174_125.wav,1640,2055,-415
17423,b-4_2000-5164_4054.wav,VTTS_b-4_2000-5164_4054.wav,5895,6339,-444
17424,b-1_2018-2118_2028.wav,VTTS_b-1_2018-2118_2028.wav,3150,2763,387
17425,b-4_2000-5164_5004.wav,VTTS_b-4_2000-5164_5004.wav,4729,4841,-112
17426,b-3_2434-2523_2442.wav,VTTS_b-3_2434-2523_2442.wav,7500,6687,813
17427,b-3_3715-3802_3724.wav,VTTS_b-3_3715-3802_3724.wav,5450,4830,620
17428,b-1_794-1009_915.wav,VTTS_b-1_794-1009_915.wav,3020,2426,594
17429,b-3_4607-5008_4948.wav,VTTS_b-3_4607-5008_4948.wav,5740,6641,-901
17430,b-4_501-1014_751.wav,VTTS_b-4_501-1014_751.wav,2800,2171,629
17431,b-1_4106-4141_4137.wav,VTTS_b-1_4106-4141_4137.wav,5080,5619,-539
17432,b-1_1111-1211_1151.wav,VTTS_b-1_1111-1211_1151.wav,1680,1521,159
17433,b-4_2000-5164_3860.wav,VTTS_b-4_2000-5164_3860.wav,2186,1997,189
17434,b-4_2000-5164_4543.wav,VTTS_b-4_2000-5164_4543.wav,3094,3135,-41
17435,b-1_2321-2421_2412.wav,VTTS_b-1_2321-2421_2412.wav,3240,2728,512
17436,b-3_1568-1665_1661.wav,VTTS_b-3_1568-1665_1661.wav,4310,5457,-1147
17437,b-3_501-930_917.wav,VTTS_b-3_501-930_917.wav,18660,11610,7050
17438,b-1_2018-2118_2036.wav,VTTS_b-1_2018-2118_2036.wav,4010,4087,-77
17439,b-1_377-477_432.wav,VTTS_b-1_377-477_432.wav,1760,1985,-225
17440,b-1_3834-3934_3852.wav,VTTS_b-1_3834-3934_3852.wav,1700,2032,-332
17441,b-3_2855-2942_2920.wav,VTTS_b-3_2855-2942_2920.wav,5400,6130,-730
17442,b-3_1321-1568_1350.wav,VTTS_b-3_1321-1568_1350.wav,3840,3692,148
17443,b-2_1223-1324_1234.wav,VTTS_b-2_1223-1324_1234.wav,3460,4505,-1045
17444,b-2_101-202_128.wav,VTTS_b-2_101-202_128.wav,2450,2566,-116
17445,b-4_1707-1813_1708.wav,VTTS_b-4_1707-1813_1708.wav,8530,9067,-537
17446,b-2_1427-1562_1521.wav,VTTS_b-2_1427-1562_1521.wav,2480,2519,-39
17447,b-1_3834-3934_3847.wav,VTTS_b-1_3834-3934_3847.wav,1730,1660,70
17448,b-1_2523-2623_2592.wav,VTTS_b-1_2523-2623_2592.wav,2470,2067,403
17449,b-3_501-930_849.wav,VTTS_b-3_501-930_849.wav,8190,7895,295
17450,b-1_1111-1211_1169.wav,VTTS_b-1_1111-1211_1169.wav,1670,1440,230
17451,b-4_2000-5164_3735.wav,VTTS_b-4_2000-5164_3735.wav,3660,3448,212
17452,b-3_6701-6800_6721.wav,VTTS_b-3_6701-6800_6721.wav,8340,7918,422
17453,b-4_501-1014_550.wav,VTTS_b-4_501-1014_550.wav,3850,3170,680
17454,b-4_1-52_34.wav,VTTS_b-4_1-52_34.wav,7250,6223,1027
17455,b-3_501-930_522.wav,VTTS_b-3_501-930_522.wav,3530,3622,-92
17456,b-4_2000-5164_2172.wav,VTTS_b-4_2000-5164_2172.wav,4180,4145,35
17457,b-3_931-979_972.wav,VTTS_b-3_931-979_972.wav,6310,6827,-517
17458,b-3_501-930_828.wav,VTTS_b-3_501-930_828.wav,5720,5224,496
17459,b-3_3538-3627_3605.wav,VTTS_b-3_3538-3627_3605.wav,4480,4540,-60
17460,b-3_3538-3627_3627.wav,VTTS_b-3_3538-3627_3627.wav,7820,8499,-679
17461,b-3_2177-2266_2228.wav,VTTS_b-3_2177-2266_2228.wav,3860,3483,377
17462,b-4_2000-5164_3916.wav,VTTS_b-4_2000-5164_3916.wav,11604,11610,-6
17463,b-4_2000-5164_2621.wav,VTTS_b-4_2000-5164_2621.wav,14260,11610,2650
17464,b-1_1515-1615_1517.wav,VTTS_b-1_1515-1615_1517.wav,1140,1103,37
17465,b-4_2000-5164_3967.wav,VTTS_b-4_2000-5164_3967.wav,4326,3251,1075
17466,b-3_196-293_263.wav,VTTS_b-3_196-293_263.wav,4290,3704,586
17467,b-4_2000-5164_4236.wav,VTTS_b-4_2000-5164_4236.wav,6142,6444,-302
17468,b-3_4607-5008_4649.wav,VTTS_b-3_4607-5008_4649.wav,4890,4400,490
17469,b-2_1325-1426_1419.wav,VTTS_b-2_1325-1426_1419.wav,3050,3204,-154
17470,b-1_2523-2623_2583.wav,VTTS_b-1_2523-2623_2583.wav,1960,2009,-49
17471,b-3_980-1077_1036.wav,VTTS_b-3_980-1077_1036.wav,3390,4435,-1045
17472,b-4_2000-5164_2476.wav,VTTS_b-4_2000-5164_2476.wav,4640,4911,-271
17473,b-3_98-195_187.wav,VTTS_b-3_98-195_187.wav,4870,4934,-64
17474,b-1_1-73_45.wav,VTTS_b-1_1-73_45.wav,1840,1765,75
17475,b-3_1079-1320_1207.wav,VTTS_b-3_1079-1320_1207.wav,9060,10507,-1447
17476,b-2_1121-1222_1129.wav,VTTS_b-2_1121-1222_1129.wav,1040,952,88
17477,b-4_2000-5164_4735.wav,VTTS_b-4_2000-5164_4735.wav,3369,4017,-648
17478,b-1_2826-2926_2915.wav,VTTS_b-1_2826-2926_2915.wav,2140,2159,-19
17479,b-3_5533-5638_5610.wav,VTTS_b-3_5533-5638_5610.wav,9090,9033,57
17480,b-3_5853-5956_5865.wav,VTTS_b-3_5853-5956_5865.wav,3190,2810,380
17481,b-3_5009-5427_5375.wav,VTTS_b-3_5009-5427_5375.wav,4800,5062,-262
17482,b-4_301-400_392.wav,VTTS_b-4_301-400_392.wav,4480,5689,-1209
17483,b-1_1010-1110_1084.wav,VTTS_b-1_1010-1110_1084.wav,2050,2264,-214
17484,b-1_3430-3530_3447.wav,VTTS_b-1_3430-3530_3447.wav,1550,1498,52
17485,b-3_1666-1763_1730.wav,VTTS_b-3_1666-1763_1730.wav,5980,6734,-754
17486,b-3_6701-6800_6797.wav,VTTS_b-3_6701-6800_6797.wav,10000,9683,317
17487,b-4_2000-5164_5023.wav,VTTS_b-4_2000-5164_5023.wav,5374,5213,161
17488,b-3_4315-4424_4345.wav,VTTS_b-3_4315-4424_4345.wav,4740,4981,-241
17489,b-3_98-195_158.wav,VTTS_b-3_98-195_158.wav,6880,7256,-376
17490,b-4_501-1014_844.wav,VTTS_b-4_501-1014_844.wav,7190,6978,212
17491,b-4_2000-5164_2568.wav,VTTS_b-4_2000-5164_2568.wav,4900,7442,-2542
17492,b-1_4322-4357_4326.wav,VTTS_b-1_4322-4357_4326.wav,2290,2206,84
17493,b-4_401-500_478.wav,VTTS_b-4_401-500_478.wav,3030,3309,-279
17494,b-3_6501-6600_6511.wav,VTTS_b-3_6501-6600_6511.wav,4200,3773,427
17495,b-1_686-793_749.wav,VTTS_b-1_686-793_749.wav,1410,1347,63
17496,b-1_2624-2724_2722.wav,VTTS_b-1_2624-2724_2722.wav,1630,1776,-146
17497,b-3_4315-4424_4343.wav,VTTS_b-3_4315-4424_4343.wav,5590,5515,75
17498,b-1_2826-2926_2903.wav,VTTS_b-1_2826-2926_2903.wav,5710,8208,-2498
17499,b-1_3834-3934_3883.wav,VTTS_b-1_3834-3934_3883.wav,4180,4528,-348
17500,b-1_1313-1413_1406.wav,VTTS_b-1_1313-1413_1406.wav,4400,4272,128
17501,b-1_1515-1615_1592.wav,VTTS_b-1_1515-1615_1592.wav,1270,1138,132
17502,b-4_2000-5164_2591.wav,VTTS_b-4_2000-5164_2591.wav,2360,2485,-125
17503,b-1_377-477_426.wav,VTTS_b-1_377-477_426.wav,3200,3030,170
17504,b-3_4607-5008_5007.wav,VTTS_b-3_4607-5008_5007.wav,4130,4319,-189
17505,b-3_4315-4424_4365.wav,VTTS_b-3_4315-4424_4365.wav,1250,1242,8
17506,b-4_501-1014_972.wav,VTTS_b-4_501-1014_972.wav,4680,4772,-92
17507,b-3_3803-3888_3844.wav,VTTS_b-3_3803-3888_3844.wav,8140,8069,71
17508,b-2_1223-1324_1320.wav,VTTS_b-2_1223-1324_1320.wav,2440,3111,-671
17509,b-3_6900-7016_6985.wav,VTTS_b-3_6900-7016_6985.wav,5650,7442,-1792
17510,b-3_2434-2523_2457.wav,VTTS_b-3_2434-2523_2457.wav,4440,4493,-53
17511,b-3_3279-3363_3345.wav,VTTS_b-3_3279-3363_3345.wav,5860,6455,-595
17512,b-2_1597-1698_1603.wav,VTTS_b-2_1597-1698_1603.wav,1040,882,158
17513,b-4_2000-5164_4319.wav,VTTS_b-4_2000-5164_4319.wav,8519,8707,-188
17514,b-4_501-1014_980.wav,VTTS_b-4_501-1014_980.wav,3430,3402,28
17515,b-2_917-1018_1010.wav,VTTS_b-2_917-1018_1010.wav,2790,2125,665
17516,b-4_2000-5164_3668.wav,VTTS_b-4_2000-5164_3668.wav,3055,3019,36
17517,b-2_509-610_564.wav,VTTS_b-2_509-610_564.wav,2990,3274,-284
17518,b-4_2000-5164_2301.wav,VTTS_b-4_2000-5164_2301.wav,2750,2856,-106
17519,b-2_815-916_822.wav,VTTS_b-2_815-916_822.wav,1920,1985,-65
17520,b-4_2000-5164_2142.wav,VTTS_b-4_2000-5164_2142.wav,5180,4400,780
17521,b-3_4207-4314_4292.wav,VTTS_b-3_4207-4314_4292.wav,3680,3471,209
17522,b-2_2209-2310_2298.wav,VTTS_b-2_2209-2310_2298.wav,5960,5190,770
17523,b-1_2624-2724_2670.wav,VTTS_b-1_2624-2724_2670.wav,4370,11610,-7240
17524,b-4_1707-1813_1775.wav,VTTS_b-4_1707-1813_1775.wav,4680,4609,71
17525,b-1_579-649_609.wav,VTTS_b-1_579-649_609.wav,2380,2426,-46
17526,b-3_5957-6015_5968.wav,VTTS_b-3_5957-6015_5968.wav,4080,4470,-390
17527,b-4_2000-5164_3297.wav,VTTS_b-4_2000-5164_3297.wav,4782,4725,57
17528,b-4_2000-5164_2062.wav,VTTS_b-4_2000-5164_2062.wav,4620,4934,-314
17529,b-4_1814-1900_1838.wav,VTTS_b-4_1814-1900_1838.wav,4880,4551,329
17530,b-4_1901-2000_1981.wav,VTTS_b-4_1901-2000_1981.wav,4110,3611,499
17531,b-1_1818-1918_1856.wav,VTTS_b-1_1818-1918_1856.wav,3010,4087,-1077
17532,b-4_501-1014_753.wav,VTTS_b-4_501-1014_753.wav,7550,7233,317
17533,b-2_2107-2193_2159.wav,VTTS_b-2_2107-2193_2159.wav,5890,5016,874
17534,b-4_2000-5164_4718.wav,VTTS_b-4_2000-5164_4718.wav,6720,6711,9
17535,b-2_1699-1800_1744.wav,VTTS_b-2_1699-1800_1744.wav,3430,3216,214
17536,b-1_794-1009_897.wav,VTTS_b-1_794-1009_897.wav,3600,4284,-684
17537,b-1_4214-4285_4223.wav,VTTS_b-1_4214-4285_4223.wav,1800,2705,-905
17538,b-4_1221-1300_1240.wav,VTTS_b-4_1221-1300_1240.wav,3240,3123,117
17539,b-3_4607-5008_4819.wav,VTTS_b-3_4607-5008_4819.wav,4790,4679,111
17540,b-3_2855-2942_2905.wav,VTTS_b-3_2855-2942_2905.wav,2080,1974,106
17541,b-3_4001-4103_4051.wav,VTTS_b-3_4001-4103_4051.wav,9020,9892,-872
17542,b-4_2000-5164_2038.wav,VTTS_b-4_2000-5164_2038.wav,3900,4122,-222
17543,b-3_6401-6500_6407.wav,VTTS_b-3_6401-6500_6407.wav,1980,2647,-667
17544,b-3_3364-3453_3442.wav,VTTS_b-3_3364-3453_3442.wav,2820,2891,-71
17545,b-3_1079-1320_1099.wav,VTTS_b-3_1079-1320_1099.wav,9420,9555,-135
17546,b-3_4001-4103_4050.wav,VTTS_b-3_4001-4103_4050.wav,6730,6269,461
17547,b-3_2434-2523_2490.wav,VTTS_b-3_2434-2523_2490.wav,1880,1741,139
17548,b-4_2000-5164_3529.wav,VTTS_b-4_2000-5164_3529.wav,4361,4807,-446
17549,b-2_1-100_64.wav,VTTS_b-2_1-100_64.wav,3640,3611,29
17550,b-4_2000-5164_5127.wav,VTTS_b-4_2000-5164_5127.wav,3081,2496,585
17551,b-1_2927-3025_2928.wav,VTTS_b-1_2927-3025_2928.wav,5840,5863,-23
17552,b-1_276-376_280.wav,VTTS_b-1_276-376_280.wav,1720,2844,-1124
17553,b-4_2000-5164_4870.wav,VTTS_b-4_2000-5164_4870.wav,4787,3471,1316
17554,b-1_1919-2017_1995.wav,VTTS_b-1_1919-2017_1995.wav,5380,7210,-1830
17555,b-1_3127-3227_3221.wav,VTTS_b-1_3127-3227_3221.wav,3250,3088,162
17556,b-4_501-1014_785.wav,VTTS_b-4_501-1014_785.wav,2570,2438,132
17557,b-3_3279-3363_3310.wav,VTTS_b-3_3279-3363_3310.wav,3310,3146,164
17558,b-1_377-477_391.wav,VTTS_b-1_377-477_391.wav,2340,2148,192
17559,b-1_3531-3631_3569.wav,VTTS_b-1_3531-3631_3569.wav,4850,4458,392
17560,b-3_6801-6900_6884.wav,VTTS_b-3_6801-6900_6884.wav,4120,6548,-2428
17561,b-4_1707-1813_1811.wav,VTTS_b-4_1707-1813_1811.wav,2040,1521,519
17562,b-3_4607-5008_4759.wav,VTTS_b-3_4607-5008_4759.wav,8870,8800,70
17563,b-3_1321-1568_1345.wav,VTTS_b-3_1321-1568_1345.wav,7020,6026,994
17564,b-3_1079-1320_1107.wav,VTTS_b-3_1079-1320_1107.wav,9480,9590,-110
17565,b-4_2000-5164_3658.wav,VTTS_b-4_2000-5164_3658.wav,2286,2786,-500
17566,b-1_686-793_699.wav,VTTS_b-1_686-793_699.wav,5500,5933,-433
17567,b-4_2000-5164_4846.wav,VTTS_b-4_2000-5164_4846.wav,2935,3065,-130
17568,b-1_1313-1413_1393.wav,VTTS_b-1_1313-1413_1393.wav,4710,4435,275
17569,b-2_2107-2193_2182.wav,VTTS_b-2_2107-2193_2182.wav,1380,1231,149
17570,b-3_4207-4314_4247.wav,VTTS_b-3_4207-4314_4247.wav,4470,5863,-1393
17571,b-3_5745-5852_5838.wav,VTTS_b-3_5745-5852_5838.wav,6040,6177,-137
17572,b-3_3628-3714_3687.wav,VTTS_b-3_3628-3714_3687.wav,5140,5375,-235
17573,b-3_1321-1568_1548.wav,VTTS_b-3_1321-1568_1548.wav,5910,11610,-5700
17574,b-4_501-1014_881.wav,VTTS_b-4_501-1014_881.wav,4730,4853,-123
17575,b-1_1616-1716_1631.wav,VTTS_b-1_1616-1716_1631.wav,2070,2740,-670
17576,b-3_3715-3802_3744.wav,VTTS_b-3_3715-3802_3744.wav,4660,4574,86
17577,b-2_203-304_298.wav,VTTS_b-2_203-304_298.wav,2790,3309,-519
17578,b-3_6701-6800_6745.wav,VTTS_b-3_6701-6800_6745.wav,7200,8417,-1217
17579,b-3_98-195_147.wav,VTTS_b-3_98-195_147.wav,4610,4122,488
17580,b-3_2855-2942_2891.wav,VTTS_b-3_2855-2942_2891.wav,4820,4992,-172
17581,b-2_1801-1902_1816.wav,VTTS_b-2_1801-1902_1816.wav,3460,3158,302
17582,b-2_1325-1426_1361.wav,VTTS_b-2_1325-1426_1361.wav,1580,1498,82
17583,b-1_1717-1817_1784.wav,VTTS_b-1_1717-1817_1784.wav,2400,2403,-3
17584,b-4_2000-5164_2274.wav,VTTS_b-4_2000-5164_2274.wav,3840,5039,-1199
17585,b-1_1111-1211_1177.wav,VTTS_b-1_1111-1211_1177.wav,2070,2090,-20
17586,b-1_3834-3934_3934.wav,VTTS_b-1_3834-3934_3934.wav,2910,3007,-97
17587,b-1_1414-1514_1518.wav,VTTS_b-1_1414-1514_1518.wav,2100,2125,-25
17588,b-4_2000-5164_3510.wav,VTTS_b-4_2000-5164_3510.wav,4568,4481,87
17589,b-1_4394-4429_4399.wav,VTTS_b-1_4394-4429_4399.wav,1140,1091,49
17590,b-1_1616-1716_1657.wav,VTTS_b-1_1616-1716_1657.wav,2040,3495,-1455
17591,b-4_1221-1300_1270.wav,VTTS_b-4_1221-1300_1270.wav,7020,7094,-74
17592,b-1_2018-2118_2106.wav,VTTS_b-1_2018-2118_2106.wav,2470,2624,-154
17593,b-3_3198-3278_3259.wav,VTTS_b-3_3198-3278_3259.wav,7220,6594,626
17594,b-2_713-814_789.wav,VTTS_b-2_713-814_789.wav,2900,3448,-548
17595,b-4_2000-5164_4528.wav,VTTS_b-4_2000-5164_4528.wav,5377,5433,-56
17596,b-4_2000-5164_4336.wav,VTTS_b-4_2000-5164_4336.wav,4538,5515,-977
17597,b-1_276-376_330.wav,VTTS_b-1_276-376_330.wav,1560,1416,144
17598,b-3_3889-4000_3904.wav,VTTS_b-3_3889-4000_3904.wav,1990,2009,-19
17599,b-3_98-195_157.wav,VTTS_b-3_98-195_157.wav,6590,6432,158
17600,b-3_6900-7016_6987.wav,VTTS_b-3_6900-7016_6987.wav,8510,8649,-139
17601,b-2_1427-1562_1516.wav,VTTS_b-2_1427-1562_1516.wav,1350,1207,143
17602,b-3_4207-4314_4249.wav,VTTS_b-3_4207-4314_4249.wav,7090,6351,739
17603,b-4_2000-5164_3372.wav,VTTS_b-4_2000-5164_3372.wav,4384,4528,-144
17604,b-1_2927-3025_3024.wav,VTTS_b-1_2927-3025_3024.wav,2470,2612,-142
17605,b-2_2209-2310_2245.wav,VTTS_b-2_2209-2310_2245.wav,4190,3158,1032
17606,b-3_1568-1665_1653.wav,VTTS_b-3_1568-1665_1653.wav,6760,6734,26
17607,b-1_3531-3631_3618.wav,VTTS_b-1_3531-3631_3618.wav,2530,2368,162
17608,b-4_2000-5164_2241.wav,VTTS_b-4_2000-5164_2241.wav,2475,2856,-381
17609,b-3_3025-3111_3031.wav,VTTS_b-3_3025-3111_3031.wav,4110,7059,-2949
17610,b-3_1321-1568_1386.wav,VTTS_b-3_1321-1568_1386.wav,2160,2055,105
17611,b-1_377-477_457.wav,VTTS_b-1_377-477_457.wav,1980,1904,76
17612,b-3_5009-5427_5066.wav,VTTS_b-3_5009-5427_5066.wav,3940,5770,-1830
17613,b-1_2725-2825_2732.wav,VTTS_b-1_2725-2825_2732.wav,1860,2009,-149
17614,b-1_1111-1211_1166.wav,VTTS_b-1_1111-1211_1166.wav,1560,1509,51
17615,b-3_392-500_469.wav,VTTS_b-3_392-500_469.wav,5520,5375,145
17616,b-2_1699-1800_1727.wav,VTTS_b-2_1699-1800_1727.wav,6160,7070,-910
17617,b-3_1321-1568_1467.wav,VTTS_b-3_1321-1568_1467.wav,5180,4807,373
17618,b-3_2524-2854_2848.wav,VTTS_b-3_2524-2854_2848.wav,7500,7256,244
17619,b-4_2000-5164_4053.wav,VTTS_b-4_2000-5164_4053.wav,1674,1533,141
17620,b-1_4394-4429_4395.wav,VTTS_b-1_4394-4429_4395.wav,4460,5863,-1403
17621,b-4_1506-1600_1525.wav,VTTS_b-4_1506-1600_1525.wav,1270,1126,144
17622,b-3_6900-7016_6928.wav,VTTS_b-3_6900-7016_6928.wav,5770,5538,232
17623,b-2_2073-2106_2097.wav,VTTS_b-2_2073-2106_2097.wav,1120,1057,63
17624,b-4_2000-5164_3526.wav,VTTS_b-4_2000-5164_3526.wav,2593,2891,-298
17625,b-1_579-649_586.wav,VTTS_b-1_579-649_586.wav,4120,3924,196
17626,b-1_794-1009_884.wav,VTTS_b-1_794-1009_884.wav,2690,2891,-201
17627,b-1_4358-4393_4363.wav,VTTS_b-1_4358-4393_4363.wav,3810,4644,-834
17628,b-3_1-97_66.wav,VTTS_b-3_1-97_66.wav,3050,2868,182
17629,b-4_2000-5164_4783.wav,VTTS_b-4_2000-5164_4783.wav,1917,1765,152
17630,b-4_2000-5164_2511.wav,VTTS_b-4_2000-5164_2511.wav,5210,6676,-1466
17631,b-1_579-649_608.wav,VTTS_b-1_579-649_608.wav,4070,4284,-214
17632,b-1_175-275_266.wav,VTTS_b-1_175-275_266.wav,1650,2043,-393
17633,b-3_5009-5427_5271.wav,VTTS_b-3_5009-5427_5271.wav,10710,10890,-180
17634,b-3_1666-1763_1676.wav,VTTS_b-3_1666-1763_1676.wav,5470,4574,896
17635,b-3_3538-3627_3577.wav,VTTS_b-3_3538-3627_3577.wav,6420,7105,-685
17636,b-3_501-930_848.wav,VTTS_b-3_501-930_848.wav,9920,9114,806
17637,b-4_2000-5164_2716.wav,VTTS_b-4_2000-5164_2716.wav,2630,2601,29
17638,b-1_2725-2825_2816.wav,VTTS_b-1_2725-2825_2816.wav,6530,6571,-41
17639,b-2_2209-2310_2254.wav,VTTS_b-2_2209-2310_2254.wav,2730,2786,-56
17640,b-1_794-1009_957.wav,VTTS_b-1_794-1009_957.wav,1950,3518,-1568
17641,b-1_4214-4285_4252.wav,VTTS_b-1_4214-4285_4252.wav,1160,1080,80
17642,b-3_6900-7016_6915.wav,VTTS_b-3_6900-7016_6915.wav,7210,6258,952
17643,b-3_5009-5427_5048.wav,VTTS_b-3_5009-5427_5048.wav,5660,6142,-482
17644,b-3_4607-5008_4879.wav,VTTS_b-3_4607-5008_4879.wav,5680,6385,-705
17645,b-1_794-1009_807.wav,VTTS_b-1_794-1009_807.wav,4480,4470,10
17646,b-4_53-150_134.wav,VTTS_b-4_53-150_134.wav,8030,8092,-62
17647,b-3_1321-1568_1363.wav,VTTS_b-3_1321-1568_1363.wav,7710,7628,82
17648,b-3_4425-4497_4471.wav,VTTS_b-3_4425-4497_4471.wav,4180,4458,-278
17649,b-3_5745-5852_5844.wav,VTTS_b-3_5745-5852_5844.wav,5630,5248,382
17650,b-1_2321-2421_2366.wav,VTTS_b-1_2321-2421_2366.wav,1210,998,212
17651,b-4_2000-5164_3911.wav,VTTS_b-4_2000-5164_3911.wav,4707,5236,-529
17652,b-3_98-195_117.wav,VTTS_b-3_98-195_117.wav,5920,5840,80
17653,b-4_2000-5164_4411.wav,VTTS_b-4_2000-5164_4411.wav,1886,2241,-355
17654,b-1_4358-4393_4369.wav,VTTS_b-1_4358-4393_4369.wav,1870,2043,-173
17655,b-1_794-1009_882.wav,VTTS_b-1_794-1009_882.wav,2770,2589,181
17656,b-1_3935-4033_3991.wav,VTTS_b-1_3935-4033_3991.wav,1450,1161,289
17657,b-3_2177-2266_2197.wav,VTTS_b-3_2177-2266_2197.wav,8900,11610,-2710
17658,b-3_196-293_245.wav,VTTS_b-3_196-293_245.wav,6620,6142,478
17659,b-1_794-1009_986.wav,VTTS_b-1_794-1009_986.wav,3620,3471,149
17660,b-4_151-300_199.wav,VTTS_b-4_151-300_199.wav,1780,1776,4
17661,b-1_175-275_268.wav,VTTS_b-1_175-275_268.wav,2220,3053,-833
17662,b-4_501-1014_537.wav,VTTS_b-4_501-1014_537.wav,3360,3088,272
17663,b-3_1666-1763_1749.wav,VTTS_b-3_1666-1763_1749.wav,5990,5770,220
17664,b-3_1321-1568_1405.wav,VTTS_b-3_1321-1568_1405.wav,2850,2171,679
17665,b-3_3538-3627_3547.wav,VTTS_b-3_3538-3627_3547.wav,6550,6014,536
17666,b-3_6601-6700_6605.wav,VTTS_b-3_6601-6700_6605.wav,5710,5294,416
17667,b-4_501-1014_710.wav,VTTS_b-4_501-1014_710.wav,1880,1846,34
17668,b-1_3329-3429_3367.wav,VTTS_b-1_3329-3429_3367.wav,1640,1811,-171
17669,b-3_3025-3111_3040.wav,VTTS_b-3_3025-3111_3040.wav,7860,6734,1126
17670,b-3_5009-5427_5283.wav,VTTS_b-3_5009-5427_5283.wav,4940,5364,-424
17671,b-3_196-293_201.wav,VTTS_b-3_196-293_201.wav,4350,4621,-271
17672,b-2_611-712_658.wav,VTTS_b-2_611-712_658.wav,1880,1962,-82
17673,b-1_2927-3025_2969.wav,VTTS_b-1_2927-3025_2969.wav,1280,1231,49
17674,b-4_2000-5164_4630.wav,VTTS_b-4_2000-5164_4630.wav,2548,2357,191
17675,b-1_2321-2421_2417.wav,VTTS_b-1_2321-2421_2417.wav,4600,4551,49
17676,b-3_3628-3714_3668.wav,VTTS_b-3_3628-3714_3668.wav,5510,5422,88
17677,b-4_151-300_180.wav,VTTS_b-4_151-300_180.wav,3650,3634,16
17678,b-4_1601-1706_1605.wav,VTTS_b-4_1601-1706_1605.wav,4140,4296,-156
17679,b-3_6016-6115_6115.wav,VTTS_b-3_6016-6115_6115.wav,8380,7953,427
17680,b-4_2000-5164_3314.wav,VTTS_b-4_2000-5164_3314.wav,1796,1579,217
17681,b-4_1101-1220_1111.wav,VTTS_b-4_1101-1220_1111.wav,8020,7686,334
17682,b-1_1717-1817_1724.wav,VTTS_b-1_1717-1817_1724.wav,1470,1405,65
17683,b-1_1-73_48.wav,VTTS_b-1_1-73_48.wav,2840,2287,553
17684,b-4_2000-5164_4051.wav,VTTS_b-4_2000-5164_4051.wav,7608,7070,538
17685,b-4_501-1014_984.wav,VTTS_b-4_501-1014_984.wav,4770,4458,312
17686,b-1_1212-1312_1223.wav,VTTS_b-1_1212-1312_1223.wav,3480,2949,531
17687,b-3_4207-4314_4269.wav,VTTS_b-3_4207-4314_4269.wav,7070,7012,58
17688,b-1_794-1009_975.wav,VTTS_b-1_794-1009_975.wav,2350,2299,51
17689,b-4_301-400_322.wav,VTTS_b-4_301-400_322.wav,9090,9381,-291
17690,b-3_501-930_782.wav,VTTS_b-3_501-930_782.wav,4110,4191,-81
17691,b-4_1901-2000_1909.wav,VTTS_b-4_1901-2000_1909.wav,4340,3971,369
17692,b-4_1014-1100_1029.wav,VTTS_b-4_1014-1100_1029.wav,7590,7616,-26
17693,b-3_2350-2433_2376.wav,VTTS_b-3_2350-2433_2376.wav,10770,9300,1470
17694,b-2_2311-2412_2361.wav,VTTS_b-2_2311-2412_2361.wav,1380,1335,45
17695,b-1_3228-3328_3323.wav,VTTS_b-1_3228-3328_3323.wav,1800,1881,-81
17696,b-4_2000-5164_2407.wav,VTTS_b-4_2000-5164_2407.wav,4300,5573,-1273
17697,b-3_3715-3802_3755.wav,VTTS_b-3_3715-3802_3755.wav,7890,7488,402
17698,b-3_5745-5852_5813.wav,VTTS_b-3_5745-5852_5813.wav,4540,5410,-870
17699,b-2_1019-1120_1041.wav,VTTS_b-2_1019-1120_1041.wav,2720,3460,-740
17700,b-1_2523-2623_2617.wav,VTTS_b-1_2523-2623_2617.wav,1300,1347,-47
17701,b-4_2000-5164_2759.wav,VTTS_b-4_2000-5164_2759.wav,4290,4400,-110
17702,b-4_2000-5164_4725.wav,VTTS_b-4_2000-5164_4725.wav,2371,2496,-125
17703,b-3_501-930_774.wav,VTTS_b-3_501-930_774.wav,8800,9474,-674
17704,b-1_1010-1110_1016.wav,VTTS_b-1_1010-1110_1016.wav,2960,2508,452
17705,b-3_4315-4424_4318.wav,VTTS_b-3_4315-4424_4318.wav,4960,4772,188
17706,b-1_794-1009_940.wav,VTTS_b-1_794-1009_940.wav,2600,2403,197
17707,b-2_611-712_701.wav,VTTS_b-2_611-712_701.wav,1480,1741,-261
17708,b-3_3628-3714_3686.wav,VTTS_b-3_3628-3714_3686.wav,7970,7721,249
17709,b-2_2209-2310_2215.wav,VTTS_b-2_2209-2310_2215.wav,2180,2032,148
17710,b-3_3538-3627_3551.wav,VTTS_b-3_3538-3627_3551.wav,5130,4505,625
17711,b-4_2000-5164_5031.wav,VTTS_b-4_2000-5164_5031.wav,3138,2856,282
17712,b-2_1801-1902_1865.wav,VTTS_b-2_1801-1902_1865.wav,2570,2902,-332
17713,b-3_3198-3278_3220.wav,VTTS_b-3_3198-3278_3220.wav,4830,4470,360
17714,b-1_1111-1211_1180.wav,VTTS_b-1_1111-1211_1180.wav,2180,3065,-885
17715,b-4_2000-5164_4323.wav,VTTS_b-4_2000-5164_4323.wav,7046,6734,312
17716,b-2_1903-2038_1938.wav,VTTS_b-2_1903-2038_1938.wav,1510,1521,-11
17717,b-3_2177-2266_2264.wav,VTTS_b-3_2177-2266_2264.wav,5930,5085,845
17718,b-3_2177-2266_2192.wav,VTTS_b-3_2177-2266_2192.wav,2600,2624,-24
17719,b-1_2422-2522_2442.wav,VTTS_b-1_2422-2522_2442.wav,2340,2995,-655
17720,b-4_2000-5164_3638.wav,VTTS_b-4_2000-5164_3638.wav,8082,8742,-660
17721,b-3_4607-5008_4622.wav,VTTS_b-3_4607-5008_4622.wav,7060,6594,466
17722,b-1_686-793_710.wav,VTTS_b-1_686-793_710.wav,2560,2229,331
17723,b-3_2524-2854_2531.wav,VTTS_b-3_2524-2854_2531.wav,4010,3947,63
17724,b-3_5009-5427_5018.wav,VTTS_b-3_5009-5427_5018.wav,3220,3692,-472
17725,b-3_5745-5852_5752.wav,VTTS_b-3_5745-5852_5752.wav,3960,3843,117
17726,b-3_1666-1763_1759.wav,VTTS_b-3_1666-1763_1759.wav,4390,4342,48
17727,b-2_713-814_792.wav,VTTS_b-2_713-814_792.wav,2450,2786,-336
17728,b-3_3803-3888_3879.wav,VTTS_b-3_3803-3888_3879.wav,2000,1695,305
17729,b-3_6401-6500_6428.wav,VTTS_b-3_6401-6500_6428.wav,5300,4586,714
17730,b-3_1079-1320_1227.wav,VTTS_b-3_1079-1320_1227.wav,2910,2833,77
17731,b-4_2000-5164_4960.wav,VTTS_b-4_2000-5164_4960.wav,5911,6989,-1078
17732,b-4_2000-5164_5051.wav,VTTS_b-4_2000-5164_5051.wav,2259,2055,204
17733,b-4_2000-5164_4173.wav,VTTS_b-4_2000-5164_4173.wav,7564,6327,1237
17734,b-1_794-1009_867.wav,VTTS_b-1_794-1009_867.wav,1340,1579,-239
17735,b-3_2855-2942_2871.wav,VTTS_b-3_2855-2942_2871.wav,3170,3228,-58
17736,b-3_4607-5008_4792.wav,VTTS_b-3_4607-5008_4792.wav,3920,4261,-341
17737,b-1_2119-2219_2189.wav,VTTS_b-1_2119-2219_2189.wav,3380,3146,234
17738,b-4_151-300_295.wav,VTTS_b-4_151-300_295.wav,12060,10925,1135
17739,b-3_98-195_152.wav,VTTS_b-3_98-195_152.wav,3530,3077,453
17740,b-2_815-916_844.wav,VTTS_b-2_815-916_844.wav,1340,1405,-65
17741,b-4_2000-5164_4882.wav,VTTS_b-4_2000-5164_4882.wav,6392,6385,7
17742,b-3_1862-1959_1897.wav,VTTS_b-3_1862-1959_1897.wav,7320,6548,772
17743,b-1_1414-1514_1468.wav,VTTS_b-1_1414-1514_1468.wav,2840,3158,-318
17744,b-1_686-793_765.wav,VTTS_b-1_686-793_765.wav,1690,1776,-86
17745,b-3_5853-5956_5878.wav,VTTS_b-3_5853-5956_5878.wav,10810,9845,965
17746,b-4_2000-5164_4545.wav,VTTS_b-4_2000-5164_4545.wav,4968,5190,-222
17747,b-3_3628-3714_3659.wav,VTTS_b-3_3628-3714_3659.wav,6390,6548,-158
17748,b-3_6701-6800_6717.wav,VTTS_b-3_6701-6800_6717.wav,3500,3820,-320
17749,b-4_501-1014_515.wav,VTTS_b-4_501-1014_515.wav,1680,1672,8
17750,b-4_2000-5164_2498.wav,VTTS_b-4_2000-5164_2498.wav,3505,3587,-82
17751,b-4_1901-2000_1992.wav,VTTS_b-4_1901-2000_1992.wav,4550,4644,-94
17752,b-3_1764-1861_1832.wav,VTTS_b-3_1764-1861_1832.wav,6520,8139,-1619
17753,b-1_3632-3732_3674.wav,VTTS_b-1_3632-3732_3674.wav,4300,4609,-309
17754,b-4_2000-5164_4007.wav,VTTS_b-4_2000-5164_4007.wav,4058,3796,262
17755,b-1_1515-1615_1605.wav,VTTS_b-1_1515-1615_1605.wav,1660,1649,11
17756,b-3_3803-3888_3864.wav,VTTS_b-3_3803-3888_3864.wav,8390,8231,159
17757,b-2_1801-1902_1863.wav,VTTS_b-2_1801-1902_1863.wav,2280,2009,271
17758,b-2_1903-2038_1940.wav,VTTS_b-2_1903-2038_1940.wav,1270,1521,-251
17759,b-2_1801-1902_1900.wav,VTTS_b-2_1801-1902_1900.wav,1920,1800,120
17760,b-4_501-1014_685.wav,VTTS_b-4_501-1014_685.wav,5240,6153,-913
17761,b-4_301-400_316.wav,VTTS_b-4_301-400_316.wav,10050,10879,-829
17762,b-3_6016-6115_6047.wav,VTTS_b-3_6016-6115_6047.wav,2650,2392,258
17763,b-3_5428-5533_5518.wav,VTTS_b-3_5428-5533_5518.wav,5780,6095,-315
17764,b-1_2220-2320_2260.wav,VTTS_b-1_2220-2320_2260.wav,1940,1811,129
17765,b-3_501-930_604.wav,VTTS_b-3_501-930_604.wav,7190,6920,270
17766,b-4_2000-5164_3110.wav,VTTS_b-4_2000-5164_3110.wav,3396,3228,168
17767,b-4_1221-1300_1280.wav,VTTS_b-4_1221-1300_1280.wav,5490,5294,196
17768,b-3_4607-5008_4995.wav,VTTS_b-3_4607-5008_4995.wav,8430,7024,1406
17769,b-1_1515-1615_1595.wav,VTTS_b-1_1515-1615_1595.wav,1070,998,72
17770,b-3_3112-3197_3146.wav,VTTS_b-3_3112-3197_3146.wav,7850,8313,-463
17771,b-4_1901-2000_1915.wav,VTTS_b-4_1901-2000_1915.wav,4350,3924,426
17772,b-4_2000-5164_3999.wav,VTTS_b-4_2000-5164_3999.wav,5266,5143,123
17773,b-4_2000-5164_3129.wav,VTTS_b-4_2000-5164_3129.wav,4733,4423,310
17774,b-2_1-100_28.wav,VTTS_b-2_1-100_28.wav,2100,3982,-1882
17775,b-4_2000-5164_4068.wav,VTTS_b-4_2000-5164_4068.wav,3161,2868,293
17776,b-4_2000-5164_5130.wav,VTTS_b-4_2000-5164_5130.wav,5855,5793,62
17777,b-3_6217-6274_6235.wav,VTTS_b-3_6217-6274_6235.wav,2690,2844,-154
17778,b-3_1321-1568_1399.wav,VTTS_b-3_1321-1568_1399.wav,6220,5619,601
17779,b-3_1321-1568_1559.wav,VTTS_b-3_1321-1568_1559.wav,4290,4423,-133
17780,b-1_650-685_660.wav,VTTS_b-1_650-685_660.wav,3390,4656,-1266
17781,b-2_815-916_826.wav,VTTS_b-2_815-916_826.wav,2330,2125,205
17782,b-4_2000-5164_3700.wav,VTTS_b-4_2000-5164_3700.wav,860,673,187
17783,b-3_3279-3363_3323.wav,VTTS_b-3_3279-3363_3323.wav,6030,6409,-379
17784,b-1_2725-2825_2752.wav,VTTS_b-1_2725-2825_2752.wav,3180,3471,-291
17785,b-1_1111-1211_1113.wav,VTTS_b-1_1111-1211_1113.wav,1990,1382,608
17786,b-2_1325-1426_1388.wav,VTTS_b-2_1325-1426_1388.wav,6850,8197,-1347
17787,b-2_2194-2208_2197.wav,VTTS_b-2_2194-2208_2197.wav,1920,2043,-123
17788,b-1_175-275_207.wav,VTTS_b-1_175-275_207.wav,3980,4296,-316
17789,b-1_3329-3429_3412.wav,VTTS_b-1_3329-3429_3412.wav,2090,1892,198
17790,b-3_392-500_486.wav,VTTS_b-3_392-500_486.wav,2590,2426,164
17791,b-4_501-1014_656.wav,VTTS_b-4_501-1014_656.wav,2190,2090,100
17792,b-3_2089-2176_2119.wav,VTTS_b-3_2089-2176_2119.wav,7430,7036,394
17793,b-4_2000-5164_2216.wav,VTTS_b-4_2000-5164_2216.wav,3200,3820,-620
17794,b-3_98-195_110.wav,VTTS_b-3_98-195_110.wav,6600,6014,586
17795,b-2_2311-2412_2326.wav,VTTS_b-2_2311-2412_2326.wav,2580,3587,-1007
17796,b-4_2000-5164_4118.wav,VTTS_b-4_2000-5164_4118.wav,3266,3193,73
17797,b-1_4178-4213_4211.wav,VTTS_b-1_4178-4213_4211.wav,1540,1567,-27
17798,b-2_2107-2193_2187.wav,VTTS_b-2_2107-2193_2187.wav,2190,2206,-16
17799,b-3_5009-5427_5335.wav,VTTS_b-3_5009-5427_5335.wav,8020,7628,392
17800,b-3_4607-5008_4955.wav,VTTS_b-3_4607-5008_4955.wav,5020,11610,-6590
17801,b-3_4425-4497_4477.wav,VTTS_b-3_4425-4497_4477.wav,4890,4760,130
17802,b-1_3228-3328_3325.wav,VTTS_b-1_3228-3328_3325.wav,2570,2740,-170
17803,b-4_2000-5164_2090.wav,VTTS_b-4_2000-5164_2090.wav,4820,5329,-509
17804,b-1_2523-2623_2577.wav,VTTS_b-1_2523-2623_2577.wav,1980,1974,6
17805,b-3_2177-2266_2224.wav,VTTS_b-3_2177-2266_2224.wav,4150,4261,-111
17806,b-3_5428-5533_5476.wav,VTTS_b-3_5428-5533_5476.wav,3610,3704,-94
17807,b-3_501-930_845.wav,VTTS_b-3_501-930_845.wav,4610,4447,163
17808,b-4_2000-5164_3300.wav,VTTS_b-4_2000-5164_3300.wav,5713,6327,-614
17809,b-3_6301-6400_6302.wav,VTTS_b-3_6301-6400_6302.wav,3090,3146,-56
17810,b-2_1121-1222_1137.wav,VTTS_b-2_1121-1222_1137.wav,1620,1521,99
17811,b-3_2434-2523_2517.wav,VTTS_b-3_2434-2523_2517.wav,6170,6351,-181
17812,b-4_2000-5164_3908.wav,VTTS_b-4_2000-5164_3908.wav,5405,5492,-87
17813,b-3_2434-2523_2446.wav,VTTS_b-3_2434-2523_2446.wav,4080,4180,-100
17814,b-2_1597-1698_1637.wav,VTTS_b-2_1597-1698_1637.wav,3230,2949,281
17815,b-2_2107-2193_2119.wav,VTTS_b-2_2107-2193_2119.wav,3320,4261,-941
17816,b-4_2000-5164_4488.wav,VTTS_b-4_2000-5164_4488.wav,3631,3262,369
17817,b-4_501-1014_585.wav,VTTS_b-4_501-1014_585.wav,8490,7779,711
17818,b-2_407-508_423.wav,VTTS_b-2_407-508_423.wav,1890,1881,9
17819,b-1_2624-2724_2645.wav,VTTS_b-1_2624-2724_2645.wav,1810,1579,231
17820,b-3_6801-6900_6823.wav,VTTS_b-3_6801-6900_6823.wav,8220,7651,569
17821,b-1_3531-3631_3547.wav,VTTS_b-1_3531-3631_3547.wav,1310,1358,-48
17822,b-4_151-300_208.wav,VTTS_b-4_151-300_208.wav,4770,4563,207
17823,b-4_1601-1706_1633.wav,VTTS_b-4_1601-1706_1633.wav,2060,2403,-343
17824,b-3_6900-7016_6916.wav,VTTS_b-3_6900-7016_6916.wav,8590,8870,-280
17825,b-2_1019-1120_1051.wav,VTTS_b-2_1019-1120_1051.wav,2960,2705,255
17826,b-1_1212-1312_1245.wav,VTTS_b-1_1212-1312_1245.wav,1450,1393,57
17827,b-1_2119-2219_2135.wav,VTTS_b-1_2119-2219_2135.wav,2290,2438,-148
17828,b-1_579-649_627.wav,VTTS_b-1_579-649_627.wav,4120,3855,265
17829,b-4_2000-5164_2737.wav,VTTS_b-4_2000-5164_2737.wav,3995,4017,-22
17830,b-3_5009-5427_5036.wav,VTTS_b-3_5009-5427_5036.wav,1530,1474,56
17831,b-1_1414-1514_1501.wav,VTTS_b-1_1414-1514_1501.wav,2520,2531,-11
17832,b-4_2000-5164_2338.wav,VTTS_b-4_2000-5164_2338.wav,5450,5248,202
17833,b-2_1903-2038_1997.wav,VTTS_b-2_1903-2038_1997.wav,3450,2972,478
17834,b-4_2000-5164_2393.wav,VTTS_b-4_2000-5164_2393.wav,4300,4226,74
17835,b-2_2311-2412_2397.wav,VTTS_b-2_2311-2412_2397.wav,1840,1730,110
17836,b-3_2000-2088_2070.wav,VTTS_b-3_2000-2088_2070.wav,4440,4284,156
17837,b-1_3329-3429_3386.wav,VTTS_b-1_3329-3429_3386.wav,4770,5619,-849
17838,b-4_2000-5164_4244.wav,VTTS_b-4_2000-5164_4244.wav,2903,2868,35
17839,b-3_5009-5427_5420.wav,VTTS_b-3_5009-5427_5420.wav,2630,2914,-284
17840,b-2_1427-1562_1472.wav,VTTS_b-2_1427-1562_1472.wav,3210,2972,238
17841,b-3_5009-5427_5295.wav,VTTS_b-3_5009-5427_5295.wav,8530,11610,-3080
17842,b-3_1862-1959_1935.wav,VTTS_b-3_1862-1959_1935.wav,2990,3170,-180
17843,b-3_4607-5008_4777.wav,VTTS_b-3_4607-5008_4777.wav,4290,3959,331
17844,b-1_3228-3328_3232.wav,VTTS_b-1_3228-3328_3232.wav,1870,2485,-615
17845,b-3_2524-2854_2664.wav,VTTS_b-3_2524-2854_2664.wav,2620,2496,124
17846,b-3_1666-1763_1748.wav,VTTS_b-3_1666-1763_1748.wav,6270,7245,-975
17847,b-1_1313-1413_1357.wav,VTTS_b-1_1313-1413_1357.wav,4860,4679,181
17848,b-2_611-712_618.wav,VTTS_b-2_611-712_618.wav,2620,2543,77
17849,b-4_2000-5164_2804.wav,VTTS_b-4_2000-5164_2804.wav,3200,3135,65
17850,b-3_501-930_747.wav,VTTS_b-3_501-930_747.wav,2410,3971,-1561
17851,b-3_4607-5008_4839.wav,VTTS_b-3_4607-5008_4839.wav,3010,3065,-55
17852,b-3_2524-2854_2836.wav,VTTS_b-3_2524-2854_2836.wav,4780,5108,-328
17853,b-1_2826-2926_2854.wav,VTTS_b-1_2826-2926_2854.wav,3710,4470,-760
17854,b-1_4214-4285_4255.wav,VTTS_b-1_4214-4285_4255.wav,3090,3239,-149
17855,b-1_1313-1413_1398.wav,VTTS_b-1_1313-1413_1398.wav,5070,4598,472
17856,b-3_4104-4206_4194.wav,VTTS_b-3_4104-4206_4194.wav,2770,2496,274
17857,b-3_1666-1763_1700.wav,VTTS_b-3_1666-1763_1700.wav,9370,9404,-34
17858,b-3_3889-4000_3975.wav,VTTS_b-3_3889-4000_3975.wav,3160,3262,-102
17859,b-3_4607-5008_4868.wav,VTTS_b-3_4607-5008_4868.wav,1560,1683,-123
17860,b-4_2000-5164_4300.wav,VTTS_b-4_2000-5164_4300.wav,2613,2833,-220
17861,b-4_1506-1600_1556.wav,VTTS_b-4_1506-1600_1556.wav,6940,6850,90
17862,b-1_4034-4069_4045.wav,VTTS_b-1_4034-4069_4045.wav,1460,1672,-212
17863,b-1_3531-3631_3620.wav,VTTS_b-1_3531-3631_3620.wav,1860,1916,-56
17864,b-4_2000-5164_4103.wav,VTTS_b-4_2000-5164_4103.wav,3486,3274,212
17865,b-2_1563-1596_1572.wav,VTTS_b-2_1563-1596_1572.wav,6510,8231,-1721
17866,b-3_4207-4314_4244.wav,VTTS_b-3_4207-4314_4244.wav,7350,6815,535
17867,b-1_1515-1615_1584.wav,VTTS_b-1_1515-1615_1584.wav,1270,1347,-77
17868,b-4_2000-5164_4159.wav,VTTS_b-4_2000-5164_4159.wav,4979,5979,-1000
17869,b-3_5009-5427_5162.wav,VTTS_b-3_5009-5427_5162.wav,2360,2821,-461
17870,b-3_2000-2088_2053.wav,VTTS_b-3_2000-2088_2053.wav,4560,4458,102
17871,b-3_6501-6600_6571.wav,VTTS_b-3_6501-6600_6571.wav,910,801,109
17872,b-1_686-793_736.wav,VTTS_b-1_686-793_736.wav,1880,1858,22
17873,b-3_4001-4103_4059.wav,VTTS_b-3_4001-4103_4059.wav,4470,4853,-383
17874,b-4_2000-5164_2207.wav,VTTS_b-4_2000-5164_2207.wav,2910,3204,-294
17875,b-1_175-275_205.wav,VTTS_b-1_175-275_205.wav,3450,3425,25
17876,b-2_1427-1562_1528.wav,VTTS_b-2_1427-1562_1528.wav,6470,6653,-183
17877,b-1_3127-3227_3157.wav,VTTS_b-1_3127-3227_3157.wav,4050,4621,-571
17878,b-1_1919-2017_2003.wav,VTTS_b-1_1919-2017_2003.wav,1480,1428,52
17879,b-4_1901-2000_1946.wav,VTTS_b-4_1901-2000_1946.wav,2680,2218,462
17880,b-3_5428-5533_5447.wav,VTTS_b-3_5428-5533_5447.wav,4870,4656,214
17881,b-2_2107-2193_2127.wav,VTTS_b-2_2107-2193_2127.wav,2000,2659,-659
17882,b-1_3834-3934_3894.wav,VTTS_b-1_3834-3934_3894.wav,3320,4284,-964
17883,b-4_2000-5164_4033.wav,VTTS_b-4_2000-5164_4033.wav,6303,6896,-593
17884,b-1_794-1009_928.wav,VTTS_b-1_794-1009_928.wav,2500,2485,15
17885,b-1_74-174_132.wav,VTTS_b-1_74-174_132.wav,2210,2287,-77
17886,b-2_2209-2310_2249.wav,VTTS_b-2_2209-2310_2249.wav,2120,1927,193
17887,b-4_2000-5164_3272.wav,VTTS_b-4_2000-5164_3272.wav,3389,3646,-257
17888,b-1_1-73_60.wav,VTTS_b-1_1-73_60.wav,2530,2577,-47
17889,b-3_294-391_369.wav,VTTS_b-3_294-391_369.wav,2900,2717,183
17890,b-1_2422-2522_2513.wav,VTTS_b-1_2422-2522_2513.wav,2230,2101,129
17891,b-4_151-300_175.wav,VTTS_b-4_151-300_175.wav,5680,5666,14
17892,b-4_2000-5164_2932.wav,VTTS_b-4_2000-5164_2932.wav,2946,3344,-398
17893,b-3_501-930_735.wav,VTTS_b-3_501-930_735.wav,5080,4807,273
17894,b-1_2119-2219_2199.wav,VTTS_b-1_2119-2219_2199.wav,3840,5677,-1837
17895,b-1_2422-2522_2452.wav,VTTS_b-1_2422-2522_2452.wav,2740,4272,-1532
17896,b-3_5533-5638_5550.wav,VTTS_b-3_5533-5638_5550.wav,3030,5840,-2810
17897,b-2_1563-1596_1579.wav,VTTS_b-2_1563-1596_1579.wav,7910,7442,468
17898,b-1_1717-1817_1746.wav,VTTS_b-1_1717-1817_1746.wav,3000,2241,759
17899,b-4_1014-1100_1039.wav,VTTS_b-4_1014-1100_1039.wav,3740,4017,-277
17900,b-4_2000-5164_4770.wav,VTTS_b-4_2000-5164_4770.wav,3042,2949,93
17901,b-1_686-793_693.wav,VTTS_b-1_686-793_693.wav,3330,3599,-269
17902,b-3_1764-1861_1814.wav,VTTS_b-3_1764-1861_1814.wav,2900,2624,276
17903,b-4_1601-1706_1630.wav,VTTS_b-4_1601-1706_1630.wav,3030,2450,580
17904,b-3_6701-6800_6773.wav,VTTS_b-3_6701-6800_6773.wav,4220,4470,-250
17905,b-4_2000-5164_2077.wav,VTTS_b-4_2000-5164_2077.wav,4915,4946,-31
17906,b-1_276-376_359.wav,VTTS_b-1_276-376_359.wav,1650,1474,176
17907,b-3_931-979_932.wav,VTTS_b-3_931-979_932.wav,7140,9207,-2067
17908,b-1_74-174_130.wav,VTTS_b-1_74-174_130.wav,1420,1324,96
17909,b-4_2000-5164_4222.wav,VTTS_b-4_2000-5164_4222.wav,4610,9137,-4527
17910,b-1_1313-1413_1370.wav,VTTS_b-1_1313-1413_1370.wav,1230,1033,197
17911,b-1_3127-3227_3150.wav,VTTS_b-1_3127-3227_3150.wav,3400,3808,-408
17912,b-3_4607-5008_4999.wav,VTTS_b-3_4607-5008_4999.wav,8430,7697,733
17913,b-3_392-500_422.wav,VTTS_b-3_392-500_422.wav,4580,4470,110
17914,b-2_2194-2208_2203.wav,VTTS_b-2_2194-2208_2203.wav,2000,2148,-148
17915,b-3_4607-5008_4917.wav,VTTS_b-3_4607-5008_4917.wav,6330,5933,397
17916,b-2_2413-2500_2428.wav,VTTS_b-2_2413-2500_2428.wav,1920,1695,225
17917,b-1_2321-2421_2363.wav,VTTS_b-1_2321-2421_2363.wav,3060,2937,123
17918,b-3_1862-1959_1904.wav,VTTS_b-3_1862-1959_1904.wav,4080,3878,202
17919,b-1_3834-3934_3864.wav,VTTS_b-1_3834-3934_3864.wav,1780,2043,-263
17920,b-3_2524-2854_2582.wav,VTTS_b-3_2524-2854_2582.wav,3560,3297,263
17921,b-1_2624-2724_2695.wav,VTTS_b-1_2624-2724_2695.wav,1680,1602,78
17922,b-2_509-610_583.wav,VTTS_b-2_509-610_583.wav,2390,3193,-803
17923,b-3_4607-5008_4623.wav,VTTS_b-3_4607-5008_4623.wav,2820,2717,103
17924,b-3_3279-3363_3302.wav,VTTS_b-3_3279-3363_3302.wav,5500,5700,-200
17925,b-3_392-500_400.wav,VTTS_b-3_392-500_400.wav,5200,5074,126
17926,b-4_2000-5164_2531.wav,VTTS_b-4_2000-5164_2531.wav,10815,9985,830
17927,b-3_6801-6900_6825.wav,VTTS_b-3_6801-6900_6825.wav,13470,11610,1860
17928,b-3_1079-1320_1186.wav,VTTS_b-3_1079-1320_1186.wav,3400,3262,138
17929,b-4_2000-5164_2887.wav,VTTS_b-4_2000-5164_2887.wav,9590,9242,348
17930,b-4_2000-5164_3645.wav,VTTS_b-4_2000-5164_3645.wav,4586,4098,488
17931,b-3_2350-2433_2422.wav,VTTS_b-3_2350-2433_2422.wav,4140,3332,808
17932,b-3_4607-5008_4954.wav,VTTS_b-3_4607-5008_4954.wav,5300,5155,145
17933,b-1_794-1009_849.wav,VTTS_b-1_794-1009_849.wav,4250,3924,326
17934,b-2_2107-2193_2164.wav,VTTS_b-2_2107-2193_2164.wav,1590,1962,-372
17935,b-1_4466-4498_4490.wav,VTTS_b-1_4466-4498_4490.wav,2950,2786,164
17936,b-1_2927-3025_3013.wav,VTTS_b-1_2927-3025_3013.wav,2800,3135,-335
17937,b-4_2000-5164_3601.wav,VTTS_b-4_2000-5164_3601.wav,2555,2752,-197
17938,b-4_2000-5164_4420.wav,VTTS_b-4_2000-5164_4420.wav,951,940,11
17939,b-3_98-195_125.wav,VTTS_b-3_98-195_125.wav,3080,3913,-833
17940,b-4_2000-5164_4477.wav,VTTS_b-4_2000-5164_4477.wav,11317,11610,-293
17941,b-3_2089-2176_2147.wav,VTTS_b-3_2089-2176_2147.wav,6680,5584,1096
17942,b-3_1321-1568_1558.wav,VTTS_b-3_1321-1568_1558.wav,4360,4098,262
17943,b-1_74-174_142.wav,VTTS_b-1_74-174_142.wav,3020,3170,-150
17944,b-1_2220-2320_2319.wav,VTTS_b-1_2220-2320_2319.wav,2670,2995,-325
17945,b-2_2209-2310_2300.wav,VTTS_b-2_2209-2310_2300.wav,2350,2218,132
17946,b-3_931-979_949.wav,VTTS_b-3_931-979_949.wav,7410,10240,-2830
17947,b-4_2000-5164_3761.wav,VTTS_b-4_2000-5164_3761.wav,3440,3680,-240
17948,b-4_1101-1220_1174.wav,VTTS_b-4_1101-1220_1174.wav,3820,3901,-81
17949,b-3_6601-6700_6667.wav,VTTS_b-3_6601-6700_6667.wav,2370,2252,118
17950,b-3_4607-5008_4803.wav,VTTS_b-3_4607-5008_4803.wav,6210,6420,-210
17951,b-3_501-930_686.wav,VTTS_b-3_501-930_686.wav,3320,3402,-82
17952,b-4_501-1014_942.wav,VTTS_b-4_501-1014_942.wav,6580,6397,183
17953,b-4_2000-5164_2463.wav,VTTS_b-4_2000-5164_2463.wav,7700,6397,1303
17954,b-3_4607-5008_4648.wav,VTTS_b-3_4607-5008_4648.wav,2810,2728,82
17955,b-4_2000-5164_2417.wav,VTTS_b-4_2000-5164_2417.wav,2240,2171,69
17956,b-4_1401-1505_1425.wav,VTTS_b-4_1401-1505_1425.wav,5360,5108,252
17957,b-2_2311-2412_2362.wav,VTTS_b-2_2311-2412_2362.wav,3010,2902,108
17958,b-3_6900-7016_6968.wav,VTTS_b-3_6900-7016_6968.wav,4270,3646,624
17959,b-3_1568-1665_1613.wav,VTTS_b-3_1568-1665_1613.wav,2840,2694,146
17960,b-3_4607-5008_4646.wav,VTTS_b-3_4607-5008_4646.wav,4960,5178,-218
17961,b-4_2000-5164_2058.wav,VTTS_b-4_2000-5164_2058.wav,5410,5886,-476
17962,b-3_6900-7016_6988.wav,VTTS_b-3_6900-7016_6988.wav,3200,3425,-225
17963,b-3_1-97_14.wav,VTTS_b-3_1-97_14.wav,8230,7767,463
17964,b-2_1563-1596_1574.wav,VTTS_b-2_1563-1596_1574.wav,2710,2995,-285
17965,b-4_401-500_472.wav,VTTS_b-4_401-500_472.wav,3840,6107,-2267
17966,b-3_1666-1763_1689.wav,VTTS_b-3_1666-1763_1689.wav,10770,10182,588
17967,b-4_2000-5164_3941.wav,VTTS_b-4_2000-5164_3941.wav,5919,5236,683
17968,b-3_4425-4497_4458.wav,VTTS_b-3_4425-4497_4458.wav,3420,3471,-51
17969,b-4_2000-5164_2567.wav,VTTS_b-4_2000-5164_2567.wav,9500,9474,26
17970,b-3_6900-7016_7006.wav,VTTS_b-3_6900-7016_7006.wav,4040,3228,812
17971,b-3_1079-1320_1222.wav,VTTS_b-3_1079-1320_1222.wav,4250,11610,-7360
17972,b-1_1818-1918_1846.wav,VTTS_b-1_1818-1918_1846.wav,1910,1637,273
17973,b-3_3889-4000_3983.wav,VTTS_b-3_3889-4000_3983.wav,3760,3727,33
17974,b-1_3329-3429_3362.wav,VTTS_b-1_3329-3429_3362.wav,2640,3541,-901
17975,b-3_5009-5427_5252.wav,VTTS_b-3_5009-5427_5252.wav,9170,8591,579
17976,b-2_2209-2310_2237.wav,VTTS_b-2_2209-2310_2237.wav,1440,1045,395
17977,b-1_4286-4321_4305.wav,VTTS_b-1_4286-4321_4305.wav,3190,2810,380
17978,b-4_1601-1706_1616.wav,VTTS_b-4_1601-1706_1616.wav,4900,5143,-243
17979,b-3_2000-2088_2050.wav,VTTS_b-3_2000-2088_2050.wav,5240,5143,97
17980,b-1_276-376_322.wav,VTTS_b-1_276-376_322.wav,2900,3460,-560
17981,b-4_151-300_169.wav,VTTS_b-4_151-300_169.wav,5240,4888,352
17982,b-4_2000-5164_3323.wav,VTTS_b-4_2000-5164_3323.wav,2465,2276,189
17983,b-1_74-174_87.wav,VTTS_b-1_74-174_87.wav,1400,1231,169
17984,b-3_294-391_344.wav,VTTS_b-3_294-391_344.wav,4160,4214,-54
17985,b-3_1666-1763_1667.wav,VTTS_b-3_1666-1763_1667.wav,7430,7988,-558
17986,b-4_2000-5164_3838.wav,VTTS_b-4_2000-5164_3838.wav,2877,2926,-49
17987,b-2_2209-2310_2251.wav,VTTS_b-2_2209-2310_2251.wav,1540,1347,193
17988,b-4_2000-5164_5153.wav,VTTS_b-4_2000-5164_5153.wav,4820,4946,-126
17989,b-2_1-100_69.wav,VTTS_b-2_1-100_69.wav,1450,1823,-373
17990,b-4_1814-1900_1821.wav,VTTS_b-4_1814-1900_1821.wav,2080,1904,176
17991,b-3_6701-6800_6732.wav,VTTS_b-3_6701-6800_6732.wav,5690,7187,-1497
17992,b-4_401-500_470.wav,VTTS_b-4_401-500_470.wav,5150,5108,42
17993,b-2_1903-2038_2028.wav,VTTS_b-2_1903-2038_2028.wav,1280,1265,15
17994,b-3_5853-5956_5892.wav,VTTS_b-3_5853-5956_5892.wav,3790,4029,-239
17995,b-3_5009-5427_5131.wav,VTTS_b-3_5009-5427_5131.wav,5410,5259,151
17996,b-4_2000-5164_2174.wav,VTTS_b-4_2000-5164_2174.wav,4440,4911,-471
17997,b-4_2000-5164_3019.wav,VTTS_b-4_2000-5164_3019.wav,5222,5236,-14
17998,b-4_151-300_283.wav,VTTS_b-4_151-300_283.wav,6490,6165,325
17999,b-2_611-712_675.wav,VTTS_b-2_611-712_675.wav,3820,3216,604
18000,b-1_2321-2421_2392.wav,VTTS_b-1_2321-2421_2392.wav,1310,1277,33
18001,b-3_501-930_529.wav,VTTS_b-3_501-930_529.wav,8500,7605,895
18002,b-1_4358-4393_4371.wav,VTTS_b-1_4358-4393_4371.wav,2650,2682,-32
18003,b-1_4322-4357_4340.wav,VTTS_b-1_4322-4357_4340.wav,1700,1846,-146
18004,b-4_1301-1400_1331.wav,VTTS_b-4_1301-1400_1331.wav,4090,5027,-937
18005,b-2_1427-1562_1482.wav,VTTS_b-2_1427-1562_1482.wav,2700,2961,-261
18006,b-1_2422-2522_2496.wav,VTTS_b-1_2422-2522_2496.wav,2710,3495,-785
18007,b-1_1818-1918_1865.wav,VTTS_b-1_1818-1918_1865.wav,1150,1196,-46
18008,b-3_1079-1320_1285.wav,VTTS_b-3_1079-1320_1285.wav,12760,11610,1150
18009,b-3_5745-5852_5834.wav,VTTS_b-3_5745-5852_5834.wav,4910,5155,-245
18010,b-4_1014-1100_1076.wav,VTTS_b-4_1014-1100_1076.wav,4960,5016,-56
18011,b-2_1-100_93.wav,VTTS_b-2_1-100_93.wav,2970,2879,91
18012,b-4_1301-1400_1397.wav,VTTS_b-4_1301-1400_1397.wav,4410,4238,172
18013,b-3_5009-5427_5269.wav,VTTS_b-3_5009-5427_5269.wav,13130,11146,1984
18014,b-3_4607-5008_4778.wav,VTTS_b-3_4607-5008_4778.wav,4520,4807,-287
18015,b-1_1515-1615_1578.wav,VTTS_b-1_1515-1615_1578.wav,1130,1173,-43
18016,b-1_2119-2219_2157.wav,VTTS_b-1_2119-2219_2157.wav,3110,2902,208
18017,b-4_2000-5164_4423.wav,VTTS_b-4_2000-5164_4423.wav,4038,5074,-1036
18018,b-3_2524-2854_2644.wav,VTTS_b-3_2524-2854_2644.wav,4160,4110,50
18019,b-3_6016-6115_6103.wav,VTTS_b-3_6016-6115_6103.wav,5420,4714,706
18020,b-4_401-500_415.wav,VTTS_b-4_401-500_415.wav,11810,10844,966
18021,b-1_1616-1716_1669.wav,VTTS_b-1_1616-1716_1669.wav,3340,3286,54
18022,b-3_4607-5008_4838.wav,VTTS_b-3_4607-5008_4838.wav,4020,4145,-125
18023,b-4_2000-5164_3494.wav,VTTS_b-4_2000-5164_3494.wav,4937,5700,-763
18024,b-1_1919-2017_2010.wav,VTTS_b-1_1919-2017_2010.wav,1990,1858,132
18025,b-3_392-500_471.wav,VTTS_b-3_392-500_471.wav,5740,5991,-251
18026,b-2_815-916_852.wav,VTTS_b-2_815-916_852.wav,2660,2252,408
18027,b-2_611-712_625.wav,VTTS_b-2_611-712_625.wav,1250,1312,-62
18028,b-4_2000-5164_4098.wav,VTTS_b-4_2000-5164_4098.wav,3530,3855,-325
18029,b-3_6900-7016_6984.wav,VTTS_b-3_6900-7016_6984.wav,1030,894,136
18030,b-4_2000-5164_2344.wav,VTTS_b-4_2000-5164_2344.wav,5290,5294,-4
18031,b-3_6501-6600_6570.wav,VTTS_b-3_6501-6600_6570.wav,4980,5805,-825
18032,b-3_2524-2854_2791.wav,VTTS_b-3_2524-2854_2791.wav,3870,3971,-101
18033,b-1_4034-4069_4049.wav,VTTS_b-1_4034-4069_4049.wav,2350,2461,-111
18034,b-3_4607-5008_5006.wav,VTTS_b-3_4607-5008_5006.wav,3000,2310,690
18035,b-2_2073-2106_2105.wav,VTTS_b-2_2073-2106_2105.wav,2600,2705,-105
18036,b-3_98-195_176.wav,VTTS_b-3_98-195_176.wav,5800,5666,134
18037,b-4_2000-5164_3618.wav,VTTS_b-4_2000-5164_3618.wav,6074,5689,385
18038,b-4_2000-5164_4351.wav,VTTS_b-4_2000-5164_4351.wav,3307,3193,114
18039,b-3_4104-4206_4135.wav,VTTS_b-3_4104-4206_4135.wav,3880,3866,14
18040,b-3_6900-7016_6944.wav,VTTS_b-3_6900-7016_6944.wav,9800,8220,1580
18041,b-3_98-195_137.wav,VTTS_b-3_98-195_137.wav,6300,6734,-434
18042,b-3_6274-6300_6276.wav,VTTS_b-3_6274-6300_6276.wav,7980,8394,-414
18043,b-2_407-508_501.wav,VTTS_b-2_407-508_501.wav,1470,1463,7
18044,b-3_1666-1763_1693.wav,VTTS_b-3_1666-1763_1693.wav,2970,3053,-83
18045,b-4_2000-5164_2376.wav,VTTS_b-4_2000-5164_2376.wav,4130,4122,8
18046,b-1_3430-3530_3529.wav,VTTS_b-1_3430-3530_3529.wav,2470,2403,67
18047,b-3_2089-2176_2149.wav,VTTS_b-3_2089-2176_2149.wav,6350,6699,-349
18048,b-2_203-304_256.wav,VTTS_b-2_203-304_256.wav,1360,1765,-405
18049,b-3_2524-2854_2789.wav,VTTS_b-3_2524-2854_2789.wav,4440,3727,713
18050,b-2_305-406_396.wav,VTTS_b-2_305-406_396.wav,2290,2345,-55
18051,b-4_2000-5164_3117.wav,VTTS_b-4_2000-5164_3117.wav,1640,1544,96
18052,b-2_917-1018_954.wav,VTTS_b-2_917-1018_954.wav,3520,3274,246
18053,b-4_2000-5164_4185.wav,VTTS_b-4_2000-5164_4185.wav,1305,1161,144
18054,b-1_2018-2118_2082.wav,VTTS_b-1_2018-2118_2082.wav,2780,2995,-215
18055,b-4_2000-5164_3056.wav,VTTS_b-4_2000-5164_3056.wav,6813,5851,962
18056,b-3_6301-6400_6348.wav,VTTS_b-3_6301-6400_6348.wav,4940,5190,-250
18057,b-2_1223-1324_1269.wav,VTTS_b-2_1223-1324_1269.wav,1810,1823,-13
18058,b-3_5009-5427_5272.wav,VTTS_b-3_5009-5427_5272.wav,2350,2415,-65
18059,b-4_53-150_99.wav,VTTS_b-4_53-150_99.wav,9240,9752,-512
18060,b-4_1506-1600_1555.wav,VTTS_b-4_1506-1600_1555.wav,6670,5991,679
18061,b-3_3364-3453_3366.wav,VTTS_b-3_3364-3453_3366.wav,7370,8649,-1279
18062,b-1_2018-2118_2053.wav,VTTS_b-1_2018-2118_2053.wav,2130,2148,-18
18063,b-4_2000-5164_5147.wav,VTTS_b-4_2000-5164_5147.wav,1824,1741,83
18064,b-4_501-1014_668.wav,VTTS_b-4_501-1014_668.wav,2650,2461,189
18065,b-3_4001-4103_4057.wav,VTTS_b-3_4001-4103_4057.wav,4200,5271,-1071
18066,b-4_2000-5164_3707.wav,VTTS_b-4_2000-5164_3707.wav,5245,4911,334
18067,b-3_3279-3363_3293.wav,VTTS_b-3_3279-3363_3293.wav,5830,5410,420
18068,b-2_1325-1426_1331.wav,VTTS_b-2_1325-1426_1331.wav,1370,1544,-174
18069,b-4_2000-5164_3350.wav,VTTS_b-4_2000-5164_3350.wav,5122,5166,-44
18070,b-3_3628-3714_3635.wav,VTTS_b-3_3628-3714_3635.wav,9350,9300,50
18071,b-2_407-508_469.wav,VTTS_b-2_407-508_469.wav,1810,1544,266
18072,b-2_305-406_355.wav,VTTS_b-2_305-406_355.wav,1800,1916,-116
18073,b-4_301-400_354.wav,VTTS_b-4_301-400_354.wav,13610,11610,2000
18074,b-4_2000-5164_4022.wav,VTTS_b-4_2000-5164_4022.wav,5585,5410,175
18075,b-4_501-1014_677.wav,VTTS_b-4_501-1014_677.wav,3990,3355,635
18076,b-3_4104-4206_4131.wav,VTTS_b-3_4104-4206_4131.wav,7550,9346,-1796
18077,b-1_1818-1918_1855.wav,VTTS_b-1_1818-1918_1855.wav,4420,3611,809
18078,b-2_101-202_123.wav,VTTS_b-2_101-202_123.wav,1380,1625,-245
18079,b-1_1717-1817_1817.wav,VTTS_b-1_1717-1817_1817.wav,2680,2090,590
18080,b-3_5853-5956_5901.wav,VTTS_b-3_5853-5956_5901.wav,7060,4795,2265
18081,b-3_1862-1959_1879.wav,VTTS_b-3_1862-1959_1879.wav,10500,10379,121
18082,b-4_1014-1100_1064.wav,VTTS_b-4_1014-1100_1064.wav,2890,2694,196
18083,b-1_2018-2118_2050.wav,VTTS_b-1_2018-2118_2050.wav,4950,5573,-623
18084,b-1_3228-3328_3271.wav,VTTS_b-1_3228-3328_3271.wav,2410,2252,158
18085,b-1_3834-3934_3846.wav,VTTS_b-1_3834-3934_3846.wav,3340,3239,101
18086,b-4_2000-5164_2220.wav,VTTS_b-4_2000-5164_2220.wav,3770,3425,345
18087,b-3_1321-1568_1495.wav,VTTS_b-3_1321-1568_1495.wav,5960,6548,-588
18088,b-3_2524-2854_2749.wav,VTTS_b-3_2524-2854_2749.wav,7880,6490,1390
18089,b-3_1079-1320_1117.wav,VTTS_b-3_1079-1320_1117.wav,5640,5956,-316
18090,b-1_794-1009_817.wav,VTTS_b-1_794-1009_817.wav,1970,2067,-97
18091,b-4_2000-5164_4878.wav,VTTS_b-4_2000-5164_4878.wav,4283,6478,-2195
18092,b-3_6501-6600_6598.wav,VTTS_b-3_6501-6600_6598.wav,10320,11610,-1290
18093,b-3_1568-1665_1604.wav,VTTS_b-3_1568-1665_1604.wav,2470,2322,148
18094,b-4_2000-5164_2482.wav,VTTS_b-4_2000-5164_2482.wav,5560,5991,-431
18095,b-4_1301-1400_1328.wav,VTTS_b-4_1301-1400_1328.wav,1320,998,322
18096,b-4_301-400_399.wav,VTTS_b-4_301-400_399.wav,2380,2624,-244
18097,b-1_1-73_30.wav,VTTS_b-1_1-73_30.wav,2120,1904,216
18098,b-4_2000-5164_2947.wav,VTTS_b-4_2000-5164_2947.wav,7462,8034,-572
18099,b-4_1401-1505_1466.wav,VTTS_b-4_1401-1505_1466.wav,7880,7349,531
18100,b-3_4607-5008_4983.wav,VTTS_b-3_4607-5008_4983.wav,5250,5271,-21
18101,b-1_74-174_100.wav,VTTS_b-1_74-174_100.wav,2740,2020,720
18102,b-2_2311-2412_2347.wav,VTTS_b-2_2311-2412_2347.wav,3740,3564,176
18103,b-1_74-174_159.wav,VTTS_b-1_74-174_159.wav,1450,1800,-350
18104,b-3_1862-1959_1878.wav,VTTS_b-3_1862-1959_1878.wav,1700,1521,179
18105,b-2_815-916_914.wav,VTTS_b-2_815-916_914.wav,1770,1591,179
18106,b-4_2000-5164_2406.wav,VTTS_b-4_2000-5164_2406.wav,1030,998,32
18107,b-2_1563-1596_1565.wav,VTTS_b-2_1563-1596_1565.wav,2780,2635,145
18108,b-4_1707-1813_1789.wav,VTTS_b-4_1707-1813_1789.wav,1600,2241,-641
18109,b-1_478-578_542.wav,VTTS_b-1_478-578_542.wav,2200,4075,-1875
18110,b-3_392-500_457.wav,VTTS_b-3_392-500_457.wav,4180,4621,-441
18111,b-4_2000-5164_2423.wav,VTTS_b-4_2000-5164_2423.wav,6890,8081,-1191
18112,b-2_1427-1562_1509.wav,VTTS_b-2_1427-1562_1509.wav,5990,7779,-1789
18113,b-3_392-500_407.wav,VTTS_b-3_392-500_407.wav,4070,4029,41
18114,b-1_478-578_497.wav,VTTS_b-1_478-578_497.wav,1350,1312,38
18115,b-1_478-578_513.wav,VTTS_b-1_478-578_513.wav,2720,2775,-55
18116,b-1_1212-1312_1292.wav,VTTS_b-1_1212-1312_1292.wav,3370,3495,-125
18117,b-3_3279-3363_3348.wav,VTTS_b-3_3279-3363_3348.wav,5900,6374,-474
18118,b-1_3329-3429_3424.wav,VTTS_b-1_3329-3429_3424.wav,1790,2090,-300
18119,b-4_2000-5164_2502.wav,VTTS_b-4_2000-5164_2502.wav,3475,3437,38
18120,b-3_4607-5008_4750.wav,VTTS_b-3_4607-5008_4750.wav,3080,3088,-8
18121,b-2_917-1018_1006.wav,VTTS_b-2_917-1018_1006.wav,4990,11389,-6399
18122,b-4_2000-5164_4497.wav,VTTS_b-4_2000-5164_4497.wav,4749,5224,-475
18123,b-2_407-508_459.wav,VTTS_b-2_407-508_459.wav,2270,1753,517
18124,b-3_980-1077_1064.wav,VTTS_b-3_980-1077_1064.wav,8300,8162,138
18125,b-2_407-508_475.wav,VTTS_b-2_407-508_475.wav,2220,2368,-148
18126,b-1_1515-1615_1588.wav,VTTS_b-1_1515-1615_1588.wav,2480,2368,112
18127,b-4_2000-5164_3525.wav,VTTS_b-4_2000-5164_3525.wav,2106,1765,341
18128,b-3_6601-6700_6678.wav,VTTS_b-3_6601-6700_6678.wav,4060,5166,-1106
18129,b-3_2267-2349_2267.wav,VTTS_b-3_2267-2349_2267.wav,5350,5677,-327
18130,b-2_713-814_778.wav,VTTS_b-2_713-814_778.wav,6360,5817,543
18131,b-4_1301-1400_1301.wav,VTTS_b-4_1301-1400_1301.wav,4980,5457,-477
18132,b-1_3228-3328_3322.wav,VTTS_b-1_3228-3328_3322.wav,2670,2450,220
18133,b-4_1101-1220_1154.wav,VTTS_b-4_1101-1220_1154.wav,7190,7674,-484
18134,b-4_2000-5164_3088.wav,VTTS_b-4_2000-5164_3088.wav,5808,9230,-3422
18135,b-3_1568-1665_1617.wav,VTTS_b-3_1568-1665_1617.wav,4110,4063,47
18136,b-4_151-300_221.wav,VTTS_b-4_151-300_221.wav,5540,8185,-2645
18137,b-3_1-97_88.wav,VTTS_b-3_1-97_88.wav,3560,3460,100
18138,b-1_2321-2421_2356.wav,VTTS_b-1_2321-2421_2356.wav,1460,1486,-26
18139,b-3_5853-5956_5886.wav,VTTS_b-3_5853-5956_5886.wav,9730,10484,-754
18140,b-3_6217-6274_6265.wav,VTTS_b-3_6217-6274_6265.wav,6160,6293,-133
18141,b-1_579-649_639.wav,VTTS_b-1_579-649_639.wav,3190,3030,160
18142,b-3_5639-5744_5727.wav,VTTS_b-3_5639-5744_5727.wav,6630,6815,-185
18143,b-2_1427-1562_1496.wav,VTTS_b-2_1427-1562_1496.wav,9180,6896,2284
18144,b-3_3112-3197_3182.wav,VTTS_b-3_3112-3197_3182.wav,5680,4563,1117
18145,b-1_3935-4033_4021.wav,VTTS_b-1_3935-4033_4021.wav,4440,4923,-483
18146,b-1_175-275_267.wav,VTTS_b-1_175-275_267.wav,1550,1776,-226
18147,b-4_2000-5164_3159.wav,VTTS_b-4_2000-5164_3159.wav,4577,4505,72
18148,b-2_1903-2038_1981.wav,VTTS_b-2_1903-2038_1981.wav,1150,1324,-174
18149,b-1_74-174_141.wav,VTTS_b-1_74-174_141.wav,2400,2276,124
18150,b-4_2000-5164_3901.wav,VTTS_b-4_2000-5164_3901.wav,4144,4447,-303
18151,b-1_478-578_522.wav,VTTS_b-1_478-578_522.wav,2360,3204,-844
18152,b-4_2000-5164_3269.wav,VTTS_b-4_2000-5164_3269.wav,5844,5828,16
18153,b-2_2209-2310_2230.wav,VTTS_b-2_2209-2310_2230.wav,2210,3111,-901
18154,b-4_501-1014_528.wav,VTTS_b-4_501-1014_528.wav,7260,6246,1014
18155,b-3_4207-4314_4301.wav,VTTS_b-3_4207-4314_4301.wav,5810,5968,-158
18156,b-3_6301-6400_6391.wav,VTTS_b-3_6301-6400_6391.wav,7070,8278,-1208
18157,b-4_1401-1505_1475.wav,VTTS_b-4_1401-1505_1475.wav,9920,10194,-274
18158,b-2_1427-1562_1452.wav,VTTS_b-2_1427-1562_1452.wav,1590,2310,-720
18159,b-3_1-97_12.wav,VTTS_b-3_1-97_12.wav,7220,6850,370
18160,b-2_2209-2310_2292.wav,VTTS_b-2_2209-2310_2292.wav,1350,1370,-20
18161,b-3_1862-1959_1940.wav,VTTS_b-3_1862-1959_1940.wav,2600,2310,290
18162,b-4_2000-5164_2433.wav,VTTS_b-4_2000-5164_2433.wav,2810,2670,140
18163,b-2_101-202_166.wav,VTTS_b-2_101-202_166.wav,1650,1753,-103
18164,b-4_2000-5164_2620.wav,VTTS_b-4_2000-5164_2620.wav,4520,4783,-263
18165,b-1_3834-3934_3856.wav,VTTS_b-1_3834-3934_3856.wav,3120,3193,-73
18166,b-2_1-100_82.wav,VTTS_b-2_1-100_82.wav,2340,2972,-632
18167,b-2_2311-2412_2380.wav,VTTS_b-2_2311-2412_2380.wav,3030,2844,186
18168,b-4_2000-5164_3890.wav,VTTS_b-4_2000-5164_3890.wav,2602,2438,164
18169,b-4_301-400_341.wav,VTTS_b-4_301-400_341.wav,6410,6711,-301
18170,b-2_1223-1324_1253.wav,VTTS_b-2_1223-1324_1253.wav,1900,1811,89
18171,b-2_815-916_861.wav,VTTS_b-2_815-916_861.wav,1010,836,174
18172,b-3_1321-1568_1402.wav,VTTS_b-3_1321-1568_1402.wav,3200,3053,147
18173,b-4_2000-5164_3275.wav,VTTS_b-4_2000-5164_3275.wav,8182,7779,403
18174,b-4_2000-5164_3801.wav,VTTS_b-4_2000-5164_3801.wav,4178,3971,207
18175,b-2_2209-2310_2310.wav,VTTS_b-2_2209-2310_2310.wav,4000,11610,-7610
18176,b-3_2524-2854_2720.wav,VTTS_b-3_2524-2854_2720.wav,3720,3680,40
18177,b-3_3364-3453_3451.wav,VTTS_b-3_3364-3453_3451.wav,1940,2032,-92
18178,b-1_1414-1514_1515.wav,VTTS_b-1_1414-1514_1515.wav,2600,2694,-94
18179,b-3_6116-6215_6155.wav,VTTS_b-3_6116-6215_6155.wav,2480,2531,-51
18180,b-4_2000-5164_4489.wav,VTTS_b-4_2000-5164_4489.wav,3431,2659,772
18181,b-2_305-406_384.wav,VTTS_b-2_305-406_384.wav,2100,1753,347
18182,b-3_2524-2854_2780.wav,VTTS_b-3_2524-2854_2780.wav,4850,3924,926
18183,b-2_2209-2310_2284.wav,VTTS_b-2_2209-2310_2284.wav,3290,3808,-518
18184,b-1_74-174_76.wav,VTTS_b-1_74-174_76.wav,2070,1718,352
18185,b-4_2000-5164_4581.wav,VTTS_b-4_2000-5164_4581.wav,5209,5445,-236
18186,b-2_611-712_614.wav,VTTS_b-2_611-712_614.wav,3930,2961,969
18187,b-3_3454-3537_3511.wav,VTTS_b-3_3454-3537_3511.wav,7660,7837,-177
18188,b-2_1427-1562_1500.wav,VTTS_b-2_1427-1562_1500.wav,2700,2136,564
18189,b-4_2000-5164_4704.wav,VTTS_b-4_2000-5164_4704.wav,9984,11482,-1498
18190,b-3_6501-6600_6518.wav,VTTS_b-3_6501-6600_6518.wav,1360,1405,-45
18191,b-4_2000-5164_3983.wav,VTTS_b-4_2000-5164_3983.wav,6333,6200,133
18192,b-4_2000-5164_4208.wav,VTTS_b-4_2000-5164_4208.wav,8498,11610,-3112
18193,b-4_1101-1220_1125.wav,VTTS_b-4_1101-1220_1125.wav,9760,8371,1389
18194,b-3_3803-3888_3837.wav,VTTS_b-3_3803-3888_3837.wav,5930,5677,253
18195,b-4_2000-5164_3198.wav,VTTS_b-4_2000-5164_3198.wav,1141,987,154
18196,b-4_2000-5164_3251.wav,VTTS_b-4_2000-5164_3251.wav,4877,4516,361
18197,b-2_611-712_635.wav,VTTS_b-2_611-712_635.wav,5250,6223,-973
18198,b-1_4178-4213_4190.wav,VTTS_b-1_4178-4213_4190.wav,1320,1382,-62
18199,b-3_196-293_274.wav,VTTS_b-3_196-293_274.wav,2470,3413,-943
18200,b-3_3454-3537_3504.wav,VTTS_b-3_3454-3537_3504.wav,5270,4690,580
18201,b-4_501-1014_746.wav,VTTS_b-4_501-1014_746.wav,1820,1486,334
18202,b-3_5009-5427_5290.wav,VTTS_b-3_5009-5427_5290.wav,6680,6676,4
18203,b-1_4214-4285_4275.wav,VTTS_b-1_4214-4285_4275.wav,5150,6223,-1073
18204,b-4_2000-5164_3211.wav,VTTS_b-4_2000-5164_3211.wav,3947,3808,139
18205,b-4_1301-1400_1322.wav,VTTS_b-4_1301-1400_1322.wav,1620,1695,-75
18206,b-1_794-1009_934.wav,VTTS_b-1_794-1009_934.wav,3130,3947,-817
18207,b-4_301-400_378.wav,VTTS_b-4_301-400_378.wav,4460,3982,478
18208,b-2_2311-2412_2408.wav,VTTS_b-2_2311-2412_2408.wav,1830,2392,-562
18209,b-3_501-930_901.wav,VTTS_b-3_501-930_901.wav,6200,6211,-11
18210,b-4_151-300_182.wav,VTTS_b-4_151-300_182.wav,2320,2392,-72
18211,b-4_301-400_329.wav,VTTS_b-4_301-400_329.wav,2280,2101,179
18212,b-3_4607-5008_4698.wav,VTTS_b-3_4607-5008_4698.wav,3500,3576,-76
18213,b-3_2434-2523_2448.wav,VTTS_b-3_2434-2523_2448.wav,3180,3425,-245
18214,b-1_3834-3934_3925.wav,VTTS_b-1_3834-3934_3925.wav,1760,2067,-307
18215,b-1_74-174_151.wav,VTTS_b-1_74-174_151.wav,1980,4540,-2560
18216,b-3_392-500_392.wav,VTTS_b-3_392-500_392.wav,6270,5700,570
18217,b-2_1699-1800_1743.wav,VTTS_b-2_1699-1800_1743.wav,1260,1242,18
18218,b-4_53-150_118.wav,VTTS_b-4_53-150_118.wav,9950,9671,279
18219,b-4_1901-2000_1916.wav,VTTS_b-4_1901-2000_1916.wav,6950,6211,739
18220,b-4_2000-5164_4569.wav,VTTS_b-4_2000-5164_4569.wav,3224,3135,89
18221,b-1_4286-4321_4288.wav,VTTS_b-1_4286-4321_4288.wav,2730,2601,129
18222,b-3_1321-1568_1421.wav,VTTS_b-3_1321-1568_1421.wav,4570,6711,-2141
18223,b-3_501-930_638.wav,VTTS_b-3_501-930_638.wav,3520,2798,722
18224,b-2_203-304_217.wav,VTTS_b-2_203-304_217.wav,3600,3831,-231
18225,b-1_3228-3328_3273.wav,VTTS_b-1_3228-3328_3273.wav,1980,1974,6
18226,b-1_377-477_401.wav,VTTS_b-1_377-477_401.wav,3000,2519,481
18227,b-3_4207-4314_4280.wav,VTTS_b-3_4207-4314_4280.wav,3410,2914,496
18228,b-1_1919-2017_1926.wav,VTTS_b-1_1919-2017_1926.wav,3000,2879,121
18229,b-3_1321-1568_1414.wav,VTTS_b-3_1321-1568_1414.wav,7320,6815,505
18230,b-1_579-649_617.wav,VTTS_b-1_579-649_617.wav,3570,3564,6
18231,b-4_2000-5164_4889.wav,VTTS_b-4_2000-5164_4889.wav,3205,2949,256
18232,b-4_2000-5164_4959.wav,VTTS_b-4_2000-5164_4959.wav,2977,3077,-100
18233,b-4_2000-5164_4609.wav,VTTS_b-4_2000-5164_4609.wav,7187,7326,-139
18234,b-3_4104-4206_4106.wav,VTTS_b-3_4104-4206_4106.wav,5950,5410,540
18235,b-1_4034-4069_4036.wav,VTTS_b-1_4034-4069_4036.wav,1090,1149,-59
18236,b-1_2826-2926_2841.wav,VTTS_b-1_2826-2926_2841.wav,1530,1382,148
18237,b-1_1111-1211_1142.wav,VTTS_b-1_1111-1211_1142.wav,2800,2659,141
18238,b-3_6301-6400_6370.wav,VTTS_b-3_6301-6400_6370.wav,4230,4168,62
18239,b-4_2000-5164_3851.wav,VTTS_b-4_2000-5164_3851.wav,8668,8940,-272
18240,b-4_501-1014_623.wav,VTTS_b-4_501-1014_623.wav,990,940,50
18241,b-4_151-300_228.wav,VTTS_b-4_151-300_228.wav,4820,4702,118
18242,b-2_2413-2500_2429.wav,VTTS_b-2_2413-2500_2429.wav,2430,2752,-322
18243,b-4_2000-5164_3426.wav,VTTS_b-4_2000-5164_3426.wav,4205,4656,-451
18244,b-4_2000-5164_2132.wav,VTTS_b-4_2000-5164_2132.wav,4930,5004,-74
18245,b-3_4104-4206_4152.wav,VTTS_b-3_4104-4206_4152.wav,6210,5642,568
18246,b-4_2000-5164_5121.wav,VTTS_b-4_2000-5164_5121.wav,1437,1057,380
18247,b-4_2000-5164_3551.wav,VTTS_b-4_2000-5164_3551.wav,1571,1579,-8
18248,b-3_3279-3363_3317.wav,VTTS_b-3_3279-3363_3317.wav,8280,8545,-265
18249,b-3_2943-3024_2987.wav,VTTS_b-3_2943-3024_2987.wav,4090,4679,-589
18250,b-3_501-930_636.wav,VTTS_b-3_501-930_636.wav,2510,2902,-392
18251,b-3_1764-1861_1848.wav,VTTS_b-3_1764-1861_1848.wav,10700,9845,855
18252,b-4_1101-1220_1152.wav,VTTS_b-4_1101-1220_1152.wav,8790,8800,-10
18253,b-1_2119-2219_2132.wav,VTTS_b-1_2119-2219_2132.wav,1310,1196,114
18254,b-1_794-1009_935.wav,VTTS_b-1_794-1009_935.wav,2700,3030,-330
18255,b-3_6301-6400_6316.wav,VTTS_b-3_6301-6400_6316.wav,6800,7198,-398
18256,b-3_3538-3627_3590.wav,VTTS_b-3_3538-3627_3590.wav,7530,7814,-284
18257,b-3_2524-2854_2799.wav,VTTS_b-3_2524-2854_2799.wav,3380,3274,106
18258,b-2_917-1018_972.wav,VTTS_b-2_917-1018_972.wav,2190,3959,-1769
18259,b-3_1079-1320_1290.wav,VTTS_b-3_1079-1320_1290.wav,6900,7187,-287
18260,b-2_1-100_23.wav,VTTS_b-2_1-100_23.wav,3240,3936,-696
18261,b-1_3935-4033_4011.wav,VTTS_b-1_3935-4033_4011.wav,2610,2798,-188
18262,b-4_501-1014_939.wav,VTTS_b-4_501-1014_939.wav,3600,3483,117
18263,b-1_2826-2926_2920.wav,VTTS_b-1_2826-2926_2920.wav,2610,2299,311
18264,b-3_3538-3627_3550.wav,VTTS_b-3_3538-3627_3550.wav,2670,3228,-558
18265,b-4_501-1014_743.wav,VTTS_b-4_501-1014_743.wav,5160,5422,-262
18266,b-3_6401-6500_6441.wav,VTTS_b-3_6401-6500_6441.wav,4710,4493,217
18267,b-1_2725-2825_2738.wav,VTTS_b-1_2725-2825_2738.wav,1050,1103,-53
18268,b-2_815-916_868.wav,VTTS_b-2_815-916_868.wav,3530,4354,-824
18269,b-4_2000-5164_3815.wav,VTTS_b-4_2000-5164_3815.wav,3470,3379,91
18270,b-4_2000-5164_3557.wav,VTTS_b-4_2000-5164_3557.wav,3537,3831,-294
18271,b-4_2000-5164_4894.wav,VTTS_b-4_2000-5164_4894.wav,3121,2763,358
18272,b-1_3026-3126_3124.wav,VTTS_b-1_3026-3126_3124.wav,7120,6780,340
18273,b-4_2000-5164_4426.wav,VTTS_b-4_2000-5164_4426.wav,6124,7988,-1864
18274,b-4_2000-5164_4358.wav,VTTS_b-4_2000-5164_4358.wav,4553,4098,455
18275,b-3_3364-3453_3406.wav,VTTS_b-3_3364-3453_3406.wav,4900,4632,268
18276,b-1_2725-2825_2745.wav,VTTS_b-1_2725-2825_2745.wav,2240,3831,-1591
18277,b-1_2321-2421_2408.wav,VTTS_b-1_2321-2421_2408.wav,1150,1033,117
18278,b-4_501-1014_508.wav,VTTS_b-4_501-1014_508.wav,5660,5108,552
18279,b-3_392-500_455.wav,VTTS_b-3_392-500_455.wav,4550,4505,45
18280,b-3_1568-1665_1607.wav,VTTS_b-3_1568-1665_1607.wav,5600,5352,248
18281,b-3_3889-4000_3992.wav,VTTS_b-3_3889-4000_3992.wav,10030,9021,1009
18282,b-2_611-712_634.wav,VTTS_b-2_611-712_634.wav,2620,2612,8
18283,b-4_501-1014_527.wav,VTTS_b-4_501-1014_527.wav,1350,1103,247
18284,b-2_203-304_222.wav,VTTS_b-2_203-304_222.wav,1790,2113,-323
18285,b-3_2524-2854_2623.wav,VTTS_b-3_2524-2854_2623.wav,9830,9242,588
18286,b-3_6274-6300_6294.wav,VTTS_b-3_6274-6300_6294.wav,2620,3762,-1142
18287,b-2_713-814_752.wav,VTTS_b-2_713-814_752.wav,2780,2450,330
18288,b-4_2000-5164_3734.wav,VTTS_b-4_2000-5164_3734.wav,4280,3947,333
18289,b-3_3889-4000_3937.wav,VTTS_b-3_3889-4000_3937.wav,910,975,-65
18290,b-1_2018-2118_2073.wav,VTTS_b-1_2018-2118_2073.wav,2140,1741,399
18291,b-3_4315-4424_4388.wav,VTTS_b-3_4315-4424_4388.wav,8040,11610,-3570
18292,b-3_5639-5744_5741.wav,VTTS_b-3_5639-5744_5741.wav,4430,3553,877
18293,b-3_6801-6900_6808.wav,VTTS_b-3_6801-6900_6808.wav,3220,3657,-437
18294,b-1_2422-2522_2460.wav,VTTS_b-1_2422-2522_2460.wav,3080,2926,154
18295,b-3_1079-1320_1302.wav,VTTS_b-3_1079-1320_1302.wav,4310,4238,72
18296,b-4_53-150_57.wav,VTTS_b-4_53-150_57.wav,9840,11610,-1770
18297,b-4_1221-1300_1286.wav,VTTS_b-4_1221-1300_1286.wav,5130,11610,-6480
18298,b-1_4358-4393_4393.wav,VTTS_b-1_4358-4393_4393.wav,3890,5352,-1462
18299,b-3_4001-4103_4064.wav,VTTS_b-3_4001-4103_4064.wav,11920,11134,786
18300,b-4_2000-5164_3616.wav,VTTS_b-4_2000-5164_3616.wav,4533,4400,133
18301,b-4_151-300_285.wav,VTTS_b-4_151-300_285.wav,5490,4748,742
18302,b-3_392-500_494.wav,VTTS_b-3_392-500_494.wav,3210,2961,249
18303,b-1_2422-2522_2464.wav,VTTS_b-1_2422-2522_2464.wav,2410,2403,7
18304,b-1_3430-3530_3501.wav,VTTS_b-1_3430-3530_3501.wav,3460,3425,35
18305,b-1_650-685_679.wav,VTTS_b-1_650-685_679.wav,3400,3518,-118
18306,b-3_1321-1568_1329.wav,VTTS_b-3_1321-1568_1329.wav,1080,1347,-267
18307,b-4_2000-5164_2314.wav,VTTS_b-4_2000-5164_2314.wav,6450,6118,332
18308,b-3_2000-2088_2003.wav,VTTS_b-3_2000-2088_2003.wav,4050,3704,346
18309,b-1_3935-4033_3944.wav,VTTS_b-1_3935-4033_3944.wav,4140,4865,-725
18310,b-3_6601-6700_6679.wav,VTTS_b-3_6601-6700_6679.wav,4160,4156,4
18311,b-1_2018-2118_2093.wav,VTTS_b-1_2018-2118_2093.wav,1120,1126,-6
18312,b-3_5428-5533_5484.wav,VTTS_b-3_5428-5533_5484.wav,2970,2833,137
18313,b-1_2927-3025_2980.wav,VTTS_b-1_2927-3025_2980.wav,1260,1254,6
18314,b-1_3632-3732_3682.wav,VTTS_b-1_3632-3732_3682.wav,2660,2844,-184
18315,b-1_686-793_729.wav,VTTS_b-1_686-793_729.wav,1570,1660,-90
18316,b-3_501-930_510.wav,VTTS_b-3_501-930_510.wav,3190,3262,-72
18317,b-1_2826-2926_2869.wav,VTTS_b-1_2826-2926_2869.wav,1330,1358,-28
18318,b-3_931-979_959.wav,VTTS_b-3_931-979_959.wav,5450,5921,-471
18319,b-1_4070-4105_4098.wav,VTTS_b-1_4070-4105_4098.wav,3250,3355,-105
18320,b-1_3026-3126_3082.wav,VTTS_b-1_3026-3126_3082.wav,2550,2438,112
18321,b-3_4607-5008_4893.wav,VTTS_b-3_4607-5008_4893.wav,8650,10321,-1671
18322,b-4_2000-5164_2827.wav,VTTS_b-4_2000-5164_2827.wav,4780,4667,113
18323,b-3_2524-2854_2743.wav,VTTS_b-3_2524-2854_2743.wav,5810,5213,597
18324,b-2_1-100_86.wav,VTTS_b-2_1-100_86.wav,2870,4760,-1890
18325,b-2_1903-2038_2011.wav,VTTS_b-2_1903-2038_2011.wav,1270,1138,132
18326,b-2_1325-1426_1332.wav,VTTS_b-2_1325-1426_1332.wav,1580,1405,175
18327,b-3_196-293_206.wav,VTTS_b-3_196-293_206.wav,10200,8940,1260
18328,b-4_2000-5164_2047.wav,VTTS_b-4_2000-5164_2047.wav,8385,9172,-787
18329,b-1_2119-2219_2163.wav,VTTS_b-1_2119-2219_2163.wav,1220,1254,-34
18330,b-1_3329-3429_3342.wav,VTTS_b-1_3329-3429_3342.wav,5460,4551,909
18331,b-1_2321-2421_2403.wav,VTTS_b-1_2321-2421_2403.wav,2290,1858,432
18332,b-3_4104-4206_4169.wav,VTTS_b-3_4104-4206_4169.wav,2880,2670,210
18333,b-1_1515-1615_1535.wav,VTTS_b-1_1515-1615_1535.wav,2700,2450,250
18334,b-1_1111-1211_1179.wav,VTTS_b-1_1111-1211_1179.wav,1780,1335,445
18335,b-3_294-391_319.wav,VTTS_b-3_294-391_319.wav,5740,5097,643
18336,b-2_1699-1800_1765.wav,VTTS_b-2_1699-1800_1765.wav,720,743,-23
18337,b-3_3025-3111_3057.wav,VTTS_b-3_3025-3111_3057.wav,5550,6490,-940
18338,b-3_6501-6600_6553.wav,VTTS_b-3_6501-6600_6553.wav,5540,4307,1233
18339,b-2_305-406_383.wav,VTTS_b-2_305-406_383.wav,4410,4772,-362
18340,b-1_3026-3126_3093.wav,VTTS_b-1_3026-3126_3093.wav,1250,1161,89
18341,b-3_4607-5008_4607.wav,VTTS_b-3_4607-5008_4607.wav,3300,3344,-44
18342,b-3_2524-2854_2776.wav,VTTS_b-3_2524-2854_2776.wav,3960,4342,-382
18343,b-3_3025-3111_3089.wav,VTTS_b-3_3025-3111_3089.wav,2490,2612,-122
18344,b-4_2000-5164_3771.wav,VTTS_b-4_2000-5164_3771.wav,8360,11505,-3145
18345,b-1_4394-4429_4400.wav,VTTS_b-1_4394-4429_4400.wav,1760,1614,146
18346,b-3_5533-5638_5580.wav,VTTS_b-3_5533-5638_5580.wav,6500,6734,-234
18347,b-4_2000-5164_4252.wav,VTTS_b-4_2000-5164_4252.wav,6054,6513,-459
18348,b-3_1-97_100.wav,VTTS_b-3_1-97_100.wav,1910,1858,52
18349,b-1_1212-1312_1276.wav,VTTS_b-1_1212-1312_1276.wav,2100,2844,-744
18350,b-3_6601-6700_6609.wav,VTTS_b-3_6601-6700_6609.wav,6330,11610,-5280
18351,b-3_6601-6700_6648.wav,VTTS_b-3_6601-6700_6648.wav,2690,2647,43
18352,b-3_6900-7016_6923.wav,VTTS_b-3_6900-7016_6923.wav,5900,6026,-126
18353,b-3_1079-1320_1170.wav,VTTS_b-3_1079-1320_1170.wav,2890,2694,196
18354,b-2_2073-2106_2084.wav,VTTS_b-2_2073-2106_2084.wav,1800,2740,-940
18355,b-3_2000-2088_2048.wav,VTTS_b-3_2000-2088_2048.wav,7000,6327,673
18356,b-4_2000-5164_3130.wav,VTTS_b-4_2000-5164_3130.wav,1973,1950,23
18357,b-3_1321-1568_1501.wav,VTTS_b-3_1321-1568_1501.wav,1510,1416,94
18358,b-4_501-1014_986.wav,VTTS_b-4_501-1014_986.wav,1990,2055,-65
18359,b-4_501-1014_604.wav,VTTS_b-4_501-1014_604.wav,6680,7454,-774
18360,b-2_713-814_754.wav,VTTS_b-2_713-814_754.wav,6590,6536,54
18361,b-1_1212-1312_1225.wav,VTTS_b-1_1212-1312_1225.wav,1640,1567,73
18362,b-1_175-275_220.wav,VTTS_b-1_175-275_220.wav,2250,2496,-246
18363,b-2_1121-1222_1170.wav,VTTS_b-2_1121-1222_1170.wav,1030,1834,-804
18364,b-3_1862-1959_1866.wav,VTTS_b-3_1862-1959_1866.wav,2030,2032,-2
18365,b-1_3733-3833_3805.wav,VTTS_b-1_3733-3833_3805.wav,2220,2508,-288
18366,b-3_2267-2349_2307.wav,VTTS_b-3_2267-2349_2307.wav,5470,5213,257
18367,b-3_6217-6274_6231.wav,VTTS_b-3_6217-6274_6231.wav,1520,1683,-163
18368,b-3_6401-6500_6474.wav,VTTS_b-3_6401-6500_6474.wav,2720,2589,131
18369,b-3_6601-6700_6660.wav,VTTS_b-3_6601-6700_6660.wav,2020,3077,-1057
18370,b-1_3531-3631_3555.wav,VTTS_b-1_3531-3631_3555.wav,3150,3518,-368
18371,b-2_1-100_38.wav,VTTS_b-2_1-100_38.wav,2030,3587,-1557
18372,b-4_1601-1706_1678.wav,VTTS_b-4_1601-1706_1678.wav,2800,2844,-44
18373,b-3_2855-2942_2875.wav,VTTS_b-3_2855-2942_2875.wav,2130,2334,-204
18374,b-3_4104-4206_4141.wav,VTTS_b-3_4104-4206_4141.wav,9550,8487,1063
18375,b-1_4034-4069_4034.wav,VTTS_b-1_4034-4069_4034.wav,1790,1846,-56
18376,b-2_1563-1596_1570.wav,VTTS_b-2_1563-1596_1570.wav,1890,2032,-142
18377,b-1_1515-1615_1533.wav,VTTS_b-1_1515-1615_1533.wav,2430,2183,247
18378,b-4_2000-5164_2019.wav,VTTS_b-4_2000-5164_2019.wav,4790,4981,-191
18379,b-2_713-814_801.wav,VTTS_b-2_713-814_801.wav,4920,4923,-3
18380,b-2_815-916_819.wav,VTTS_b-2_815-916_819.wav,2580,3971,-1391
18381,b-3_5957-6015_5970.wav,VTTS_b-3_5957-6015_5970.wav,2990,2995,-5
18382,b-2_407-508_479.wav,VTTS_b-2_407-508_479.wav,1520,836,684
18383,b-1_1212-1312_1280.wav,VTTS_b-1_1212-1312_1280.wav,2000,1858,142
18384,b-2_713-814_788.wav,VTTS_b-2_713-814_788.wav,5920,5596,324
18385,b-1_794-1009_933.wav,VTTS_b-1_794-1009_933.wav,3730,3599,131
18386,b-3_1321-1568_1567.wav,VTTS_b-3_1321-1568_1567.wav,6790,5132,1658
18387,b-2_815-916_842.wav,VTTS_b-2_815-916_842.wav,1590,1614,-24
18388,b-3_2524-2854_2721.wav,VTTS_b-3_2524-2854_2721.wav,3960,4052,-92
18389,b-4_2000-5164_2800.wav,VTTS_b-4_2000-5164_2800.wav,3140,3204,-64
18390,b-1_2220-2320_2223.wav,VTTS_b-1_2220-2320_2223.wav,1790,1788,2
18391,b-3_6116-6215_6208.wav,VTTS_b-3_6116-6215_6208.wav,2380,2775,-395
18392,b-3_6217-6274_6252.wav,VTTS_b-3_6217-6274_6252.wav,6650,6478,172
18393,b-4_2000-5164_3597.wav,VTTS_b-4_2000-5164_3597.wav,9185,8975,210
18394,b-2_1325-1426_1398.wav,VTTS_b-2_1325-1426_1398.wav,1620,1416,204
18395,b-1_175-275_253.wav,VTTS_b-1_175-275_253.wav,2900,2926,-26
18396,b-2_917-1018_941.wav,VTTS_b-2_917-1018_941.wav,5660,4505,1155
18397,b-1_1919-2017_1985.wav,VTTS_b-1_1919-2017_1985.wav,2710,2810,-100
18398,b-4_2000-5164_4421.wav,VTTS_b-4_2000-5164_4421.wav,8757,9358,-601
18399,b-3_4607-5008_4645.wav,VTTS_b-3_4607-5008_4645.wav,6580,8104,-1524
18400,b-4_1814-1900_1887.wav,VTTS_b-4_1814-1900_1887.wav,1790,1730,60
18401,b-3_6016-6115_6036.wav,VTTS_b-3_6016-6115_6036.wav,3040,2473,567
18402,b-3_3198-3278_3199.wav,VTTS_b-3_3198-3278_3199.wav,8290,7663,627
18403,b-4_2000-5164_3061.wav,VTTS_b-4_2000-5164_3061.wav,4535,4957,-422
18404,b-1_3329-3429_3346.wav,VTTS_b-1_3329-3429_3346.wav,2700,2717,-17
18405,b-1_1313-1413_1365.wav,VTTS_b-1_1313-1413_1365.wav,880,824,56
18406,b-1_2119-2219_2155.wav,VTTS_b-1_2119-2219_2155.wav,2500,1289,1211
18407,b-2_1121-1222_1211.wav,VTTS_b-2_1121-1222_1211.wav,5650,5979,-329
18408,b-3_2524-2854_2778.wav,VTTS_b-3_2524-2854_2778.wav,3820,3158,662
18409,b-4_2000-5164_2609.wav,VTTS_b-4_2000-5164_2609.wav,5030,5178,-148
18410,b-4_2000-5164_4989.wav,VTTS_b-4_2000-5164_4989.wav,7913,7326,587
18411,b-3_1764-1861_1834.wav,VTTS_b-3_1764-1861_1834.wav,4840,4365,475
18412,b-3_501-930_922.wav,VTTS_b-3_501-930_922.wav,4180,4435,-255
18413,b-4_2000-5164_3867.wav,VTTS_b-4_2000-5164_3867.wav,4681,4795,-114
18414,b-2_203-304_278.wav,VTTS_b-2_203-304_278.wav,2300,2868,-568
18415,b-3_6401-6500_6491.wav,VTTS_b-3_6401-6500_6491.wav,9130,9183,-53
18416,b-4_1101-1220_1216.wav,VTTS_b-4_1101-1220_1216.wav,7100,8731,-1631
18417,b-1_3935-4033_3971.wav,VTTS_b-1_3935-4033_3971.wav,1580,1614,-34
18418,b-2_1019-1120_1075.wav,VTTS_b-2_1019-1120_1075.wav,2710,2682,28
18419,b-1_3228-3328_3318.wav,VTTS_b-1_3228-3328_3318.wav,1860,2136,-276
18420,b-3_1321-1568_1570.wav,VTTS_b-3_1321-1568_1570.wav,2630,2009,621
18421,b-3_2524-2854_2675.wav,VTTS_b-3_2524-2854_2675.wav,6730,6072,658
18422,b-3_2943-3024_2975.wav,VTTS_b-3_2943-3024_2975.wav,7530,8731,-1201
18423,b-3_980-1077_1053.wav,VTTS_b-3_980-1077_1053.wav,5040,5132,-92
18424,b-2_2413-2500_2469.wav,VTTS_b-2_2413-2500_2469.wav,1740,1451,289
18425,b-3_6801-6900_6815.wav,VTTS_b-3_6801-6900_6815.wav,3190,2485,705
18426,b-4_2000-5164_2579.wav,VTTS_b-4_2000-5164_2579.wav,4235,4725,-490
18427,b-4_2000-5164_3786.wav,VTTS_b-4_2000-5164_3786.wav,3190,2949,241
18428,b-2_1801-1902_1810.wav,VTTS_b-2_1801-1902_1810.wav,3390,2961,429
18429,b-4_2000-5164_4145.wav,VTTS_b-4_2000-5164_4145.wav,3106,2752,354
18430,b-3_2350-2433_2415.wav,VTTS_b-3_2350-2433_2415.wav,5280,5178,102
18431,b-3_2524-2854_2635.wav,VTTS_b-3_2524-2854_2635.wav,4830,4656,174
18432,b-3_501-930_608.wav,VTTS_b-3_501-930_608.wav,7490,8173,-683
18433,b-4_501-1014_995.wav,VTTS_b-4_501-1014_995.wav,6670,7477,-807
18434,b-1_377-477_433.wav,VTTS_b-1_377-477_433.wav,1240,1463,-223
18435,b-3_980-1077_1034.wav,VTTS_b-3_980-1077_1034.wav,3470,3611,-141
18436,b-1_1616-1716_1677.wav,VTTS_b-1_1616-1716_1677.wav,1460,1498,-38
18437,b-3_6601-6700_6675.wav,VTTS_b-3_6601-6700_6675.wav,3090,3193,-103
18438,b-1_1616-1716_1661.wav,VTTS_b-1_1616-1716_1661.wav,1520,1347,173
18439,b-1_3228-3328_3302.wav,VTTS_b-1_3228-3328_3302.wav,1450,1579,-129
18440,b-4_2000-5164_2862.wav,VTTS_b-4_2000-5164_2862.wav,7205,7512,-307
18441,b-4_1506-1600_1528.wav,VTTS_b-4_1506-1600_1528.wav,3740,3100,640
18442,b-3_501-930_906.wav,VTTS_b-3_501-930_906.wav,4510,3889,621
18443,b-4_2000-5164_4245.wav,VTTS_b-4_2000-5164_4245.wav,6516,6177,339
18444,b-3_5009-5427_5075.wav,VTTS_b-3_5009-5427_5075.wav,3490,3216,274
18445,b-4_2000-5164_4265.wav,VTTS_b-4_2000-5164_4265.wav,4814,4656,158
18446,b-2_2311-2412_2372.wav,VTTS_b-2_2311-2412_2372.wav,1530,1451,79
18447,b-1_3329-3429_3339.wav,VTTS_b-1_3329-3429_3339.wav,3540,3576,-36
18448,b-3_5009-5427_5062.wav,VTTS_b-3_5009-5427_5062.wav,2710,2647,63
18449,b-2_305-406_338.wav,VTTS_b-2_305-406_338.wav,2800,2728,72
18450,b-4_1301-1400_1382.wav,VTTS_b-4_1301-1400_1382.wav,6680,6769,-89
18451,b-2_1801-1902_1839.wav,VTTS_b-2_1801-1902_1839.wav,1670,1974,-304
18452,b-3_6601-6700_6625.wav,VTTS_b-3_6601-6700_6625.wav,4350,4156,194
18453,b-4_501-1014_900.wav,VTTS_b-4_501-1014_900.wav,3570,3773,-203
18454,b-4_1101-1220_1157.wav,VTTS_b-4_1101-1220_1157.wav,10980,11610,-630
18455,b-3_501-930_860.wav,VTTS_b-3_501-930_860.wav,3490,3460,30
18456,b-3_6217-6274_6244.wav,VTTS_b-3_6217-6274_6244.wav,3980,3982,-2
18457,b-3_2524-2854_2583.wav,VTTS_b-3_2524-2854_2583.wav,3430,3332,98
18458,b-4_2000-5164_2749.wav,VTTS_b-4_2000-5164_2749.wav,5650,6095,-445
18459,b-4_2000-5164_2673.wav,VTTS_b-4_2000-5164_2673.wav,4810,5016,-206
18460,b-4_1014-1100_1027.wav,VTTS_b-4_1014-1100_1027.wav,12710,11610,1100
18461,b-3_501-930_681.wav,VTTS_b-3_501-930_681.wav,4200,4609,-409
18462,b-4_2000-5164_2165.wav,VTTS_b-4_2000-5164_2165.wav,1930,4122,-2192
18463,b-4_2000-5164_2504.wav,VTTS_b-4_2000-5164_2504.wav,3620,3367,253
18464,b-3_4607-5008_4724.wav,VTTS_b-3_4607-5008_4724.wav,5290,6107,-817
18465,b-4_2000-5164_4655.wav,VTTS_b-4_2000-5164_4655.wav,3735,3657,78
18466,b-1_175-275_199.wav,VTTS_b-1_175-275_199.wav,1260,1242,18
18467,b-4_1901-2000_1912.wav,VTTS_b-4_1901-2000_1912.wav,7860,7628,232
18468,b-3_4425-4497_4442.wav,VTTS_b-3_4425-4497_4442.wav,3370,3344,26
18469,b-3_4607-5008_4878.wav,VTTS_b-3_4607-5008_4878.wav,5610,4888,722
18470,b-2_2073-2106_2075.wav,VTTS_b-2_2073-2106_2075.wav,1350,1405,-55
18471,b-2_611-712_684.wav,VTTS_b-2_611-712_684.wav,1160,1277,-117
18472,b-3_5639-5744_5717.wav,VTTS_b-3_5639-5744_5717.wav,5070,5689,-619
18473,b-3_1568-1665_1629.wav,VTTS_b-3_1568-1665_1629.wav,4380,4040,340
18474,b-1_4070-4105_4101.wav,VTTS_b-1_4070-4105_4101.wav,4590,11610,-7020
18475,b-1_2220-2320_2318.wav,VTTS_b-1_2220-2320_2318.wav,1910,1892,18
18476,b-1_4214-4285_4232.wav,VTTS_b-1_4214-4285_4232.wav,2730,3320,-590
18477,b-3_4315-4424_4331.wav,VTTS_b-3_4315-4424_4331.wav,6950,6618,332
18478,b-4_501-1014_642.wav,VTTS_b-4_501-1014_642.wav,7640,7419,221
18479,b-1_2725-2825_2794.wav,VTTS_b-1_2725-2825_2794.wav,2590,2415,175
18480,b-3_1-97_74.wav,VTTS_b-3_1-97_74.wav,2280,2310,-30
18481,b-3_4607-5008_4884.wav,VTTS_b-3_4607-5008_4884.wav,2130,1974,156
18482,b-3_2943-3024_2978.wav,VTTS_b-3_2943-3024_2978.wav,5800,6362,-562
18483,b-3_2434-2523_2458.wav,VTTS_b-3_2434-2523_2458.wav,7750,7233,517
18484,b-1_3127-3227_3181.wav,VTTS_b-1_3127-3227_3181.wav,3890,3367,523
18485,b-1_2220-2320_2236.wav,VTTS_b-1_2220-2320_2236.wav,2570,3007,-437
18486,b-4_2000-5164_4106.wav,VTTS_b-4_2000-5164_4106.wav,6832,6931,-99
18487,b-3_1079-1320_1185.wav,VTTS_b-3_1079-1320_1185.wav,3000,2833,167
18488,b-2_611-712_694.wav,VTTS_b-2_611-712_694.wav,2480,1544,936
18489,b-4_2000-5164_2953.wav,VTTS_b-4_2000-5164_2953.wav,7635,7233,402
18490,b-4_301-400_314.wav,VTTS_b-4_301-400_314.wav,10890,10797,93
18491,b-4_151-300_263.wav,VTTS_b-4_151-300_263.wav,4090,4063,27
18492,b-3_2524-2854_2790.wav,VTTS_b-3_2524-2854_2790.wav,10340,9474,866
18493,b-4_151-300_286.wav,VTTS_b-4_151-300_286.wav,7690,9567,-1877
18494,b-3_4607-5008_4741.wav,VTTS_b-3_4607-5008_4741.wav,4810,4203,607
18495,b-3_2000-2088_2039.wav,VTTS_b-3_2000-2088_2039.wav,9010,9683,-673
18496,b-3_6501-6600_6546.wav,VTTS_b-3_6501-6600_6546.wav,1850,1741,109
18497,b-1_794-1009_903.wav,VTTS_b-1_794-1009_903.wav,3380,3483,-103
18498,b-1_3329-3429_3389.wav,VTTS_b-1_3329-3429_3389.wav,3190,3204,-14
18499,b-3_2000-2088_2009.wav,VTTS_b-3_2000-2088_2009.wav,5080,4946,134
18500,b-2_1325-1426_1422.wav,VTTS_b-2_1325-1426_1422.wav,7580,9253,-1673
18501,b-3_6401-6500_6480.wav,VTTS_b-3_6401-6500_6480.wav,8360,7430,930
18502,b-3_4104-4206_4123.wav,VTTS_b-3_4104-4206_4123.wav,4580,4644,-64
18503,b-2_1121-1222_1146.wav,VTTS_b-2_1121-1222_1146.wav,4010,4435,-425
18504,b-4_2000-5164_4748.wav,VTTS_b-4_2000-5164_4748.wav,2466,2276,190
18505,b-1_2422-2522_2444.wav,VTTS_b-1_2422-2522_2444.wav,3610,6142,-2532
18506,b-1_4034-4069_4060.wav,VTTS_b-1_4034-4069_4060.wav,2260,1892,368
18507,b-3_1568-1665_1627.wav,VTTS_b-3_1568-1665_1627.wav,5600,6026,-426
18508,b-4_151-300_292.wav,VTTS_b-4_151-300_292.wav,1440,1382,58
18509,b-1_2220-2320_2292.wav,VTTS_b-1_2220-2320_2292.wav,2580,3564,-984
18510,b-1_3228-3328_3228.wav,VTTS_b-1_3228-3328_3228.wav,6420,6211,209
18511,b-3_6301-6400_6309.wav,VTTS_b-3_6301-6400_6309.wav,5510,4957,553
18512,b-3_3889-4000_3968.wav,VTTS_b-3_3889-4000_3968.wav,3610,3646,-36
18513,b-3_4607-5008_4635.wav,VTTS_b-3_4607-5008_4635.wav,5270,5283,-13
18514,b-4_1014-1100_1094.wav,VTTS_b-4_1014-1100_1094.wav,7530,7036,494
18515,b-2_203-304_233.wav,VTTS_b-2_203-304_233.wav,2980,2810,170
18516,b-3_6401-6500_6481.wav,VTTS_b-3_6401-6500_6481.wav,4560,4087,473
18517,b-1_2321-2421_2411.wav,VTTS_b-1_2321-2421_2411.wav,2020,1660,360
18518,b-2_1699-1800_1779.wav,VTTS_b-2_1699-1800_1779.wav,1200,1138,62
18519,b-3_2524-2854_2593.wav,VTTS_b-3_2524-2854_2593.wav,5480,4899,581
18520,b-3_5639-5744_5735.wav,VTTS_b-3_5639-5744_5735.wav,4720,4075,645
18521,b-3_1862-1959_1909.wav,VTTS_b-3_1862-1959_1909.wav,6160,5364,796
18522,b-3_1666-1763_1680.wav,VTTS_b-3_1666-1763_1680.wav,9710,10762,-1052
18523,b-2_1801-1902_1823.wav,VTTS_b-2_1801-1902_1823.wav,3730,4516,-786
18524,b-2_101-202_167.wav,VTTS_b-2_101-202_167.wav,2270,2345,-75
18525,b-1_3834-3934_3916.wav,VTTS_b-1_3834-3934_3916.wav,3400,3332,68
18526,b-1_1616-1716_1702.wav,VTTS_b-1_1616-1716_1702.wav,2200,1858,342
18527,b-3_6016-6115_6097.wav,VTTS_b-3_6016-6115_6097.wav,2800,2752,48
18528,b-3_2855-2942_2923.wav,VTTS_b-3_2855-2942_2923.wav,6740,7279,-539
18529,b-3_5009-5427_5211.wav,VTTS_b-3_5009-5427_5211.wav,3460,3855,-395
18530,b-4_501-1014_994.wav,VTTS_b-4_501-1014_994.wav,4250,3808,442
18531,b-2_203-304_241.wav,VTTS_b-2_203-304_241.wav,3930,4400,-470
18532,b-3_4315-4424_4342.wav,VTTS_b-3_4315-4424_4342.wav,2140,2206,-66
18533,b-3_931-979_961.wav,VTTS_b-3_931-979_961.wav,6070,6177,-107
18534,b-2_1223-1324_1315.wav,VTTS_b-2_1223-1324_1315.wav,6770,6478,292
18535,b-4_53-150_150.wav,VTTS_b-4_53-150_150.wav,9010,7802,1208
18536,b-3_5639-5744_5642.wav,VTTS_b-3_5639-5744_5642.wav,3920,4853,-933
18537,b-1_4214-4285_4278.wav,VTTS_b-1_4214-4285_4278.wav,3940,4598,-658
18538,b-3_4498-4605_4514.wav,VTTS_b-3_4498-4605_4514.wav,2260,2252,8
18539,b-2_713-814_713.wav,VTTS_b-2_713-814_713.wav,1680,2101,-421
18540,b-3_1666-1763_1674.wav,VTTS_b-3_1666-1763_1674.wav,2960,3471,-511
18541,b-3_980-1077_1040.wav,VTTS_b-3_980-1077_1040.wav,3440,3529,-89
18542,b-2_2311-2412_2405.wav,VTTS_b-2_2311-2412_2405.wav,1520,9590,-8070
18543,b-4_2000-5164_4541.wav,VTTS_b-4_2000-5164_4541.wav,4438,4133,305
18544,b-1_2927-3025_2931.wav,VTTS_b-1_2927-3025_2931.wav,4070,4319,-249
18545,b-3_1321-1568_1456.wav,VTTS_b-3_1321-1568_1456.wav,6180,6525,-345
18546,b-4_2000-5164_2477.wav,VTTS_b-4_2000-5164_2477.wav,2700,3053,-353
18547,b-4_2000-5164_2093.wav,VTTS_b-4_2000-5164_2093.wav,3350,3320,30
18548,b-1_4358-4393_4374.wav,VTTS_b-1_4358-4393_4374.wav,4240,5108,-868
18549,b-3_98-195_120.wav,VTTS_b-3_98-195_120.wav,3220,2450,770
18550,b-3_2524-2854_2683.wav,VTTS_b-3_2524-2854_2683.wav,4650,4075,575
18551,b-2_1019-1120_1026.wav,VTTS_b-2_1019-1120_1026.wav,1700,1498,202
18552,b-3_6016-6115_6101.wav,VTTS_b-3_6016-6115_6101.wav,5000,4807,193
18553,b-4_2000-5164_5037.wav,VTTS_b-4_2000-5164_5037.wav,5077,4505,572
18554,b-1_2624-2724_2706.wav,VTTS_b-1_2624-2724_2706.wav,1730,2101,-371
18555,b-1_4106-4141_4140.wav,VTTS_b-1_4106-4141_4140.wav,2250,2380,-130
18556,b-4_2000-5164_3288.wav,VTTS_b-4_2000-5164_3288.wav,6883,6769,114
18557,b-3_2177-2266_2226.wav,VTTS_b-3_2177-2266_2226.wav,5280,4737,543
18558,b-3_5009-5427_5194.wav,VTTS_b-3_5009-5427_5194.wav,8330,7976,354
18559,b-1_2220-2320_2231.wav,VTTS_b-1_2220-2320_2231.wav,1200,1219,-19
18560,b-3_294-391_351.wav,VTTS_b-3_294-391_351.wav,5460,5016,444
18561,b-3_2089-2176_2116.wav,VTTS_b-3_2089-2176_2116.wav,4270,3971,299
18562,b-4_2000-5164_2500.wav,VTTS_b-4_2000-5164_2500.wav,4345,3704,641
18563,b-3_2524-2854_2832.wav,VTTS_b-3_2524-2854_2832.wav,8730,7953,777
18564,b-3_5853-5956_5879.wav,VTTS_b-3_5853-5956_5879.wav,6780,6269,511
18565,b-1_2523-2623_2618.wav,VTTS_b-1_2523-2623_2618.wav,1680,1823,-143
18566,b-2_1801-1902_1875.wav,VTTS_b-2_1801-1902_1875.wav,1560,1451,109
18567,b-4_1707-1813_1766.wav,VTTS_b-4_1707-1813_1766.wav,3200,3750,-550
18568,b-3_98-195_165.wav,VTTS_b-3_98-195_165.wav,5790,5445,345
18569,b-4_2000-5164_2546.wav,VTTS_b-4_2000-5164_2546.wav,5990,5433,557
18570,b-3_1079-1320_1283.wav,VTTS_b-3_1079-1320_1283.wav,8690,9404,-714
18571,b-3_5533-5638_5596.wav,VTTS_b-3_5533-5638_5596.wav,3340,3332,8
18572,b-1_3531-3631_3564.wav,VTTS_b-1_3531-3631_3564.wav,3400,2810,590
18573,b-3_5957-6015_5989.wav,VTTS_b-3_5957-6015_5989.wav,10940,10379,561
18574,b-3_5639-5744_5729.wav,VTTS_b-3_5639-5744_5729.wav,5110,4156,954
18575,b-3_5853-5956_5911.wav,VTTS_b-3_5853-5956_5911.wav,7820,7581,239
18576,b-2_2311-2412_2378.wav,VTTS_b-2_2311-2412_2378.wav,4960,3901,1059
18577,b-1_377-477_388.wav,VTTS_b-1_377-477_388.wav,830,1173,-343
18578,b-3_98-195_185.wav,VTTS_b-3_98-195_185.wav,2970,3657,-687
18579,b-4_2000-5164_3206.wav,VTTS_b-4_2000-5164_3206.wav,2570,2101,469
18580,b-3_6801-6900_6857.wav,VTTS_b-3_6801-6900_6857.wav,3400,3495,-95
18581,b-3_3279-3363_3294.wav,VTTS_b-3_3279-3363_3294.wav,8430,8742,-312
18582,b-1_3228-3328_3313.wav,VTTS_b-1_3228-3328_3313.wav,2040,2032,8
18583,b-3_5009-5427_5057.wav,VTTS_b-3_5009-5427_5057.wav,5060,4981,79
18584,b-4_401-500_439.wav,VTTS_b-4_401-500_439.wav,4590,4609,-19
18585,b-2_1903-2038_1952.wav,VTTS_b-2_1903-2038_1952.wav,1740,1730,10
18586,b-3_4207-4314_4307.wav,VTTS_b-3_4207-4314_4307.wav,5640,5201,439
18587,b-4_2000-5164_2399.wav,VTTS_b-4_2000-5164_2399.wav,8805,11389,-2584
18588,b-4_2000-5164_4933.wav,VTTS_b-4_2000-5164_4933.wav,3506,3320,186
18589,b-3_3538-3627_3614.wav,VTTS_b-3_3538-3627_3614.wav,5200,6606,-1406
18590,b-4_53-150_65.wav,VTTS_b-4_53-150_65.wav,8910,8603,307
18591,b-3_3889-4000_3919.wav,VTTS_b-3_3889-4000_3919.wav,3540,3483,57
18592,b-4_1506-1600_1594.wav,VTTS_b-4_1506-1600_1594.wav,5700,5503,197
18593,b-4_2000-5164_2628.wav,VTTS_b-4_2000-5164_2628.wav,3425,3611,-186
18594,b-3_3715-3802_3751.wav,VTTS_b-3_3715-3802_3751.wav,6130,5457,673
18595,b-2_407-508_451.wav,VTTS_b-2_407-508_451.wav,3020,3471,-451
18596,b-3_3803-3888_3847.wav,VTTS_b-3_3803-3888_3847.wav,3450,3553,-103
18597,b-2_2311-2412_2338.wav,VTTS_b-2_2311-2412_2338.wav,5850,6188,-338
18598,b-1_2119-2219_2204.wav,VTTS_b-1_2119-2219_2204.wav,4940,4238,702
18599,b-2_1801-1902_1808.wav,VTTS_b-2_1801-1902_1808.wav,4830,6711,-1881
18600,b-4_2000-5164_4954.wav,VTTS_b-4_2000-5164_4954.wav,2470,2368,102
18601,b-3_6116-6215_6133.wav,VTTS_b-3_6116-6215_6133.wav,4160,11610,-7450
18602,b-4_2000-5164_2615.wav,VTTS_b-4_2000-5164_2615.wav,1660,1614,46
18603,b-1_478-578_540.wav,VTTS_b-1_478-578_540.wav,1770,2020,-250
18604,b-1_4070-4105_4086.wav,VTTS_b-1_4070-4105_4086.wav,1230,1231,-1
18605,b-4_2000-5164_2176.wav,VTTS_b-4_2000-5164_2176.wav,4445,5364,-919
18606,b-2_2413-2500_2497.wav,VTTS_b-2_2413-2500_2497.wav,1280,1149,131
18607,b-4_2000-5164_2674.wav,VTTS_b-4_2000-5164_2674.wav,5810,6502,-692
18608,b-3_1-97_34.wav,VTTS_b-3_1-97_34.wav,2900,2961,-61
18609,b-4_2000-5164_4067.wav,VTTS_b-4_2000-5164_4067.wav,6398,6803,-405
18610,b-3_501-930_709.wav,VTTS_b-3_501-930_709.wav,3200,3448,-248
18611,b-4_151-300_288.wav,VTTS_b-4_151-300_288.wav,6190,9056,-2866
18612,b-1_2826-2926_2909.wav,VTTS_b-1_2826-2926_2909.wav,5560,4957,603
18613,b-3_5009-5427_5147.wav,VTTS_b-3_5009-5427_5147.wav,3130,2891,239
18614,b-3_1666-1763_1722.wav,VTTS_b-3_1666-1763_1722.wav,3120,2972,148
18615,b-3_1079-1320_1157.wav,VTTS_b-3_1079-1320_1157.wav,5500,5538,-38
18616,b-2_2040-2072_2053.wav,VTTS_b-2_2040-2072_2053.wav,1730,9474,-7744
18617,b-1_1717-1817_1723.wav,VTTS_b-1_1717-1817_1723.wav,1130,929,201
18618,b-1_2422-2522_2465.wav,VTTS_b-1_2422-2522_2465.wav,1650,1637,13
18619,b-1_2725-2825_2725.wav,VTTS_b-1_2725-2825_2725.wav,4690,4214,476
18620,b-3_501-930_710.wav,VTTS_b-3_501-930_710.wav,2410,2833,-423
18621,b-1_3026-3126_3097.wav,VTTS_b-1_3026-3126_3097.wav,4440,4737,-297
18622,b-4_501-1014_870.wav,VTTS_b-4_501-1014_870.wav,6940,7152,-212
18623,b-4_151-300_160.wav,VTTS_b-4_151-300_160.wav,2720,3042,-322
18624,b-1_2927-3025_2971.wav,VTTS_b-1_2927-3025_2971.wav,2320,2241,79
18625,b-1_3228-3328_3257.wav,VTTS_b-1_3228-3328_3257.wav,2960,2972,-12
18626,b-4_501-1014_607.wav,VTTS_b-4_501-1014_607.wav,1560,1614,-54
18627,b-4_1-52_46.wav,VTTS_b-4_1-52_46.wav,14760,11610,3150
18628,b-4_2000-5164_4175.wav,VTTS_b-4_2000-5164_4175.wav,7646,10855,-3209
18629,b-1_794-1009_1009.wav,VTTS_b-1_794-1009_1009.wav,1050,998,52
18630,b-3_1862-1959_1922.wav,VTTS_b-3_1862-1959_1922.wav,9830,9137,693
18631,b-1_2927-3025_2949.wav,VTTS_b-1_2927-3025_2949.wav,2660,2635,25
18632,b-1_1919-2017_1999.wav,VTTS_b-1_1919-2017_1999.wav,1590,1800,-210
18633,b-3_3279-3363_3295.wav,VTTS_b-3_3279-3363_3295.wav,3420,3065,355
18634,b-4_1901-2000_1988.wav,VTTS_b-4_1901-2000_1988.wav,2870,2496,374
18635,b-1_1717-1817_1730.wav,VTTS_b-1_1717-1817_1730.wav,2350,3100,-750
18636,b-1_1515-1615_1571.wav,VTTS_b-1_1515-1615_1571.wav,2250,2067,183
18637,b-2_509-610_584.wav,VTTS_b-2_509-610_584.wav,5970,5666,304
18638,b-1_794-1009_944.wav,VTTS_b-1_794-1009_944.wav,2160,1916,244
18639,b-2_509-610_548.wav,VTTS_b-2_509-610_548.wav,3750,3437,313
18640,b-4_1601-1706_1663.wav,VTTS_b-4_1601-1706_1663.wav,4090,3901,189
18641,b-2_1325-1426_1325.wav,VTTS_b-2_1325-1426_1325.wav,1800,3634,-1834
18642,b-1_3026-3126_3077.wav,VTTS_b-1_3026-3126_3077.wav,4670,4296,374
18643,b-4_301-400_362.wav,VTTS_b-4_301-400_362.wav,1530,1521,9
18644,b-1_2624-2724_2714.wav,VTTS_b-1_2624-2724_2714.wav,3830,4644,-814
18645,b-4_2000-5164_3410.wav,VTTS_b-4_2000-5164_3410.wav,2749,2659,90
18646,b-1_175-275_183.wav,VTTS_b-1_175-275_183.wav,3300,3344,-44
18647,b-2_1801-1902_1846.wav,VTTS_b-2_1801-1902_1846.wav,4910,4017,893
18648,b-3_2524-2854_2795.wav,VTTS_b-3_2524-2854_2795.wav,7600,6908,692
18649,b-1_4070-4105_4091.wav,VTTS_b-1_4070-4105_4091.wav,4110,4528,-418
18650,b-3_1960-2000_1969.wav,VTTS_b-3_1960-2000_1969.wav,10860,11610,-750
18651,b-1_1515-1615_1523.wav,VTTS_b-1_1515-1615_1523.wav,1910,1660,250
18652,b-1_74-174_98.wav,VTTS_b-1_74-174_98.wav,2110,2543,-433
18653,b-1_2523-2623_2597.wav,VTTS_b-1_2523-2623_2597.wav,1360,1300,60
18654,b-1_2725-2825_2808.wav,VTTS_b-1_2725-2825_2808.wav,1610,1474,136
18655,b-4_501-1014_887.wav,VTTS_b-4_501-1014_887.wav,9380,8522,858
18656,b-1_1919-2017_1925.wav,VTTS_b-1_1919-2017_1925.wav,1820,2055,-235
18657,b-4_1301-1400_1399.wav,VTTS_b-4_1301-1400_1399.wav,4560,3994,566
18658,b-3_5639-5744_5733.wav,VTTS_b-3_5639-5744_5733.wav,3180,3286,-106
18659,b-3_1862-1959_1953.wav,VTTS_b-3_1862-1959_1953.wav,5690,5712,-22
18660,b-3_4607-5008_4770.wav,VTTS_b-3_4607-5008_4770.wav,5350,6142,-792
18661,b-3_2943-3024_2968.wav,VTTS_b-3_2943-3024_2968.wav,5180,5132,48
18662,b-3_4498-4605_4580.wav,VTTS_b-3_4498-4605_4580.wav,6680,5724,956
18663,b-1_2624-2724_2658.wav,VTTS_b-1_2624-2724_2658.wav,2760,2972,-212
18664,b-4_1707-1813_1806.wav,VTTS_b-4_1707-1813_1806.wav,1990,1440,550
18665,b-1_2321-2421_2413.wav,VTTS_b-1_2321-2421_2413.wav,1360,1347,13
18666,b-3_1960-2000_1974.wav,VTTS_b-3_1960-2000_1974.wav,860,778,82
18667,b-2_917-1018_962.wav,VTTS_b-2_917-1018_962.wav,5240,6571,-1331
18668,b-2_815-916_855.wav,VTTS_b-2_815-916_855.wav,3700,5294,-1594
18669,b-4_1814-1900_1863.wav,VTTS_b-4_1814-1900_1863.wav,7720,11610,-3890
18670,b-3_501-930_846.wav,VTTS_b-3_501-930_846.wav,8820,8522,298
18671,b-4_2000-5164_2614.wav,VTTS_b-4_2000-5164_2614.wav,7330,8069,-739
18672,b-1_478-578_518.wav,VTTS_b-1_478-578_518.wav,1460,2055,-595
18673,b-2_1223-1324_1300.wav,VTTS_b-2_1223-1324_1300.wav,1060,1115,-55
18674,b-1_2624-2724_2682.wav,VTTS_b-1_2624-2724_2682.wav,3450,3553,-103
18675,b-3_4498-4605_4522.wav,VTTS_b-3_4498-4605_4522.wav,2490,3715,-1225
18676,b-4_2000-5164_4688.wav,VTTS_b-4_2000-5164_4688.wav,4312,4389,-77
18677,b-2_611-712_637.wav,VTTS_b-2_611-712_637.wav,2780,2357,423
18678,b-1_4034-4069_4059.wav,VTTS_b-1_4034-4069_4059.wav,2440,2717,-277
18679,b-3_4607-5008_4668.wav,VTTS_b-3_4607-5008_4668.wav,3090,2543,547
18680,b-1_2624-2724_2665.wav,VTTS_b-1_2624-2724_2665.wav,3540,3379,161
18681,b-2_1223-1324_1237.wav,VTTS_b-2_1223-1324_1237.wav,2260,3982,-1722
18682,b-3_501-930_786.wav,VTTS_b-3_501-930_786.wav,10150,9985,165
18683,b-1_3632-3732_3723.wav,VTTS_b-1_3632-3732_3723.wav,3450,3390,60
18684,b-1_3026-3126_3061.wav,VTTS_b-1_3026-3126_3061.wav,6070,5968,102
18685,b-3_2524-2854_2755.wav,VTTS_b-3_2524-2854_2755.wav,10930,10739,191
18686,b-4_2000-5164_3066.wav,VTTS_b-4_2000-5164_3066.wav,6389,6351,38
18687,b-4_1401-1505_1403.wav,VTTS_b-4_1401-1505_1403.wav,5490,5097,393
18688,b-1_686-793_745.wav,VTTS_b-1_686-793_745.wav,6640,7372,-732
18689,b-1_4070-4105_4071.wav,VTTS_b-1_4070-4105_4071.wav,1560,1579,-19
18690,b-1_1212-1312_1278.wav,VTTS_b-1_1212-1312_1278.wav,2950,2577,373
18691,b-1_3834-3934_3888.wav,VTTS_b-1_3834-3934_3888.wav,5400,5631,-231
18692,b-2_815-916_820.wav,VTTS_b-2_815-916_820.wav,3270,3541,-271
18693,b-4_301-400_321.wav,VTTS_b-4_301-400_321.wav,8900,9044,-144
18694,b-4_2000-5164_4666.wav,VTTS_b-4_2000-5164_4666.wav,3866,3773,93
18695,b-3_1-97_82.wav,VTTS_b-3_1-97_82.wav,4500,4621,-121
18696,b-3_4607-5008_4854.wav,VTTS_b-3_4607-5008_4854.wav,3030,2868,162
18697,b-3_4607-5008_4736.wav,VTTS_b-3_4607-5008_4736.wav,3740,4098,-358
18698,b-3_6116-6215_6123.wav,VTTS_b-3_6116-6215_6123.wav,1580,1509,71
18699,b-4_1301-1400_1368.wav,VTTS_b-4_1301-1400_1368.wav,6840,6548,292
18700,b-1_4286-4321_4293.wav,VTTS_b-1_4286-4321_4293.wav,4680,5735,-1055
18701,b-3_501-930_599.wav,VTTS_b-3_501-930_599.wav,4020,3785,235
18702,b-3_6116-6215_6121.wav,VTTS_b-3_6116-6215_6121.wav,3980,4714,-734
18703,b-4_501-1014_897.wav,VTTS_b-4_501-1014_897.wav,9190,9985,-795
18704,b-3_5853-5956_5945.wav,VTTS_b-3_5853-5956_5945.wav,4910,4284,626
18705,b-1_4286-4321_4286.wav,VTTS_b-1_4286-4321_4286.wav,2330,2566,-236
18706,b-4_2000-5164_4337.wav,VTTS_b-4_2000-5164_4337.wav,3276,3239,37
18707,b-3_4607-5008_4710.wav,VTTS_b-3_4607-5008_4710.wav,6270,7697,-1427
18708,b-3_1079-1320_1239.wav,VTTS_b-3_1079-1320_1239.wav,3440,3564,-124
18709,b-3_6900-7016_6914.wav,VTTS_b-3_6900-7016_6914.wav,5410,5526,-116
18710,b-3_294-391_331.wav,VTTS_b-3_294-391_331.wav,6990,8835,-1845
18711,b-1_4142-4177_4148.wav,VTTS_b-1_4142-4177_4148.wav,2390,2426,-36
18712,b-1_2321-2421_2409.wav,VTTS_b-1_2321-2421_2409.wav,1200,1207,-7
18713,b-4_53-150_72.wav,VTTS_b-4_53-150_72.wav,10580,9160,1420
18714,b-3_3715-3802_3789.wav,VTTS_b-3_3715-3802_3789.wav,3130,3065,65
18715,b-3_5009-5427_5425.wav,VTTS_b-3_5009-5427_5425.wav,3140,3262,-122
18716,b-1_1313-1413_1317.wav,VTTS_b-1_1313-1413_1317.wav,4460,4145,315
18717,b-1_794-1009_805.wav,VTTS_b-1_794-1009_805.wav,2550,2287,263
18718,b-3_1321-1568_1487.wav,VTTS_b-3_1321-1568_1487.wav,1050,1022,28
18719,b-4_1901-2000_1985.wav,VTTS_b-4_1901-2000_1985.wav,1870,1800,70
18720,b-2_2040-2072_2046.wav,VTTS_b-2_2040-2072_2046.wav,3030,3785,-755
18721,b-3_6900-7016_6977.wav,VTTS_b-3_6900-7016_6977.wav,3990,3785,205
18722,b-4_2000-5164_4408.wav,VTTS_b-4_2000-5164_4408.wav,8649,7941,708
18723,b-1_2220-2320_2243.wav,VTTS_b-1_2220-2320_2243.wav,3620,2798,822
18724,b-1_1515-1615_1574.wav,VTTS_b-1_1515-1615_1574.wav,3730,3379,351
18725,b-1_377-477_408.wav,VTTS_b-1_377-477_408.wav,1600,1428,172
18726,b-3_5533-5638_5547.wav,VTTS_b-3_5533-5638_5547.wav,5600,5770,-170
18727,b-4_2000-5164_4347.wav,VTTS_b-4_2000-5164_4347.wav,6775,6885,-110
18728,b-4_2000-5164_2951.wav,VTTS_b-4_2000-5164_2951.wav,7285,8162,-877
18729,b-4_1506-1600_1534.wav,VTTS_b-4_1506-1600_1534.wav,4410,4087,323
18730,b-3_4607-5008_4862.wav,VTTS_b-3_4607-5008_4862.wav,3160,3088,72
18731,b-4_501-1014_762.wav,VTTS_b-4_501-1014_762.wav,2870,2937,-67
18732,b-1_4214-4285_4282.wav,VTTS_b-1_4214-4285_4282.wav,4110,6502,-2392
18733,b-1_3733-3833_3833.wav,VTTS_b-1_3733-3833_3833.wav,2290,2218,72
18734,b-1_377-477_416.wav,VTTS_b-1_377-477_416.wav,1820,1753,67
18735,b-1_4466-4498_4471.wav,VTTS_b-1_4466-4498_4471.wav,4240,4365,-125
18736,b-2_1903-2038_1962.wav,VTTS_b-2_1903-2038_1962.wav,2340,1393,947
18737,b-1_1919-2017_1978.wav,VTTS_b-1_1919-2017_1978.wav,1300,1312,-12
18738,b-4_1401-1505_1415.wav,VTTS_b-4_1401-1505_1415.wav,940,1068,-128
18739,b-4_501-1014_760.wav,VTTS_b-4_501-1014_760.wav,11390,9752,1638
18740,b-4_2000-5164_2073.wav,VTTS_b-4_2000-5164_2073.wav,5085,6026,-941
18741,b-3_6116-6215_6131.wav,VTTS_b-3_6116-6215_6131.wav,2670,2403,267
18742,b-3_2434-2523_2444.wav,VTTS_b-3_2434-2523_2444.wav,5840,6293,-453
18743,b-4_1-52_3.wav,VTTS_b-4_1-52_3.wav,3890,4865,-975
18744,b-1_2321-2421_2404.wav,VTTS_b-1_2321-2421_2404.wav,2920,2659,261
18745,b-2_2209-2310_2306.wav,VTTS_b-2_2209-2310_2306.wav,1290,1509,-219
18746,b-1_2927-3025_2942.wav,VTTS_b-1_2927-3025_2942.wav,3570,3437,133
18747,b-4_501-1014_968.wav,VTTS_b-4_501-1014_968.wav,3680,4168,-488
18748,b-2_203-304_237.wav,VTTS_b-2_203-304_237.wav,2270,2577,-307
18749,b-4_2000-5164_4167.wav,VTTS_b-4_2000-5164_4167.wav,2488,2485,3
18750,b-1_175-275_226.wav,VTTS_b-1_175-275_226.wav,1610,1440,170
18751,b-3_196-293_233.wav,VTTS_b-3_196-293_233.wav,1590,1614,-24
18752,b-3_1960-2000_1984.wav,VTTS_b-3_1960-2000_1984.wav,4710,4540,170
18753,b-1_2523-2623_2543.wav,VTTS_b-1_2523-2623_2543.wav,2190,2148,42
18754,b-2_1121-1222_1158.wav,VTTS_b-2_1121-1222_1158.wav,3370,2438,932
18755,b-1_4178-4213_4196.wav,VTTS_b-1_4178-4213_4196.wav,3880,4516,-636
18756,b-3_3715-3802_3783.wav,VTTS_b-3_3715-3802_3783.wav,8030,7686,344
18757,b-4_2000-5164_2177.wav,VTTS_b-4_2000-5164_2177.wav,5430,5759,-329
18758,b-3_4607-5008_4974.wav,VTTS_b-3_4607-5008_4974.wav,6710,6525,185
18759,b-3_2434-2523_2488.wav,VTTS_b-3_2434-2523_2488.wav,7130,11610,-4480
18760,b-2_203-304_254.wav,VTTS_b-2_203-304_254.wav,1860,1985,-125
18761,b-1_794-1009_898.wav,VTTS_b-1_794-1009_898.wav,1950,2566,-616
18762,b-2_1121-1222_1160.wav,VTTS_b-2_1121-1222_1160.wav,1780,2844,-1064
18763,b-2_509-610_527.wav,VTTS_b-2_509-610_527.wav,2140,2287,-147
18764,b-1_686-793_751.wav,VTTS_b-1_686-793_751.wav,1890,1695,195
18765,b-4_2000-5164_3413.wav,VTTS_b-4_2000-5164_3413.wav,4569,4748,-179
18766,b-1_2927-3025_2933.wav,VTTS_b-1_2927-3025_2933.wav,3570,4505,-935
18767,b-3_3279-3363_3311.wav,VTTS_b-3_3279-3363_3311.wav,5530,5538,-8
18768,b-1_478-578_566.wav,VTTS_b-1_478-578_566.wav,2240,2043,197
18769,b-3_5853-5956_5953.wav,VTTS_b-3_5853-5956_5953.wav,4890,4795,95
18770,b-2_1903-2038_1976.wav,VTTS_b-2_1903-2038_1976.wav,3240,3599,-359
18771,b-3_1666-1763_1753.wav,VTTS_b-3_1666-1763_1753.wav,3460,3274,186
18772,b-3_4104-4206_4146.wav,VTTS_b-3_4104-4206_4146.wav,4040,3947,93
18773,b-3_4001-4103_4043.wav,VTTS_b-3_4001-4103_4043.wav,3620,3193,427
18774,b-3_98-195_177.wav,VTTS_b-3_98-195_177.wav,6220,5793,427
18775,b-4_2000-5164_4061.wav,VTTS_b-4_2000-5164_4061.wav,5774,8104,-2330
18776,b-4_1014-1100_1019.wav,VTTS_b-4_1014-1100_1019.wav,5980,5782,198
18777,b-2_2107-2193_2190.wav,VTTS_b-2_2107-2193_2190.wav,1790,1730,60
18778,b-3_4315-4424_4324.wav,VTTS_b-3_4315-4424_4324.wav,7620,8986,-1366
18779,b-4_2000-5164_2452.wav,VTTS_b-4_2000-5164_2452.wav,4200,4110,90
18780,b-1_4286-4321_4319.wav,VTTS_b-1_4286-4321_4319.wav,3320,3251,69
18781,b-3_931-979_964.wav,VTTS_b-3_931-979_964.wav,4260,4261,-1
18782,b-4_2000-5164_2912.wav,VTTS_b-4_2000-5164_2912.wav,4567,4331,236
18783,b-3_1079-1320_1149.wav,VTTS_b-3_1079-1320_1149.wav,2920,2856,64
18784,b-3_1960-2000_1986.wav,VTTS_b-3_1960-2000_1986.wav,7100,7407,-307
18785,b-4_2000-5164_5157.wav,VTTS_b-4_2000-5164_5157.wav,7453,7245,208
18786,b-3_4607-5008_4991.wav,VTTS_b-3_4607-5008_4991.wav,5160,5108,52
18787,b-3_392-500_491.wav,VTTS_b-3_392-500_491.wav,5010,5631,-621
18788,b-3_5853-5956_5897.wav,VTTS_b-3_5853-5956_5897.wav,2610,2252,358
18789,b-2_1427-1562_1543.wav,VTTS_b-2_1427-1562_1543.wav,2610,2334,276
18790,b-1_1313-1413_1417.wav,VTTS_b-1_1313-1413_1417.wav,3320,3146,174
18791,b-1_1616-1716_1643.wav,VTTS_b-1_1616-1716_1643.wav,3780,2810,970
18792,b-1_1515-1615_1537.wav,VTTS_b-1_1515-1615_1537.wav,1540,1300,240
18793,b-4_2000-5164_3075.wav,VTTS_b-4_2000-5164_3075.wav,9688,11505,-1817
18794,b-3_4425-4497_4464.wav,VTTS_b-3_4425-4497_4464.wav,5490,5132,358
18795,b-3_196-293_210.wav,VTTS_b-3_196-293_210.wav,5820,5944,-124
18796,b-2_1427-1562_1465.wav,VTTS_b-2_1427-1562_1465.wav,3430,3251,179
18797,b-2_1-100_42.wav,VTTS_b-2_1-100_42.wav,1520,1637,-117
18798,b-4_1101-1220_1165.wav,VTTS_b-4_1101-1220_1165.wav,1950,1858,92
18799,b-2_611-712_715.wav,VTTS_b-2_611-712_715.wav,1760,4331,-2571
18800,b-3_4607-5008_4805.wav,VTTS_b-3_4607-5008_4805.wav,5660,6490,-830
18801,b-2_2413-2500_2476.wav,VTTS_b-2_2413-2500_2476.wav,2600,4203,-1603
18802,b-3_5745-5852_5851.wav,VTTS_b-3_5745-5852_5851.wav,11760,11610,150
18803,b-4_2000-5164_2916.wav,VTTS_b-4_2000-5164_2916.wav,4389,4214,175
18804,b-3_5533-5638_5604.wav,VTTS_b-3_5533-5638_5604.wav,2790,5108,-2318
18805,b-3_5009-5427_5421.wav,VTTS_b-3_5009-5427_5421.wav,2280,2299,-19
18806,b-1_1010-1110_1098.wav,VTTS_b-1_1010-1110_1098.wav,4680,4377,303
18807,b-4_2000-5164_4919.wav,VTTS_b-4_2000-5164_4919.wav,3600,3773,-173
18808,b-1_276-376_333.wav,VTTS_b-1_276-376_333.wav,2920,2345,575
18809,b-3_5428-5533_5519.wav,VTTS_b-3_5428-5533_5519.wav,7270,7454,-184
18810,b-1_276-376_320.wav,VTTS_b-1_276-376_320.wav,2640,3738,-1098
18811,b-3_1321-1568_1489.wav,VTTS_b-3_1321-1568_1489.wav,2940,2833,107
18812,b-1_3935-4033_3955.wav,VTTS_b-1_3935-4033_3955.wav,1980,2067,-87
18813,b-2_1-100_53.wav,VTTS_b-2_1-100_53.wav,2050,1950,100
18814,b-3_6016-6115_6088.wav,VTTS_b-3_6016-6115_6088.wav,10750,11041,-291
18815,b-3_6217-6274_6267.wav,VTTS_b-3_6217-6274_6267.wav,3380,3135,245
18816,b-4_2000-5164_5119.wav,VTTS_b-4_2000-5164_5119.wav,5776,5886,-110
18817,b-2_815-916_876.wav,VTTS_b-2_815-916_876.wav,3470,3750,-280
18818,b-1_1919-2017_1963.wav,VTTS_b-1_1919-2017_1963.wav,2600,2589,11
18819,b-2_917-1018_964.wav,VTTS_b-2_917-1018_964.wav,3270,3193,77
18820,b-4_401-500_441.wav,VTTS_b-4_401-500_441.wav,2390,2287,103
18821,b-3_4498-4605_4521.wav,VTTS_b-3_4498-4605_4521.wav,4630,4040,590
18822,b-2_1019-1120_1080.wav,VTTS_b-2_1019-1120_1080.wav,1900,1985,-85
18823,b-1_2220-2320_2258.wav,VTTS_b-1_2220-2320_2258.wav,2020,2229,-209
18824,b-3_501-930_758.wav,VTTS_b-3_501-930_758.wav,5480,5654,-174
18825,b-3_2434-2523_2494.wav,VTTS_b-3_2434-2523_2494.wav,4260,4261,-1
18826,b-3_6301-6400_6392.wav,VTTS_b-3_6301-6400_6392.wav,4220,4191,29
18827,b-4_1301-1400_1366.wav,VTTS_b-4_1301-1400_1366.wav,5790,5248,542
18828,b-4_2000-5164_2683.wav,VTTS_b-4_2000-5164_2683.wav,2167,1474,693
18829,b-4_501-1014_882.wav,VTTS_b-4_501-1014_882.wav,8590,8034,556
18830,b-3_4001-4103_4029.wav,VTTS_b-3_4001-4103_4029.wav,6480,6571,-91
18831,b-4_1901-2000_1918.wav,VTTS_b-4_1901-2000_1918.wav,8610,7442,1168
18832,b-4_501-1014_925.wav,VTTS_b-4_501-1014_925.wav,980,906,74
18833,b-3_6016-6115_6085.wav,VTTS_b-3_6016-6115_6085.wav,2800,2914,-114
18834,b-3_2350-2433_2386.wav,VTTS_b-3_2350-2433_2386.wav,8970,8858,112
18835,b-4_2000-5164_4047.wav,VTTS_b-4_2000-5164_4047.wav,2641,2136,505
18836,b-3_4104-4206_4150.wav,VTTS_b-3_4104-4206_4150.wav,5170,5062,108
18837,b-4_2000-5164_4998.wav,VTTS_b-4_2000-5164_4998.wav,8390,7245,1145
18838,b-4_2000-5164_4561.wav,VTTS_b-4_2000-5164_4561.wav,4347,4354,-7
18839,b-1_1313-1413_1320.wav,VTTS_b-1_1313-1413_1320.wav,3310,2775,535
18840,b-2_101-202_190.wav,VTTS_b-2_101-202_190.wav,3680,4760,-1080
18841,b-4_2000-5164_3446.wav,VTTS_b-4_2000-5164_3446.wav,3543,3715,-172
18842,b-3_501-930_693.wav,VTTS_b-3_501-930_693.wav,7080,7036,44
18843,b-4_301-400_383.wav,VTTS_b-4_301-400_383.wav,6630,5817,813
18844,b-4_501-1014_790.wav,VTTS_b-4_501-1014_790.wav,3250,2508,742
18845,b-3_2855-2942_2862.wav,VTTS_b-3_2855-2942_2862.wav,5520,6060,-540
18846,b-1_4142-4177_4161.wav,VTTS_b-1_4142-4177_4161.wav,1780,1950,-170
18847,b-3_980-1077_1011.wav,VTTS_b-3_980-1077_1011.wav,3970,3599,371
18848,b-2_2413-2500_2436.wav,VTTS_b-2_2413-2500_2436.wav,3950,4574,-624
18849,b-3_5745-5852_5802.wav,VTTS_b-3_5745-5852_5802.wav,6120,5817,303
18850,b-4_1506-1600_1588.wav,VTTS_b-4_1506-1600_1588.wav,5480,5085,395
18851,b-2_509-610_546.wav,VTTS_b-2_509-610_546.wav,4570,4981,-411
18852,b-2_917-1018_998.wav,VTTS_b-2_917-1018_998.wav,1470,1358,112
18853,b-4_1814-1900_1825.wav,VTTS_b-4_1814-1900_1825.wav,6040,6560,-520
18854,b-1_3531-3631_3601.wav,VTTS_b-1_3531-3631_3601.wav,3720,4748,-1028
18855,b-4_2000-5164_4560.wav,VTTS_b-4_2000-5164_4560.wav,6418,5817,601
18856,b-2_407-508_484.wav,VTTS_b-2_407-508_484.wav,3800,3344,456
18857,b-4_2000-5164_3746.wav,VTTS_b-4_2000-5164_3746.wav,2450,2543,-93
18858,b-3_196-293_259.wav,VTTS_b-3_196-293_259.wav,9770,9660,110
18859,b-3_1321-1568_1535.wav,VTTS_b-3_1321-1568_1535.wav,3490,3599,-109
18860,b-4_151-300_251.wav,VTTS_b-4_151-300_251.wav,2760,2647,113
18861,b-3_1079-1320_1139.wav,VTTS_b-3_1079-1320_1139.wav,4010,3170,840
18862,b-1_74-174_120.wav,VTTS_b-1_74-174_120.wav,2600,1753,847
18863,b-1_175-275_200.wav,VTTS_b-1_175-275_200.wav,1550,1498,52
18864,b-1_2927-3025_2986.wav,VTTS_b-1_2927-3025_2986.wav,2470,2775,-305
18865,b-4_1707-1813_1733.wav,VTTS_b-4_1707-1813_1733.wav,1540,2136,-596
18866,b-1_3632-3732_3632.wav,VTTS_b-1_3632-3732_3632.wav,1910,2276,-366
18867,b-4_1401-1505_1432.wav,VTTS_b-4_1401-1505_1432.wav,2320,2171,149
18868,b-3_5639-5744_5696.wav,VTTS_b-3_5639-5744_5696.wav,4560,4272,288
18869,b-4_501-1014_824.wav,VTTS_b-4_501-1014_824.wav,4830,4261,569
18870,b-1_1616-1716_1690.wav,VTTS_b-1_1616-1716_1690.wav,1690,1672,18
18871,b-4_1601-1706_1646.wav,VTTS_b-4_1601-1706_1646.wav,7670,8545,-875
18872,b-2_1-100_51.wav,VTTS_b-2_1-100_51.wav,2500,3715,-1215
18873,b-3_3198-3278_3222.wav,VTTS_b-3_3198-3278_3222.wav,1820,1892,-72
18874,b-3_1321-1568_1411.wav,VTTS_b-3_1321-1568_1411.wav,2580,2403,177
18875,b-2_2040-2072_2047.wav,VTTS_b-2_2040-2072_2047.wav,2810,2403,407
18876,b-3_4607-5008_4637.wav,VTTS_b-3_4607-5008_4637.wav,7970,7628,342
18877,b-3_5009-5427_5251.wav,VTTS_b-3_5009-5427_5251.wav,5100,5155,-55
18878,b-3_3715-3802_3780.wav,VTTS_b-3_3715-3802_3780.wav,7580,8255,-675
18879,b-3_2524-2854_2691.wav,VTTS_b-3_2524-2854_2691.wav,3050,2798,252
18880,b-4_2000-5164_3630.wav,VTTS_b-4_2000-5164_3630.wav,2844,3158,-314
18881,b-2_1223-1324_1260.wav,VTTS_b-2_1223-1324_1260.wav,6110,5097,1013
18882,b-2_203-304_284.wav,VTTS_b-2_203-304_284.wav,2930,3831,-901
18883,b-1_1-73_12.wav,VTTS_b-1_1-73_12.wav,5730,7070,-1340
18884,b-1_2220-2320_2286.wav,VTTS_b-1_2220-2320_2286.wav,1890,1974,-84
18885,b-4_2000-5164_2904.wav,VTTS_b-4_2000-5164_2904.wav,2601,2438,163
18886,b-3_1862-1959_1925.wav,VTTS_b-3_1862-1959_1925.wav,4310,4191,119
18887,b-1_3935-4033_3984.wav,VTTS_b-1_3935-4033_3984.wav,2510,2055,455
18888,b-4_2000-5164_4213.wav,VTTS_b-4_2000-5164_4213.wav,3639,3738,-99
18889,b-1_2826-2926_2880.wav,VTTS_b-1_2826-2926_2880.wav,3300,3680,-380
18890,b-1_1414-1514_1513.wav,VTTS_b-1_1414-1514_1513.wav,1720,1556,164
18891,b-3_5009-5427_5303.wav,VTTS_b-3_5009-5427_5303.wav,8170,8034,136
18892,b-3_3889-4000_3945.wav,VTTS_b-3_3889-4000_3945.wav,4880,4737,143
18893,b-2_611-712_686.wav,VTTS_b-2_611-712_686.wav,1650,1614,36
18894,b-3_3025-3111_3100.wav,VTTS_b-3_3025-3111_3100.wav,4150,4331,-181
18895,b-4_501-1014_819.wav,VTTS_b-4_501-1014_819.wav,2800,2926,-126
18896,b-3_5009-5427_5326.wav,VTTS_b-3_5009-5427_5326.wav,5820,5828,-8
18897,b-4_2000-5164_2281.wav,VTTS_b-4_2000-5164_2281.wav,2440,2368,72
18898,b-3_5745-5852_5830.wav,VTTS_b-3_5745-5852_5830.wav,5440,6165,-725
18899,b-4_2000-5164_2796.wav,VTTS_b-4_2000-5164_2796.wav,3630,3843,-213
18900,b-1_1010-1110_1104.wav,VTTS_b-1_1010-1110_1104.wav,2150,1834,316
18901,b-2_1597-1698_1677.wav,VTTS_b-2_1597-1698_1677.wav,9030,11610,-2580
18902,b-3_3889-4000_3980.wav,VTTS_b-3_3889-4000_3980.wav,5140,5480,-340
18903,b-3_5745-5852_5758.wav,VTTS_b-3_5745-5852_5758.wav,3640,3878,-238
18904,b-3_1079-1320_1229.wav,VTTS_b-3_1079-1320_1229.wav,4840,4528,312
18905,b-1_2119-2219_2211.wav,VTTS_b-1_2119-2219_2211.wav,1600,1544,56
18906,b-3_4498-4605_4570.wav,VTTS_b-3_4498-4605_4570.wav,3060,2902,158
18907,b-2_2311-2412_2406.wav,VTTS_b-2_2311-2412_2406.wav,4440,4481,-41
18908,b-1_4322-4357_4354.wav,VTTS_b-1_4322-4357_4354.wav,1830,1927,-97
18909,b-4_1301-1400_1374.wav,VTTS_b-4_1301-1400_1374.wav,3860,3692,168
18910,b-2_917-1018_949.wav,VTTS_b-2_917-1018_949.wav,1760,3100,-1340
18911,b-3_501-930_903.wav,VTTS_b-3_501-930_903.wav,5850,5480,370
18912,b-3_1079-1320_1234.wav,VTTS_b-3_1079-1320_1234.wav,2400,2368,32
18913,b-1_3834-3934_3866.wav,VTTS_b-1_3834-3934_3866.wav,1250,1637,-387
18914,b-1_4142-4177_4157.wav,VTTS_b-1_4142-4177_4157.wav,1350,1509,-159
18915,b-3_6217-6274_6271.wav,VTTS_b-3_6217-6274_6271.wav,3130,3181,-51
18916,b-3_6601-6700_6637.wav,VTTS_b-3_6601-6700_6637.wav,10160,9834,326
18917,b-4_2000-5164_2860.wav,VTTS_b-4_2000-5164_2860.wav,8615,8104,511
18918,b-1_794-1009_796.wav,VTTS_b-1_794-1009_796.wav,3710,3889,-179
18919,b-4_2000-5164_3481.wav,VTTS_b-4_2000-5164_3481.wav,6319,5364,955
18920,b-2_1699-1800_1750.wav,VTTS_b-2_1699-1800_1750.wav,1510,2241,-731
18921,b-3_5428-5533_5502.wav,VTTS_b-3_5428-5533_5502.wav,5190,5283,-93
18922,b-4_2000-5164_4844.wav,VTTS_b-4_2000-5164_4844.wav,5959,5770,189
18923,b-1_3329-3429_3381.wav,VTTS_b-1_3329-3429_3381.wav,1650,1405,245
18924,b-1_3935-4033_3940.wav,VTTS_b-1_3935-4033_3940.wav,3750,4005,-255
18925,b-1_2624-2724_2646.wav,VTTS_b-1_2624-2724_2646.wav,1880,1788,92
18926,b-4_2000-5164_3825.wav,VTTS_b-4_2000-5164_3825.wav,2805,2345,460
18927,b-4_501-1014_922.wav,VTTS_b-4_501-1014_922.wav,7590,6908,682
18928,b-1_1414-1514_1427.wav,VTTS_b-1_1414-1514_1427.wav,1060,1138,-78
18929,b-1_4178-4213_4186.wav,VTTS_b-1_4178-4213_4186.wav,2100,2345,-245
18930,b-4_53-150_76.wav,VTTS_b-4_53-150_76.wav,9750,9439,311
18931,b-1_2826-2926_2881.wav,VTTS_b-1_2826-2926_2881.wav,4820,4528,292
18932,b-4_2000-5164_4747.wav,VTTS_b-4_2000-5164_4747.wav,1325,1149,176
18933,b-3_6401-6500_6401.wav,VTTS_b-3_6401-6500_6401.wav,5680,7372,-1692
18934,b-3_501-930_721.wav,VTTS_b-3_501-930_721.wav,4770,5840,-1070
18935,b-3_4207-4314_4260.wav,VTTS_b-3_4207-4314_4260.wav,6460,6966,-506
18936,b-1_1414-1514_1509.wav,VTTS_b-1_1414-1514_1509.wav,4180,4087,93
18937,b-3_5745-5852_5775.wav,VTTS_b-3_5745-5852_5775.wav,1510,1625,-115
18938,b-2_407-508_466.wav,VTTS_b-2_407-508_466.wav,2850,2635,215
18939,b-1_3127-3227_3143.wav,VTTS_b-1_3127-3227_3143.wav,1600,1567,33
18940,b-4_2000-5164_4546.wav,VTTS_b-4_2000-5164_4546.wav,5056,4516,540
18941,b-4_501-1014_967.wav,VTTS_b-4_501-1014_967.wav,2850,2473,377
18942,b-3_6701-6800_6718.wav,VTTS_b-3_6701-6800_6718.wav,10030,9102,928
18943,b-3_4498-4605_4533.wav,VTTS_b-3_4498-4605_4533.wav,3570,2984,586
18944,b-1_1818-1918_1894.wav,VTTS_b-1_1818-1918_1894.wav,2860,3100,-240
18945,b-3_6701-6800_6752.wav,VTTS_b-3_6701-6800_6752.wav,4480,6130,-1650
18946,b-3_501-930_854.wav,VTTS_b-3_501-930_854.wav,2170,2310,-140
18947,b-4_501-1014_532.wav,VTTS_b-4_501-1014_532.wav,6930,6699,231
18948,b-4_2000-5164_3912.wav,VTTS_b-4_2000-5164_3912.wav,9344,10542,-1198
18949,b-1_2927-3025_2937.wav,VTTS_b-1_2927-3025_2937.wav,3810,5143,-1333
18950,b-4_2000-5164_4548.wav,VTTS_b-4_2000-5164_4548.wav,5491,5074,417
18951,b-2_509-610_558.wav,VTTS_b-2_509-610_558.wav,4190,4087,103
18952,b-1_3834-3934_3895.wav,VTTS_b-1_3834-3934_3895.wav,1680,1788,-108
18953,b-1_1616-1716_1641.wav,VTTS_b-1_1616-1716_1641.wav,4230,4365,-135
18954,b-3_931-979_946.wav,VTTS_b-3_931-979_946.wav,4530,4470,60
18955,b-4_2000-5164_3680.wav,VTTS_b-4_2000-5164_3680.wav,6484,5561,923
18956,b-3_2524-2854_2760.wav,VTTS_b-3_2524-2854_2760.wav,2810,2786,24
18957,b-1_2422-2522_2451.wav,VTTS_b-1_2422-2522_2451.wav,1410,1591,-181
18958,b-1_2826-2926_2901.wav,VTTS_b-1_2826-2926_2901.wav,4870,5666,-796
18959,b-4_2000-5164_5015.wav,VTTS_b-4_2000-5164_5015.wav,1740,1463,277
18960,b-3_5853-5956_5931.wav,VTTS_b-3_5853-5956_5931.wav,7700,8533,-833
18961,b-3_6601-6700_6628.wav,VTTS_b-3_6601-6700_6628.wav,5100,6235,-1135
18962,b-1_3935-4033_4017.wav,VTTS_b-1_3935-4033_4017.wav,2700,2705,-5
18963,b-1_1616-1716_1617.wav,VTTS_b-1_1616-1716_1617.wav,2170,2078,92
18964,b-3_5853-5956_5926.wav,VTTS_b-3_5853-5956_5926.wav,7500,8359,-859
18965,b-4_2000-5164_2046.wav,VTTS_b-4_2000-5164_2046.wav,4245,5085,-840
18966,b-2_1-100_4.wav,VTTS_b-2_1-100_4.wav,7420,8777,-1357
18967,b-3_4104-4206_4200.wav,VTTS_b-3_4104-4206_4200.wav,7210,7883,-673
18968,b-3_2089-2176_2104.wav,VTTS_b-3_2089-2176_2104.wav,5490,7187,-1697
18969,b-4_2000-5164_4339.wav,VTTS_b-4_2000-5164_4339.wav,6111,6281,-170
18970,b-4_2000-5164_3674.wav,VTTS_b-4_2000-5164_3674.wav,7042,8429,-1387
18971,b-1_3935-4033_3975.wav,VTTS_b-1_3935-4033_3975.wav,2210,2473,-263
18972,b-1_1919-2017_1932.wav,VTTS_b-1_1919-2017_1932.wav,3780,3518,262
18973,b-4_2000-5164_3283.wav,VTTS_b-4_2000-5164_3283.wav,9739,9276,463
18974,b-3_4207-4314_4305.wav,VTTS_b-3_4207-4314_4305.wav,5820,5770,50
18975,b-1_4322-4357_4347.wav,VTTS_b-1_4322-4357_4347.wav,4070,4377,-307
18976,b-3_6701-6800_6763.wav,VTTS_b-3_6701-6800_6763.wav,15240,11610,3630
18977,b-1_3935-4033_3959.wav,VTTS_b-1_3935-4033_3959.wav,1110,1207,-97
18978,b-3_2524-2854_2854.wav,VTTS_b-3_2524-2854_2854.wav,3010,4667,-1657
18979,b-3_1862-1959_1947.wav,VTTS_b-3_1862-1959_1947.wav,8120,7616,504
18980,b-1_1818-1918_1898.wav,VTTS_b-1_1818-1918_1898.wav,2050,1950,100
18981,b-3_1568-1665_1579.wav,VTTS_b-3_1568-1665_1579.wav,4120,4690,-570
18982,b-3_6900-7016_7002.wav,VTTS_b-3_6900-7016_7002.wav,4840,4690,150
18983,b-3_3454-3537_3466.wav,VTTS_b-3_3454-3537_3466.wav,8390,7941,449
18984,b-3_6900-7016_6979.wav,VTTS_b-3_6900-7016_6979.wav,5160,4122,1038
18985,b-4_2000-5164_3071.wav,VTTS_b-4_2000-5164_3071.wav,5327,5294,33
18986,b-1_2624-2724_2640.wav,VTTS_b-1_2624-2724_2640.wav,950,987,-37
18987,b-2_2209-2310_2259.wav,VTTS_b-2_2209-2310_2259.wav,1430,1416,14
18988,b-4_2000-5164_4516.wav,VTTS_b-4_2000-5164_4516.wav,4150,3123,1027
18989,b-3_4315-4424_4359.wav,VTTS_b-3_4315-4424_4359.wav,5660,5259,401
18990,b-1_1919-2017_1974.wav,VTTS_b-1_1919-2017_1974.wav,5980,5271,709
18991,b-3_501-930_891.wav,VTTS_b-3_501-930_891.wav,8720,8371,349
18992,b-3_294-391_326.wav,VTTS_b-3_294-391_326.wav,7450,9079,-1629
18993,b-3_2177-2266_2257.wav,VTTS_b-3_2177-2266_2257.wav,5500,8301,-2801
18994,b-3_4498-4605_4582.wav,VTTS_b-3_4498-4605_4582.wav,6020,6699,-679
18995,b-1_2422-2522_2486.wav,VTTS_b-1_2422-2522_2486.wav,3300,3262,38
18996,b-3_1666-1763_1724.wav,VTTS_b-3_1666-1763_1724.wav,2540,1834,706
18997,b-3_4607-5008_4920.wav,VTTS_b-3_4607-5008_4920.wav,7180,7070,110
18998,b-3_2089-2176_2136.wav,VTTS_b-3_2089-2176_2136.wav,4030,4203,-173
18999,b-1_686-793_773.wav,VTTS_b-1_686-793_773.wav,1750,1649,101
19000,b-3_5009-5427_5223.wav,VTTS_b-3_5009-5427_5223.wav,2860,2601,259
19001,b-4_2000-5164_2552.wav,VTTS_b-4_2000-5164_2552.wav,8260,8858,-598
19002,b-1_1717-1817_1739.wav,VTTS_b-1_1717-1817_1739.wav,1510,1486,24
19003,b-1_276-376_341.wav,VTTS_b-1_276-376_341.wav,3130,4737,-1607
19004,b-3_196-293_275.wav,VTTS_b-3_196-293_275.wav,5610,5201,409
19005,b-4_501-1014_589.wav,VTTS_b-4_501-1014_589.wav,8660,7814,846
19006,b-4_2000-5164_5035.wav,VTTS_b-4_2000-5164_5035.wav,5382,5341,41
19007,b-3_392-500_466.wav,VTTS_b-3_392-500_466.wav,5800,5317,483
19008,b-4_2000-5164_2503.wav,VTTS_b-4_2000-5164_2503.wav,3940,3738,202
19009,b-3_2350-2433_2399.wav,VTTS_b-3_2350-2433_2399.wav,2670,2380,290
19010,b-3_6601-6700_6649.wav,VTTS_b-3_6601-6700_6649.wav,6780,6664,116
19011,b-3_3889-4000_3981.wav,VTTS_b-3_3889-4000_3981.wav,4630,4725,-95
19012,b-2_509-610_519.wav,VTTS_b-2_509-610_519.wav,1690,1544,146
19013,b-2_2107-2193_2184.wav,VTTS_b-2_2107-2193_2184.wav,1290,1300,-10
19014,b-1_2321-2421_2376.wav,VTTS_b-1_2321-2421_2376.wav,3180,3692,-512
19015,b-3_4607-5008_4662.wav,VTTS_b-3_4607-5008_4662.wav,3870,3309,561
19016,b-3_5639-5744_5692.wav,VTTS_b-3_5639-5744_5692.wav,4440,4389,51
19017,b-1_377-477_394.wav,VTTS_b-1_377-477_394.wav,2710,3622,-912
19018,b-1_579-649_649.wav,VTTS_b-1_579-649_649.wav,1750,1672,78
19019,b-4_2000-5164_4952.wav,VTTS_b-4_2000-5164_4952.wav,2047,1637,410
19020,b-1_794-1009_830.wav,VTTS_b-1_794-1009_830.wav,4090,3773,317
19021,b-1_794-1009_906.wav,VTTS_b-1_794-1009_906.wav,6010,6478,-468
19022,b-4_2000-5164_2578.wav,VTTS_b-4_2000-5164_2578.wav,7370,7047,323
19023,b-3_1568-1665_1652.wav,VTTS_b-3_1568-1665_1652.wav,2990,2984,6
19024,b-2_1427-1562_1428.wav,VTTS_b-2_1427-1562_1428.wav,5100,11610,-6510
19025,b-4_2000-5164_4888.wav,VTTS_b-4_2000-5164_4888.wav,1963,1741,222
19026,b-1_4358-4393_4358.wav,VTTS_b-1_4358-4393_4358.wav,3320,3123,197
19027,b-2_1121-1222_1143.wav,VTTS_b-2_1121-1222_1143.wav,1100,1556,-456
19028,b-3_4498-4605_4600.wav,VTTS_b-3_4498-4605_4600.wav,3920,4772,-852
19029,b-3_196-293_284.wav,VTTS_b-3_196-293_284.wav,3350,3367,-17
19030,b-4_1401-1505_1424.wav,VTTS_b-4_1401-1505_1424.wav,6990,8046,-1056
19031,b-4_2000-5164_4502.wav,VTTS_b-4_2000-5164_4502.wav,8387,8406,-19
19032,b-1_2018-2118_2080.wav,VTTS_b-1_2018-2118_2080.wav,2340,1811,529
19033,b-1_478-578_481.wav,VTTS_b-1_478-578_481.wav,1690,1695,-5
19034,b-4_501-1014_721.wav,VTTS_b-4_501-1014_721.wav,1510,1463,47
19035,b-3_1321-1568_1566.wav,VTTS_b-3_1321-1568_1566.wav,6860,6954,-94
19036,b-3_3025-3111_3066.wav,VTTS_b-3_3025-3111_3066.wav,7510,6699,811
19037,b-4_2000-5164_3811.wav,VTTS_b-4_2000-5164_3811.wav,3755,3901,-146
19038,b-1_3127-3227_3223.wav,VTTS_b-1_3127-3227_3223.wav,6370,5526,844
19039,b-1_3430-3530_3478.wav,VTTS_b-1_3430-3530_3478.wav,3250,2972,278
19040,b-4_501-1014_964.wav,VTTS_b-4_501-1014_964.wav,2220,1800,420
19041,b-4_1901-2000_1932.wav,VTTS_b-4_1901-2000_1932.wav,5380,4214,1166
19042,b-3_6601-6700_6640.wav,VTTS_b-3_6601-6700_6640.wav,2990,2705,285
19043,b-4_2000-5164_4297.wav,VTTS_b-4_2000-5164_4297.wav,4330,5294,-964
19044,b-4_2000-5164_3492.wav,VTTS_b-4_2000-5164_3492.wav,11393,10867,526
19045,b-3_3803-3888_3882.wav,VTTS_b-3_3803-3888_3882.wav,2800,2740,60
19046,b-1_1414-1514_1420.wav,VTTS_b-1_1414-1514_1420.wav,2120,3135,-1015
19047,b-4_2000-5164_4279.wav,VTTS_b-4_2000-5164_4279.wav,5030,5341,-311
19048,b-3_4498-4605_4504.wav,VTTS_b-3_4498-4605_4504.wav,3290,3123,167
19049,b-3_2000-2088_2067.wav,VTTS_b-3_2000-2088_2067.wav,6950,7175,-225
19050,b-3_1666-1763_1734.wav,VTTS_b-3_1666-1763_1734.wav,5080,4365,715
19051,b-3_2524-2854_2684.wav,VTTS_b-3_2524-2854_2684.wav,2800,2403,397
19052,b-2_611-712_652.wav,VTTS_b-2_611-712_652.wav,1320,1312,8
19053,b-4_2000-5164_3672.wav,VTTS_b-4_2000-5164_3672.wav,6866,7906,-1040
19054,b-2_203-304_264.wav,VTTS_b-2_203-304_264.wav,2810,3622,-812
19055,b-3_5853-5956_5903.wav,VTTS_b-3_5853-5956_5903.wav,4160,4249,-89
19056,b-3_4104-4206_4121.wav,VTTS_b-3_4104-4206_4121.wav,7240,7094,146
19057,b-3_501-930_627.wav,VTTS_b-3_501-930_627.wav,9350,8406,944
19058,b-1_1818-1918_1820.wav,VTTS_b-1_1818-1918_1820.wav,1700,2125,-425
19059,b-2_305-406_335.wav,VTTS_b-2_305-406_335.wav,1610,1962,-352
19060,b-1_3935-4033_3994.wav,VTTS_b-1_3935-4033_3994.wav,4630,4505,125
19061,b-2_1121-1222_1202.wav,VTTS_b-2_1121-1222_1202.wav,5780,6467,-687
19062,b-3_5009-5427_5083.wav,VTTS_b-3_5009-5427_5083.wav,8220,8162,58
19063,b-3_1666-1763_1747.wav,VTTS_b-3_1666-1763_1747.wav,5070,5259,-189
19064,b-3_4607-5008_4844.wav,VTTS_b-3_4607-5008_4844.wav,9700,10298,-598
19065,b-3_4425-4497_4426.wav,VTTS_b-3_4425-4497_4426.wav,5100,5132,-32
19066,b-3_501-930_814.wav,VTTS_b-3_501-930_814.wav,3210,2902,308
19067,b-1_3632-3732_3655.wav,VTTS_b-1_3632-3732_3655.wav,3570,4249,-679
19068,b-3_2000-2088_2037.wav,VTTS_b-3_2000-2088_2037.wav,8380,11331,-2951
19069,b-4_1601-1706_1602.wav,VTTS_b-4_1601-1706_1602.wav,7750,7338,412
19070,b-3_6900-7016_6921.wav,VTTS_b-3_6900-7016_6921.wav,3790,3053,737
19071,b-3_1079-1320_1143.wav,VTTS_b-3_1079-1320_1143.wav,2990,3077,-87
19072,b-3_3628-3714_3648.wav,VTTS_b-3_3628-3714_3648.wav,2780,2554,226
19073,b-3_2177-2266_2221.wav,VTTS_b-3_2177-2266_2221.wav,6360,6095,265
19074,b-1_2220-2320_2245.wav,VTTS_b-1_2220-2320_2245.wav,1540,1451,89
19075,b-3_2177-2266_2252.wav,VTTS_b-3_2177-2266_2252.wav,2400,2461,-61
19076,b-1_794-1009_1008.wav,VTTS_b-1_794-1009_1008.wav,3470,3622,-152
19077,b-3_4207-4314_4286.wav,VTTS_b-3_4207-4314_4286.wav,4660,5004,-344
19078,b-3_392-500_492.wav,VTTS_b-3_392-500_492.wav,3080,3576,-496
19079,b-3_6801-6900_6806.wav,VTTS_b-3_6801-6900_6806.wav,5390,5410,-20
19080,b-1_3026-3126_3098.wav,VTTS_b-1_3026-3126_3098.wav,3470,2972,498
19081,b-4_2000-5164_3485.wav,VTTS_b-4_2000-5164_3485.wav,2348,2345,3
19082,b-3_3889-4000_3918.wav,VTTS_b-3_3889-4000_3918.wav,6150,5770,380
19083,b-3_6401-6500_6451.wav,VTTS_b-3_6401-6500_6451.wav,6350,6478,-128
19084,b-3_3538-3627_3576.wav,VTTS_b-3_3538-3627_3576.wav,7050,8789,-1739
19085,b-2_1223-1324_1226.wav,VTTS_b-2_1223-1324_1226.wav,3670,4098,-428
19086,b-3_2855-2942_2892.wav,VTTS_b-3_2855-2942_2892.wav,5420,5712,-292
19087,b-2_1019-1120_1025.wav,VTTS_b-2_1019-1120_1025.wav,1300,1556,-256
19088,b-4_1506-1600_1516.wav,VTTS_b-4_1506-1600_1516.wav,1720,1370,350
19089,b-4_2000-5164_4456.wav,VTTS_b-4_2000-5164_4456.wav,7787,10147,-2360
19090,b-4_2000-5164_5061.wav,VTTS_b-4_2000-5164_5061.wav,7411,6803,608
19091,b-1_4178-4213_4182.wav,VTTS_b-1_4178-4213_4182.wav,1560,1509,51
19092,b-3_2855-2942_2858.wav,VTTS_b-3_2855-2942_2858.wav,4260,4400,-140
19093,b-3_2855-2942_2901.wav,VTTS_b-3_2855-2942_2901.wav,5340,5944,-604
19094,b-3_1862-1959_1933.wav,VTTS_b-3_1862-1959_1933.wav,5450,6711,-1261
19095,b-2_1597-1698_1630.wav,VTTS_b-2_1597-1698_1630.wav,3470,2717,753
19096,b-4_1014-1100_1077.wav,VTTS_b-4_1014-1100_1077.wav,3230,3019,211
19097,b-3_5009-5427_5325.wav,VTTS_b-3_5009-5427_5325.wav,3420,3657,-237
19098,b-1_2826-2926_2833.wav,VTTS_b-1_2826-2926_2833.wav,1260,1254,6
19099,b-2_1019-1120_1095.wav,VTTS_b-2_1019-1120_1095.wav,2640,3286,-646
19100,b-1_4466-4498_4468.wav,VTTS_b-1_4466-4498_4468.wav,3860,4296,-436
19101,b-4_501-1014_674.wav,VTTS_b-4_501-1014_674.wav,3170,3111,59
19102,b-1_794-1009_929.wav,VTTS_b-1_794-1009_929.wav,4710,4284,426
19103,b-1_686-793_717.wav,VTTS_b-1_686-793_717.wav,1050,1033,17
19104,b-2_2311-2412_2329.wav,VTTS_b-2_2311-2412_2329.wav,4480,3727,753
19105,b-3_4425-4497_4444.wav,VTTS_b-3_4425-4497_4444.wav,3930,4191,-261
19106,b-3_392-500_448.wav,VTTS_b-3_392-500_448.wav,4080,4098,-18
19107,b-1_1515-1615_1614.wav,VTTS_b-1_1515-1615_1614.wav,2230,2241,-11
19108,b-1_4034-4069_4041.wav,VTTS_b-1_4034-4069_4041.wav,1680,1614,66
19109,b-3_4425-4497_4487.wav,VTTS_b-3_4425-4497_4487.wav,4780,4365,415
19110,b-2_305-406_309.wav,VTTS_b-2_305-406_309.wav,4070,4168,-98
19111,b-1_1515-1615_1563.wav,VTTS_b-1_1515-1615_1563.wav,1320,1347,-27
19112,b-1_276-376_343.wav,VTTS_b-1_276-376_343.wav,2200,3553,-1353
19113,b-1_2220-2320_2289.wav,VTTS_b-1_2220-2320_2289.wav,1360,1300,60
19114,b-1_794-1009_888.wav,VTTS_b-1_794-1009_888.wav,3540,3239,301
19115,b-3_4498-4605_4539.wav,VTTS_b-3_4498-4605_4539.wav,5030,4923,107
19116,b-2_1325-1426_1399.wav,VTTS_b-2_1325-1426_1399.wav,1700,2020,-320
19117,b-1_1212-1312_1289.wav,VTTS_b-1_1212-1312_1289.wav,2280,2090,190
19118,b-1_3026-3126_3094.wav,VTTS_b-1_3026-3126_3094.wav,3930,4365,-435
19119,b-1_1111-1211_1123.wav,VTTS_b-1_1111-1211_1123.wav,2720,2821,-101
19120,b-3_294-391_310.wav,VTTS_b-3_294-391_310.wav,5820,5759,61
19121,b-1_2018-2118_2101.wav,VTTS_b-1_2018-2118_2101.wav,1790,1765,25
19122,b-3_4001-4103_4011.wav,VTTS_b-3_4001-4103_4011.wav,4800,5178,-378
19123,b-1_2220-2320_2306.wav,VTTS_b-1_2220-2320_2306.wav,1310,1091,219
19124,b-4_1221-1300_1256.wav,VTTS_b-4_1221-1300_1256.wav,4370,4156,214
19125,b-4_53-150_84.wav,VTTS_b-4_53-150_84.wav,9010,8301,709
19126,b-1_1414-1514_1500.wav,VTTS_b-1_1414-1514_1500.wav,4260,4180,80
19127,b-4_2000-5164_4091.wav,VTTS_b-4_2000-5164_4091.wav,3438,3216,222
19128,b-4_501-1014_543.wav,VTTS_b-4_501-1014_543.wav,2700,2705,-5
19129,b-3_98-195_126.wav,VTTS_b-3_98-195_126.wav,6310,5956,354
19130,b-3_4607-5008_4901.wav,VTTS_b-3_4607-5008_4901.wav,6240,6200,40
19131,b-1_4070-4105_4085.wav,VTTS_b-1_4070-4105_4085.wav,1230,1324,-94
19132,b-4_2000-5164_3640.wav,VTTS_b-4_2000-5164_3640.wav,1738,1614,124
19133,b-4_151-300_159.wav,VTTS_b-4_151-300_159.wav,3030,2148,882
19134,b-3_3889-4000_3895.wav,VTTS_b-3_3889-4000_3895.wav,5100,4493,607
19135,b-3_4104-4206_4176.wav,VTTS_b-3_4104-4206_4176.wav,3320,3320,0
19136,b-4_2000-5164_2459.wav,VTTS_b-4_2000-5164_2459.wav,4200,3692,508
19137,b-2_713-814_783.wav,VTTS_b-2_713-814_783.wav,5100,3878,1222
19138,b-1_1414-1514_1433.wav,VTTS_b-1_1414-1514_1433.wav,2590,3518,-928
19139,b-1_1414-1514_1488.wav,VTTS_b-1_1414-1514_1488.wav,1930,1614,316
19140,b-1_1717-1817_1768.wav,VTTS_b-1_1717-1817_1768.wav,2530,2519,11
19141,b-1_3026-3126_3063.wav,VTTS_b-1_3026-3126_3063.wav,1720,1718,2
19142,b-2_2107-2193_2172.wav,VTTS_b-2_2107-2193_2172.wav,3210,3146,64
19143,b-1_2725-2825_2743.wav,VTTS_b-1_2725-2825_2743.wav,3280,3355,-75
19144,b-3_1079-1320_1098.wav,VTTS_b-3_1079-1320_1098.wav,10330,10008,322
19145,b-3_980-1077_1078.wav,VTTS_b-3_980-1077_1078.wav,4350,3913,437
19146,b-3_1-97_16.wav,VTTS_b-3_1-97_16.wav,9620,8812,808
19147,b-4_2000-5164_4215.wav,VTTS_b-4_2000-5164_4215.wav,4543,5724,-1181
19148,b-1_1717-1817_1726.wav,VTTS_b-1_1717-1817_1726.wav,2450,2009,441
19149,b-1_579-649_643.wav,VTTS_b-1_579-649_643.wav,4580,4853,-273
19150,b-1_1010-1110_1070.wav,VTTS_b-1_1010-1110_1070.wav,2260,2485,-225
19151,b-4_1901-2000_1901.wav,VTTS_b-4_1901-2000_1901.wav,9690,9799,-109
19152,b-4_501-1014_669.wav,VTTS_b-4_501-1014_669.wav,9270,9183,87
19153,b-3_3364-3453_3393.wav,VTTS_b-3_3364-3453_3393.wav,2860,2810,50
19154,b-2_407-508_407.wav,VTTS_b-2_407-508_407.wav,2220,4122,-1902
19155,b-1_2422-2522_2449.wav,VTTS_b-1_2422-2522_2449.wav,1480,1370,110
19156,b-3_6401-6500_6493.wav,VTTS_b-3_6401-6500_6493.wav,3680,3413,267
19157,b-2_1223-1324_1257.wav,VTTS_b-2_1223-1324_1257.wav,900,778,122
19158,b-4_401-500_476.wav,VTTS_b-4_401-500_476.wav,11240,11610,-370
19159,b-2_713-814_740.wav,VTTS_b-2_713-814_740.wav,1930,2218,-288
19160,b-3_2434-2523_2479.wav,VTTS_b-3_2434-2523_2479.wav,5080,5190,-110
19161,b-3_4607-5008_4700.wav,VTTS_b-3_4607-5008_4700.wav,4800,6037,-1237
19162,b-4_2000-5164_4861.wav,VTTS_b-4_2000-5164_4861.wav,3098,3111,-13
19163,b-4_501-1014_894.wav,VTTS_b-4_501-1014_894.wav,3110,3843,-733
19164,b-1_650-685_668.wav,VTTS_b-1_650-685_668.wav,1820,1776,44
19165,b-1_2220-2320_2246.wav,VTTS_b-1_2220-2320_2246.wav,1440,1393,47
19166,b-3_6501-6600_6515.wav,VTTS_b-3_6501-6600_6515.wav,2870,3030,-160
19167,b-2_1325-1426_1350.wav,VTTS_b-2_1325-1426_1350.wav,8530,6908,1622
19168,b-4_1-52_16.wav,VTTS_b-4_1-52_16.wav,9940,9311,629
19169,b-4_301-400_368.wav,VTTS_b-4_301-400_368.wav,5030,4876,154
19170,b-1_2018-2118_2083.wav,VTTS_b-1_2018-2118_2083.wav,2360,2334,26
19171,b-4_53-150_122.wav,VTTS_b-4_53-150_122.wav,10170,9067,1103
19172,b-4_1901-2000_1904.wav,VTTS_b-4_1901-2000_1904.wav,9640,8812,828
19173,b-3_980-1077_992.wav,VTTS_b-3_980-1077_992.wav,2610,2601,9
19174,b-2_305-406_401.wav,VTTS_b-2_305-406_401.wav,2040,2438,-398
19175,b-3_1321-1568_1449.wav,VTTS_b-3_1321-1568_1449.wav,6730,6525,205
19176,b-2_1903-2038_1988.wav,VTTS_b-2_1903-2038_1988.wav,1750,1602,148
19177,b-1_3834-3934_3909.wav,VTTS_b-1_3834-3934_3909.wav,1320,1335,-15
19178,b-4_2000-5164_4029.wav,VTTS_b-4_2000-5164_4029.wav,7392,7860,-468
19179,b-2_917-1018_923.wav,VTTS_b-2_917-1018_923.wav,3340,3204,136
19180,b-3_3803-3888_3854.wav,VTTS_b-3_3803-3888_3854.wav,4640,4389,251
